"id_notice","real_words_strongs_in_notice","real_words_strongs_in_notice_number_appear","fake_words_strongs_in_notice","fake_words_strongs_in_notice_number_appear","notice_strong_words_real_total","notice_strong_words_fake_total","notice_strong_words_total","classe_notice"
1,"['funcao', 'ministrar']","[1, 1]","['equador']","[1]",2,1,3,1
2,"['companhia', 'companhia', 'destinar', 'europeu', 'quilometro']","[2, 2, 1, 1, 1]","['parir', 'parir']","[2, 2]",5,2,7,1
3,"['companhia', 'demandar', 'exportacao', 'interrupcao', 'periodo', 'reabertura', 'reuter']","[1, 1, 1, 1, 1, 1, 1]","[]","[]",7,0,7,1
6,"['afetado', 'afetado', 'diariament', 'pagamento', 'pagamento', 'sindicato']","[2, 2, 1, 2, 2, 1]","['greve', 'greve']","[2, 2]",6,2,8,1
8,"['lelo', 'mutacao']","[1, 1]","['espalhar', 'invadir']","[1, 1]",2,2,4,1
10,"['aplicacao', 'coordenar', 'distrito', 'domingo', 'dosar', 'esquema', 'estrategia', 'facilitar', 'fase', 'fundacao', 'igualitario', 'instituto', 'intervalar', 'operacionalizacao', 'oswaldo', 'pastar', 'planar', 'prazo', 'publicoalvo', 'remessar', 'sabado', 'saudar', 'saudar', 'saudar', 'vigilancia']","[1, 1, 1, 1, 1, 1, 1, 1, 1, 1, 1, 1, 1, 1, 1, 1, 1, 1, 1, 1, 1, 3, 3, 3, 1]","[]","[]",25,0,25,1
12,"['anvisa', 'autonomia', 'autonomia', 'autoridad', 'calheiro', 'calheiro', 'colegiado', 'comissao', 'comissao', 'comissao', 'conflito', 'consistencia', 'crise', 'crise', 'decisao', 'decisao', 'depoimento', 'depoimento', 'depoimento', 'depoimento', 'destacar', 'escassez', 'etapa', 'exministro', 'exministro', 'exministro', 'exministro', 'exministro', 'exministro', 'exministro', 'exministro', 'inconsistencia', 'inquerito', 'instituto', 'justificativo', 'mdbal', 'plenario', 'preservar', 'proposto', 'reclamacao', 'recurso', 'respostar', 'saudar', 'saudar', 'saudar', 'saudar', 'saudar', 'sessao', 'situacao', 'tcu', 'tcu', 'vigilancia', 'wajngarten']","[1, 2, 2, 1, 2, 2, 1, 3, 3, 3, 1, 1, 2, 2, 2, 2, 4, 4, 4, 4, 1, 1, 1, 8, 8, 8, 8, 8, 8, 8, 8, 1, 1, 1, 1, 1, 1, 1, 1, 1, 1, 1, 5, 5, 5, 5, 5, 1, 1, 2, 2, 1, 1]","['desmentir', 'desmentir', 'versao', 'versao']","[2, 2, 2, 2]",53,4,57,1
13,"['decisao', 'limitacao', 'negativar', 'presenca', 'reducao', 'regrar']","[1, 1, 1, 1, 1, 1]","['libertador', 'libertador', 'patrocinador']","[2, 2, 1]",6,3,9,1
14,"['companhia', 'desempenhar', 'destinar', 'guarulho', 'instituto', 'logistico', 'parceria', 'parceria', 'saudar', 'significativo', 'significativo', 'voo']","[1, 1, 1, 1, 1, 1, 2, 2, 1, 2, 2, 1]","[]","[]",12,0,12,1
15,"['adesao', 'demrj', 'etapa', 'federar', 'liderar']","[1, 1, 1, 1, 1]","[]","[]",5,0,5,1
18,"['antonio', 'anvisa', 'anvisa', 'destacar', 'necessidad', 'passageiro', 'triagem', 'triagem', 'triagem', 'vigilancia']","[1, 2, 2, 1, 1, 1, 3, 3, 3, 1]","['verificar']","[1]",10,1,11,1
26,"['afp', 'aplicacao', 'atrasar', 'companhia', 'esforco', 'europeu', 'exportacao', 'saudar', 'temor']","[1, 1, 1, 1, 1, 1, 1, 1, 1]","[]","[]",9,0,9,1
27,"['adicionar', 'distrito', 'dosar', 'enfermagem', 'etapa', 'expectativa', 'fase', 'fase', 'fase', 'instituto', 'integrant', 'saudar', 'saudar', 'saudar']","[1, 1, 1, 1, 1, 1, 3, 3, 3, 1, 1, 3, 3, 3]","[]","[]",14,0,14,1
28,"['decisao', 'decisao', 'fez', 'lira', 'magistrado', 'ppal', 'pslrj', 'reuter', 'sociai', 'supremo', 'supremo']","[2, 2, 1, 1, 1, 1, 1, 1, 1, 2, 2]","[]","[]",11,0,11,1
29,"['autoridad', 'disseminacao', 'domingo', 'hospitalizar', 'metropolitano', 'necessario', 'necessidad', 'possibilidad', 'reuter', 'reuter', 'saudar', 'saudar', 'toquio', 'toquio', 'toquio']","[1, 1, 1, 1, 1, 1, 1, 1, 2, 2, 2, 2, 3, 3, 3]","['espalhar']","[1]",15,1,16,1
31,"['converso', 'determinacao', 'equipamento', 'espanha', 'limitacao', 'orientacao', 'periodo', 'planar', 'prever', 'regrar', 'rotina', 'rotina', 'treinar', 'treino', 'treino']","[1, 1, 1, 1, 1, 1, 1, 1, 1, 1, 2, 2, 1, 2, 2]","[]","[]",15,0,15,1
32,"['aurelio', 'aurelio', 'colegiado', 'constituicao', 'decisao', 'mello', 'ministrar', 'ministrar', 'ministrar', 'patamar', 'plenario', 'pslrj', 'silveiro', 'supremo', 'supremo']","[2, 2, 1, 1, 1, 1, 3, 3, 3, 1, 1, 1, 1, 2, 2]","[]","[]",15,0,15,1
34,"['celebrar', 'internar', 'internar', 'saudar']","[1, 2, 2, 1]","['imagem']","[1]",4,1,5,1
36,"['alerj', 'alerj', 'ausencia', 'comissao', 'comissao', 'comissao', 'comissao', 'comissao', 'comissao', 'decisao', 'decisao', 'decisao', 'elaborar', 'integrant', 'investigacao', 'justicar', 'legislativo', 'legislativo', 'notificar', 'plenario', 'plenario', 'prazo', 'prazo', 'prazo', 'prazo', 'sessao', 'sessao', 'sessao', 'suspenso', 'wilson', 'witzel', 'witzel', 'witzel', 'witzel']","[2, 2, 1, 6, 6, 6, 6, 6, 6, 3, 3, 3, 1, 1, 1, 1, 2, 2, 1, 2, 2, 4, 4, 4, 4, 3, 3, 3, 1, 1, 4, 4, 4, 4]","[]","[]",34,0,34,1
37,"['discussao', 'epidemiar', 'importancia', 'infectar', 'treinamento', 'treinar']","[1, 1, 1, 1, 1, 1]","[]","[]",6,0,6,1
38,"['ansiedad', 'depressao', 'enfrentamento', 'intenso', 'necessidad', 'reconhecimento', 'risco', 'saudar', 'saudar']","[1, 1, 1, 1, 1, 1, 1, 2, 2]","[]","[]",9,0,9,1
46,"[]","[]","['capturar', 'circular', 'compartilhar', 'compartilhar', 'descricao', 'fotografia', 'fotografia', 'imagem', 'imagem', 'legendar', 'transposicao', 'transposicao']","[1, 1, 2, 2, 1, 2, 2, 2, 2, 1, 2, 2]",0,12,12,1
47,"['agravar', 'comorbidad', 'complicacao', 'internar', 'internar', 'internar', 'saudar']","[1, 1, 1, 3, 3, 3, 1]","[]","[]",7,0,7,1
48,"['congresso', 'congresso', 'desvio', 'recurso']","[2, 2, 1, 1]","[]","[]",4,0,4,1
49,"['infectar', 'notificar', 'saudar']","[1, 1, 1]","[]","[]",3,0,3,1
50,"['amplo', 'fluminens', 'renata', 'renata', 'souza', 'subir', 'sugestao', 'tatto', 'tatto', 'tatto', 'tatto', 'tatto']","[1, 1, 2, 2, 1, 1, 1, 5, 5, 5, 5, 5]","['legendar']","[1]",12,1,13,1
51,"['absoluto', 'apurar', 'boletim', 'boletim', 'boletim', 'flavio', 'flavio', 'flavio', 'instaurar', 'investigacao', 'pratico', 'preliminar', 'republicanosrj', 'requerimento']","[1, 1, 3, 3, 3, 3, 3, 3, 1, 1, 1, 1, 1, 1]","['mansao', 'verdadeiro']","[1, 1]",14,2,16,1
52,"['infectar', 'michael', 'situacao']","[1, 1, 1]","[]","[]",3,0,3,1
53,"['augusto', 'capitar', 'companhia', 'domingo', 'forcatarefa', 'machadar', 'prorrogacao', 'prorrogar', 'republico', 'trafego']","[1, 1, 1, 1, 1, 1, 1, 1, 1, 1]","[]","[]",10,0,10,1
54,"['aglomeracao', 'caxia', 'duqu', 'entregu', 'insuficient']","[1, 1, 1, 1, 1]","['protestar']","[1]",5,1,6,1
57,"['instituto', 'posturar']","[1, 1]","[]","[]",2,0,2,1
61,"['acompanhamento', 'cooperacao', 'descumprimento', 'distrito', 'distrito', 'funcionamento', 'justicar', 'orientacao', 'pagamento', 'prazo', 'saudar', 'saudar']","[1, 1, 1, 2, 2, 1, 1, 1, 1, 1, 2, 2]","[]","[]",12,0,12,1
68,"['domingo', 'facilitar']","[1, 1]","[]","[]",2,0,2,1
69,"['adulto', 'almeida', 'comprometido', 'desenvolvimento', 'espirito', 'espirito', 'humanitario', 'periodo', 'plano', 'psicologo', 'psicologo', 'psicologo', 'recebido']","[1, 1, 1, 1, 2, 2, 1, 1, 1, 3, 3, 3, 1]","[]","[]",13,0,13,1
70,"['anteriorment', 'anuncio', 'companhia', 'companhia', 'companhia', 'decisao', 'decorrencia', 'disseminacao', 'esforco', 'oferecido', 'possibilidad', 'reforcar', 'saudar', 'saudar', 'suspensao', 'temporario', 'viagem', 'viagem']","[1, 1, 3, 3, 3, 1, 1, 1, 1, 1, 1, 1, 2, 2, 1, 1, 2, 2]","[]","[]",18,0,18,1
71,"['biliao', 'biliao', 'celebrar', 'epidemiar', 'impactar', 'instituto', 'reforcar', 'saudar', 'saudar']","[2, 2, 1, 1, 1, 1, 1, 2, 2]","['intitular']","[1]",9,1,10,1
72,"['alternativo', 'facilitar', 'jornada', 'organizador', 'regrar', 'voo', 'voo']","[1, 1, 1, 1, 1, 2, 2]","['filmar']","[1]",7,1,8,1
73,"['apurar', 'fluminens', 'inquerito', 'inquerito', 'justicar', 'mprj', 'nomeacao']","[1, 1, 2, 2, 1, 1, 1]","[]","[]",7,0,7,1
75,"['contemplar', 'respostar']","[1, 1]","[]","[]",2,0,2,1
76,"['epidemiar', 'saudar', 'situacao', 'xinhua']","[1, 1, 1, 1]","[]","[]",4,0,4,1
79,"['autorizacao', 'colombio', 'desembarcar', 'diagnosticar', 'passageiro', 'passageiro', 'passageiro', 'passageiro', 'passageiro', 'republico', 'tripulacao', 'tripulacao', 'viagem']","[1, 1, 1, 1, 5, 5, 5, 5, 5, 1, 2, 2, 1]","[]","[]",13,0,13,1
80,"['interpretar', 'sabado']","[1, 1]","['filmar']","[1]",2,1,3,1
83,"['afetado', 'ambientar', 'biliao', 'comprometido', 'cooperacao', 'dedicar', 'desempenhar', 'desenvolvimento', 'diminuicao', 'diretoria', 'enfatizar', 'expansao', 'funcao', 'implementacao', 'inclusao', 'indicador', 'mudanca', 'mudanca', 'necessario', 'opcao', 'periodo', 'pratico', 'preparacao', 'processo', 'taxar', 'treinamento']","[1, 1, 1, 1, 1, 1, 1, 1, 1, 1, 1, 1, 1, 1, 1, 1, 2, 2, 1, 1, 1, 1, 1, 1, 1, 1]","['ganhar', 'parir']","[1, 1]",26,2,28,1
84,"['comissao', 'crise', 'crise', 'crise', 'europeu', 'europeu', 'europeu', 'europeu', 'respostar', 'taxar']","[1, 3, 3, 3, 4, 4, 4, 4, 1, 1]","[]","[]",10,0,10,1
89,"['autoridad', 'epidemiar', 'inglaterra', 'ministrar', 'periodo', 'restritivo', 'saudar', 'saudar', 'superar']","[1, 1, 1, 1, 1, 1, 2, 2, 1]","[]","[]",9,0,9,1
90,"['aprovacao', 'constituicao', 'decisao', 'desenvolvimento', 'dificultar', 'divergencia', 'emendar', 'emendar', 'fundeb', 'fundeb', 'mudanca', 'plenario', 'proposto', 'proposto', 'prorrogar', 'recurso']","[1, 1, 1, 1, 1, 1, 2, 2, 2, 2, 1, 1, 2, 2, 1, 1]","[]","[]",16,0,16,1
92,"['aglomeracao', 'agravar', 'decisao', 'epidemiar', 'fase', 'fase', 'fase', 'planar', 'planar', 'prever', 'previsao', 'privar', 'reabertura', 'reabertura', 'suspenso']","[1, 1, 1, 1, 3, 3, 3, 2, 2, 1, 1, 1, 2, 2, 1]","['crech']","[1]",15,1,16,1
98,"['anuncio', 'anvisa', 'autorizacao', 'biliao', 'client', 'desenvolvimento', 'enfatizar', 'fase', 'fundacao', 'instituto', 'ministrar', 'ministrar', 'mudanca', 'oswaldo', 'palacio', 'planalto', 'provisorio', 'relativo', 'saudar', 'vigilancia']","[1, 1, 1, 1, 1, 1, 1, 1, 1, 1, 2, 2, 1, 1, 1, 1, 1, 1, 1, 1]","[]","[]",20,0,20,1
100,"['anuncio', 'especifico', 'lancamento']","[1, 1, 1]","[]","[]",3,0,3,1
105,"['adicionar', 'administrativo', 'bandeira', 'conselho', 'funcao', 'funcao', 'funcao', 'funcionamento', 'lancamento', 'pagamento', 'pagamento', 'possibilidad', 'risco', 'suspensa']","[1, 1, 1, 1, 3, 3, 3, 1, 1, 2, 2, 1, 1, 1]","[]","[]",14,0,14,1
108,"['confirmado', 'emergenciai', 'facilitar', 'medida', 'milho', 'monitoramento', 'recurso']","[1, 1, 1, 1, 1, 1, 1]","[]","[]",7,0,7,1
110,"['fluxo', 'fluxo', 'orientacao', 'pastar', 'pastar', 'respostar', 'saudar', 'saudar', 'saudar', 'suspeito', 'treinar']","[2, 2, 1, 2, 2, 1, 3, 3, 3, 1, 1]","[]","[]",11,0,11,1
117,"['assintomatico', 'gabinet', 'gabinet', 'pastar', 'positivar', 'positivar', 'saudar', 'saudar', 'saudar']","[1, 2, 2, 1, 2, 2, 3, 3, 3]","[]","[]",9,0,9,1
118,"[]","[]","[]","[]",0,0,0,1
120,"['crise', 'curso', 'flexibilizacao', 'mudanca', 'pagamento', 'possibilidad', 'prever', 'provisorio', 'regrar', 'revogar', 'suspensao', 'suspensao']","[1, 1, 1, 1, 1, 1, 1, 1, 1, 1, 2, 2]","[]","[]",12,0,12,1
121,"['fase', 'fase', 'fundacao', 'imunizacao', 'instituto', 'liderar', 'paralelo', 'respostar']","[2, 2, 1, 1, 1, 1, 1, 1]","[]","[]",8,0,8,1
124,"['balancar', 'comparacao', 'consolidar', 'consorcio', 'decorrent', 'estabilidad', 'levantamento', 'saudar', 'situacao', 'tendencia', 'totalizar', 'variacao']","[1, 1, 1, 1, 1, 1, 1, 1, 1, 1, 1, 1]","[]","[]",12,0,12,1
126,"['heleno', 'inconsistencia', 'justicar', 'oficio', 'periodo', 'prever', 'sabado', 'substituicao', 'substituicao']","[1, 1, 1, 1, 1, 1, 1, 2, 2]","['expulsar']","[1]",9,1,10,1
127,"['diagnosticar', 'espanha', 'inicialment', 'intensivo', 'internar', 'internar', 'respiratorio', 'saudar', 'situacao']","[1, 1, 1, 1, 2, 2, 1, 1, 1]","['cartaz', 'menino']","[1, 1]",9,2,11,1
128,"['consolidar', 'consorcio', 'levantamento', 'sabado', 'saudar', 'situacao', 'variacao', 'variacao']","[1, 1, 1, 1, 1, 1, 2, 2]","[]","[]",8,0,8,1
130,"['alcolumbr', 'alcolumbr', 'alcolumbr', 'calendario', 'celso', 'discussao', 'indicado', 'informaco', 'kassio', 'kassio', 'mello', 'previsao', 'reuniao', 'reuniao', 'supremo', 'tambem', 'tambem', 'tramitacao']","[3, 3, 3, 1, 1, 1, 1, 1, 2, 2, 1, 1, 2, 2, 1, 2, 2, 1]","[]","[]",18,0,18,1
132,"['andrew', 'crise', 'propagacao', 'quarentenar']","[1, 1, 1, 1]","[]","[]",4,0,4,1
136,"['complicacao', 'saudar', 'saudar', 'vigilancia']","[1, 2, 2, 1]","[]","[]",4,0,4,1
137,"['ambientar', 'integro', 'ministrar', 'ministrar', 'ricardo', 'sall', 'sall', 'servidor']","[1, 1, 2, 2, 1, 2, 2, 1]","[]","[]",8,0,8,1
138,"['ausencia', 'domingo', 'justicar', 'justificativo', 'normalment', 'pratico', 'situacao', 'suspenso']","[1, 1, 1, 1, 1, 1, 1, 1]","['preencher']","[1]",8,1,9,1
140,"['afastamento', 'alerj', 'apreensao', 'apreensao', 'confirmado', 'confirmado', 'contrato', 'desenvolvimento', 'exprefeito', 'goncalv', 'heleno', 'inicialment', 'irregularidad', 'justicar', 'justicar', 'legislativo', 'ministrar', 'palacio', 'preventivo', 'redondo', 'saudar', 'temporario', 'wilson', 'witzel', 'witzel']","[1, 1, 2, 2, 2, 2, 1, 1, 1, 1, 1, 1, 1, 2, 2, 1, 1, 1, 1, 1, 1, 1, 1, 2, 2]","[]","[]",25,0,25,1
141,"['adulto', 'aplicacao', 'decisao', 'desafiar', 'desenvolvimento', 'implementacao', 'infectar', 'saudar', 'situacao', 'situacao']","[1, 1, 1, 1, 1, 1, 1, 1, 2, 2]","['humanar']","[1]",10,1,11,1
142,"['antonio', 'atuacao', 'comportamento', 'congresso', 'economia', 'economia', 'economia', 'gued', 'gued', 'gued', 'ministrar', 'ministrar', 'ministrar', 'plano', 'proposto', 'proposto', 'proposto', 'rejeitar', 'unanimidad']","[1, 1, 1, 1, 3, 3, 3, 3, 3, 3, 3, 3, 3, 1, 3, 3, 3, 1, 1]","['desmentir']","[1]",19,1,20,1
143,"['alunar', 'balancar', 'balancar', 'balancar', 'contabilizar', 'internar', 'positivar', 'sabado', 'sabado', 'saudar', 'saudar', 'saudar', 'suspeito']","[1, 3, 3, 3, 1, 1, 1, 2, 2, 3, 3, 3, 1]","[]","[]",13,0,13,1
144,"['congresso', 'diretoria', 'imunizacao', 'imunizacao', 'iniciativo', 'logistico', 'planar', 'prever', 'prever', 'prioritario', 'privar', 'privar', 'privar', 'saudar', 'saudar']","[1, 1, 2, 2, 1, 1, 1, 2, 2, 1, 3, 3, 3, 2, 2]","[]","[]",15,0,15,1
145,"['distrito', 'dosar', 'esquema', 'fase', 'igualitario', 'instituto', 'necessario', 'operacionalizacao', 'pastar', 'pastar', 'periodo', 'planar', 'publicoalvo', 'remessar', 'saudar', 'saudar', 'vigilancia']","[1, 1, 1, 1, 1, 1, 1, 1, 2, 2, 1, 1, 1, 1, 2, 2, 1]","[]","[]",17,0,17,1
148,"['converso', 'converso', 'demandar', 'desenvolvimento', 'estrategia', 'fabricacao', 'possibilidad', 'saudar', 'situacao']","[2, 2, 1, 1, 1, 1, 1, 1, 1]","[]","[]",9,0,9,1
149,"['almeida', 'ricardo', 'ricardo']","[1, 2, 2]","[]","[]",3,0,3,1
152,"['articulacao', 'azevedo', 'biliao', 'congresso', 'decisao', 'discussao', 'discussao', 'emendar', 'especifico', 'oliveira', 'palacio', 'planalto', 'planalto', 'prever', 'proposto', 'sancao', 'tributario', 'tributario', 'vetar', 'vetar']","[1, 1, 1, 1, 1, 2, 2, 1, 1, 1, 1, 2, 2, 1, 1, 1, 2, 2, 2, 2]","['catolico', 'perdao']","[1, 1]",20,2,22,1
154,"['autorizacao', 'carat', 'correspondent', 'destinar', 'especializar', 'pulmonar', 'pulmonar', 'reforcar', 'saudar', 'saudar', 'suportar', 'suportar', 'suportar', 'suspeito', 'temporario', 'ventilatorio', 'ventilatorio']","[1, 1, 1, 1, 1, 2, 2, 1, 2, 2, 3, 3, 3, 1, 1, 2, 2]","[]","[]",17,0,17,1
155,"['aprovacao', 'congresso', 'constituicao', 'crise', 'medida', 'pedido', 'previsto', 'proposta']","[1, 1, 1, 1, 1, 1, 1, 1]","[]","[]",8,0,8,1
156,"['avancar', 'epicentro', 'fronteiro', 'hubei', 'hubei', 'internar', 'provincia', 'provincia', 'reabrir', 'xinhua']","[1, 1, 1, 2, 2, 1, 2, 2, 1, 1]","[]","[]",10,0,10,1
158,"['argumentar', 'consequencia', 'emendar', 'henriqu', 'independentement', 'republico', 'tucano']","[1, 1, 1, 1, 1, 1, 1]","['estranhar']","[1]",7,1,8,1
161,"['atuacao', 'atuacao', 'carla', 'decisao', 'decisao', 'distrito', 'favorito', 'indicado', 'kassio', 'nomeacao', 'orientacao', 'pedido', 'processo', 'pslsp', 'quatro', 'supremo', 'suspensa', 'zambelli']","[2, 2, 1, 2, 2, 1, 1, 1, 1, 1, 1, 1, 1, 1, 1, 1, 1, 1]","[]","[]",18,0,18,1
164,"['academia', 'academia', 'ansiedad', 'antonio', 'crise', 'depressao', 'depressao', 'depressao', 'desafio', 'equilibrio', 'geografia', 'ibg', 'impacto', 'instituto', 'milho', 'periodo', 'periodo', 'plano', 'quadro', 'reuniao', 'risco', 'risco', 'situacao', 'tambem', 'tambem', 'ufrj']","[2, 2, 1, 1, 1, 3, 3, 3, 1, 1, 1, 1, 1, 1, 1, 2, 2, 1, 1, 1, 2, 2, 1, 2, 2, 1]","[]","[]",26,0,26,1
167,"['anteontem', 'anteriorment', 'circulacao', 'comunitario', 'concedido', 'epidemiologico', 'investigacao', 'metropolitano', 'notificar', 'quedo', 'recordar', 'recordar', 'saudar', 'subir']","[1, 1, 1, 1, 1, 1, 1, 1, 1, 1, 2, 2, 1, 1]","[]","[]",14,0,14,1
169,"['avancar', 'colunista', 'extraordinario']","[1, 1, 1]","[]","[]",3,0,3,1
170,"['fase', 'goncalv', 'planar', 'presenciar', 'saudar']","[1, 1, 1, 1, 1]","[]","[]",5,0,5,1
172,"['alteracao', 'congresso', 'pagamento', 'proposto', 'sancao', 'sessao', 'situacao']","[1, 1, 1, 1, 1, 1, 1]","['sacar']","[1]",7,1,8,1
173,"['afastamento', 'apreensao', 'araujo', 'argumentar', 'cenario', 'colunista', 'decisao', 'decisao', 'destacar', 'forcatarefa', 'humberto', 'inquerito', 'inquerito', 'interlocutor', 'investigacao', 'investigacao', 'investigacao', 'justicar', 'martim', 'oficio', 'oficio', 'proferir', 'republico', 'republico', 'risco', 'supremo']","[1, 1, 1, 1, 1, 1, 2, 2, 1, 1, 1, 2, 2, 1, 3, 3, 3, 1, 1, 2, 2, 1, 2, 2, 1, 1]","[]","[]",26,0,26,1
174,"['argumentar', 'autoridad', 'comissao', 'comissao', 'deslocamento', 'discussao', 'economia', 'especialment', 'governista', 'inquerito', 'periodo', 'presenciar', 'proposto', 'realizacao', 'realizacao', 'recurso', 'respostar', 'reuniao', 'saudar', 'sessao']","[1, 1, 2, 2, 1, 1, 1, 1, 1, 1, 1, 1, 1, 2, 2, 1, 1, 1, 1, 1]","['tampouco']","[1]",20,1,21,1
178,"['companhia', 'ultimo']","[1, 1]","[]","[]",2,0,2,1
180,"['adversario', 'empatar', 'margem', 'mello', 'renata', 'rocha', 'souza']","[1, 1, 1, 1, 1, 1, 1]","['bandeiro']","[1]",7,1,8,1
181,"['circulacao', 'contemplar', 'curvo', 'destacar', 'possibilidad', 'primeiroministro', 'subir']","[1, 1, 1, 1, 1, 1, 1]","[]","[]",7,0,7,1
183,"['avancar', 'resolucao']","[1, 1]","['capturar', 'imagem', 'imagem', 'minutar']","[1, 2, 2, 1]",2,4,6,1
184,"['barroso', 'barroso', 'condenacao', 'conduta', 'globonew', 'julgamento', 'magistrado', 'ministrar', 'ministrar', 'urbano']","[2, 2, 1, 1, 1, 1, 1, 2, 2, 1]","['abusar']","[1]",10,1,11,1
186,"[]","[]","[]","[]",0,0,0,1
187,"['ambientar', 'avancar', 'reducao', 'restritivo', 'turista']","[1, 1, 1, 1, 1]","[]","[]",5,0,5,1
188,"['associacao', 'cardiologista', 'cenario', 'impacto', 'intubacao', 'intubacao', 'intubacao', 'levantamento', 'levantamento', 'prazo', 'privar', 'privar', 'situacao']","[1, 1, 1, 1, 3, 3, 3, 2, 2, 1, 2, 2, 1]","[]","[]",13,0,13,1
191,"['boletim', 'boletim', 'ricardo', 'ricardo']","[2, 2, 2, 2]","[]","[]",4,0,4,1
193,"['autoridad', 'calheiro', 'calheiro', 'converso', 'converso', 'internar', 'mdbal', 'prorrogacao', 'prorrogacao', 'recuperacao', 'saudar']","[1, 2, 2, 2, 2, 1, 1, 2, 2, 1, 1]","[]","[]",11,0,11,1
194,"['balancar', 'boletim', 'domingo', 'mudanca', 'planar', 'prever', 'saudar', 'saudar', 'suspeito', 'suspeito', 'vigilancia']","[1, 1, 1, 1, 1, 1, 2, 2, 2, 2, 1]","[]","[]",11,0,11,1
196,"['autoridad', 'crise', 'decisao', 'dificuldad', 'quarentenar', 'recurso', 'tendencia']","[1, 1, 1, 1, 1, 1, 1]","[]","[]",7,0,7,1
201,"['arthur', 'atrair', 'condicao', 'demrj', 'desgastar', 'lira', 'lira', 'palacio', 'planalto', 'presenca', 'reuniao', 'rossi']","[1, 1, 1, 1, 1, 2, 2, 1, 1, 1, 1, 1]","['legendar']","[1]",12,1,13,1
202,"['acumular', 'aglomeracao', 'aglomeracao', 'bandeirant', 'celebrar', 'celebrar', 'curvo', 'internacao', 'observar', 'palacio', 'quedo', 'relaxamento']","[1, 2, 2, 1, 2, 2, 1, 1, 1, 1, 1, 1]","[]","[]",12,0,12,1
204,"['acumular', 'cnj', 'comparacao', 'crescimento', 'despesa', 'despesa', 'despesa', 'expansao', 'extraordinario', 'justicar', 'justicar', 'justicar', 'margem', 'margem', 'periodo', 'pratico', 'prever', 'regrar', 'subir', 'supremo', 'tesourar', 'variacao', 'variacao']","[1, 1, 1, 1, 3, 3, 3, 1, 1, 3, 3, 3, 2, 2, 1, 1, 1, 1, 1, 1, 1, 2, 2]","[]","[]",23,0,23,1
205,"['decisao', 'inicialment', 'portavoz', 'presenca', 'presenca', 'recuar']","[1, 1, 1, 2, 2, 1]","['filmar']","[1]",6,1,7,1
207,"['avancar', 'diagnosticar', 'epidemiar', 'estagio', 'estimativo', 'expressivo', 'intervalar', 'periodo', 'quedo', 'suspenso']","[1, 1, 1, 1, 1, 1, 1, 1, 1, 1]","[]","[]",10,0,10,1
210,"['autorizacao', 'coletivo', 'crise', 'decisao', 'possibilidad', 'preservacao', 'saudar', 'saudar', 'sindicato']","[1, 1, 1, 1, 1, 1, 2, 2, 1]","['greve']","[1]",9,1,10,1
211,"['folhar', 'imunizacao', 'imunizacao', 'integro', 'ministrar', 'planar', 'reforcar', 'saudar', 'sessao']","[1, 2, 2, 1, 1, 1, 1, 1, 1]","[]","[]",9,0,9,1
212,"['adhanom', 'adhanom', 'defendido', 'henriqu', 'ministrar', 'precaucao', 'saudar', 'saudar', 'tedro']","[2, 2, 1, 1, 1, 1, 2, 2, 1]","[]","[]",9,0,9,1
213,"['cepa', 'monitoramento', 'transmissao']","[1, 1, 1]","[]","[]",3,0,3,1
214,"['avancar', 'desenvolvimento', 'estagio', 'fase', 'flexibilizacao', 'planar', 'regiao']","[1, 1, 1, 1, 1, 1, 1]","[]","[]",7,0,7,1
216,"['decisao', 'opcao', 'opcao', 'possibilidad']","[1, 2, 2, 1]","['ganhar', 'ganhar', 'legendar']","[2, 2, 1]",4,3,7,1
218,"['desafiar', 'dosar', 'estimular', 'fase', 'instituto', 'ministrar', 'ministrar', 'palacio', 'parceria', 'saudar', 'saudar', 'saudar', 'saudar', 'saudar', 'superar']","[1, 1, 1, 1, 1, 2, 2, 1, 1, 5, 5, 5, 5, 5, 1]","[]","[]",15,0,15,1
219,"['paralisar', 'posicionamento', 'reuniao', 'reuniao', 'tornear', 'tornear']","[1, 1, 2, 2, 2, 2]","[]","[]",6,0,6,1
223,"['consolidar', 'domingo', 'epidemiologico', 'intensivo', 'internacao', 'patamar', 'quedo', 'quedo', 'regiao', 'saudar', 'taxar', 'tendencia']","[1, 1, 1, 1, 1, 1, 2, 2, 1, 1, 1, 1]","[]","[]",12,0,12,1
227,"['celso', 'favorito', 'federar', 'justicar', 'kassio', 'magistrado', 'mello', 'ministrar', 'regiao', 'supremo']","[1, 1, 1, 1, 1, 1, 1, 1, 1, 1]","['ganhar']","[1]",10,1,11,1
231,"['funcionamento', 'necessario', 'situacao', 'transmissao']","[1, 1, 1, 1]","['clicar']","[1]",4,1,5,1
232,"['domingo', 'folhar', 'funcao', 'levantamento', 'margem', 'spaulo']","[1, 1, 1, 1, 1, 1]","[]","[]",6,0,6,1
233,"['adotada', 'apreensao', 'augusto', 'celso', 'celso', 'consequencia', 'constituicao', 'estabilidad', 'gabinet', 'heleno', 'heleno', 'heleno', 'justicar', 'mello', 'mello', 'ministrar', 'ministrar', 'previsto', 'regrar', 'republico', 'supremo']","[1, 1, 1, 2, 2, 1, 1, 1, 1, 3, 3, 3, 1, 2, 2, 2, 2, 1, 1, 1, 1]","[]","[]",21,0,21,1
234,"['antecipar', 'converso', 'converso', 'opcao', 'opcao', 'opcao', 'opcao', 'recurso']","[1, 2, 2, 4, 4, 4, 4, 1]","['selecionar', 'versao']","[1, 1]",8,2,10,1
235,"['afetado', 'contabilizar', 'estatistico', 'infectar', 'observar', 'ritmar', 'saudar', 'tendencia']","[1, 1, 1, 1, 1, 1, 1, 1]","[]","[]",8,0,8,1
240,"['anvisa', 'anvisa', 'anvisa', 'anvisa', 'integrant', 'obtido', 'parceria', 'prazo', 'prazo', 'reuniao', 'reuniao', 'reuter', 'vigilancia']","[4, 4, 4, 4, 1, 1, 1, 2, 2, 2, 2, 1, 1]","[]","[]",13,0,13,1
242,"['anteontem', 'anteontem', 'crescimento', 'crescimento', 'decorrencia', 'ritmar', 'ritmar']","[2, 2, 2, 2, 1, 2, 2]","[]","[]",7,0,7,1
245,"['anuncio', 'atrasar', 'avancar', 'decisao', 'extensao', 'extensao', 'preocupacao', 'prorrogacao', 'prorrogar', 'quarentenar', 'quarentenar', 'recordar', 'regiao', 'respectivament', 'superar']","[1, 1, 1, 1, 2, 2, 1, 1, 1, 2, 2, 1, 1, 1, 1]","['equador']","[1]",15,1,16,1
247,"['condenacao', 'condenacao', 'decorrent', 'deflagrar', 'exgovernador', 'fase', 'gabinet', 'integrant', 'jorg', 'justicar', 'pagamento', 'ribeiro', 'substituto', 'varar']","[2, 2, 1, 1, 1, 1, 1, 1, 1, 1, 1, 1, 1, 1]","['fraudar']","[1]",14,1,15,1
248,"['autoridad', 'concreto', 'estatistico', 'eventualment', 'kassio', 'magistrado', 'orientacao', 'prever', 'punicao', 'sabatino', 'situacao', 'supremo']","[1, 1, 1, 1, 1, 1, 1, 1, 1, 1, 1, 1]","['abusar']","[1]",12,1,13,1
251,"['cupula', 'integro']","[1, 1]","[]","[]",2,0,2,1
252,"['comissao', 'competicao', 'elaborar', 'elaborar', 'estagio', 'isolar', 'necessidad', 'parceria', 'realizacao', 'realizacao', 'realizacao', 'realizacao', 'regrar']","[1, 1, 2, 2, 1, 1, 1, 1, 4, 4, 4, 4, 1]","['basto', 'basto', 'circular']","[2, 2, 1]",13,3,16,1
253,"['profissionai', 'profissionai', 'semestr']","[2, 2, 1]","[]","[]",3,0,3,1
254,"['assistencia']","[1]","[]","[]",1,0,1,1
256,"['chefiar', 'sudest', 'transmissao']","[1, 1, 1]","[]","[]",3,0,3,1
258,"['atuam', 'desenvolvimento', 'destinar', 'escalar', 'extensao', 'extensao', 'materiaprima', 'necessario', 'saudar', 'universitario']","[1, 1, 1, 1, 2, 2, 1, 1, 1, 1]","[]","[]",10,0,10,1
259,"['argumentar', 'arrecadacao', 'arrecadacao', 'economia', 'gued', 'gued', 'ministrar', 'reuter']","[1, 2, 2, 1, 2, 2, 1, 1]","['checar']","[1]",8,1,9,1
260,"['carat', 'dificuldad', 'diplomata', 'esperancar', 'logistico', 'significativo']","[1, 1, 1, 1, 1, 1]","[]","[]",6,0,6,1
261,"['client', 'fase', 'jantar', 'relaxamento', 'suspenso']","[1, 1, 1, 1, 1]","['parir', 'parir']","[2, 2]",5,2,7,1
262,"['necessario', 'recurso', 'respostar']","[1, 1, 1]","[]","[]",3,0,3,1
263,"['benjamin', 'benjamin', 'carla', 'carla', 'carla', 'enfermagem', 'intensivo', 'intensivo', 'intensivo', 'internar', 'periodo', 'superar', 'universitario']","[2, 2, 3, 3, 3, 1, 3, 3, 3, 1, 1, 1, 1]","[]","[]",13,0,13,1
264,"['argumentar', 'atuacao', 'bastidor', 'celso', 'decisao', 'enfatizar', 'julgamento', 'julgamento', 'kassio', 'kassio', 'kassio', 'kassio', 'magistrado', 'mello', 'regiao', 'republico', 'supremo', 'varar']","[1, 1, 1, 1, 1, 1, 2, 2, 4, 4, 4, 4, 1, 1, 1, 1, 1, 1]","[]","[]",18,0,18,1
267,"['araujo', 'confederacao', 'confederacao', 'realizacao', 'reuter', 'tornear']","[1, 2, 2, 1, 1, 1]","[]","[]",6,0,6,1
268,"['atrair', 'californio', 'californio', 'californio', 'visitant']","[1, 3, 3, 3, 1]","['bandeiro', 'protestar']","[1, 1]",5,2,7,1
269,"['araujo', 'associacao', 'inicialment', 'periodo', 'preocupacao', 'renata', 'saudar']","[1, 1, 1, 1, 1, 1, 1]","['enderecar']","[1]",7,1,8,1
271,"['concedido', 'condicao', 'gued', 'gued', 'impacto', 'proposto', 'recurso', 'recurso', 'republico', 'revisar', 'revisar', 'taxar', 'transferencia']","[1, 1, 2, 2, 1, 1, 2, 2, 1, 2, 2, 1, 1]","['manchet']","[1]",13,1,14,1
273,"['acompanhamento', 'acompanhamento', 'ambito', 'ambito', 'apurar', 'biliao', 'comparacao', 'decisao', 'distrito', 'economia', 'enfrentamento', 'especialment', 'importancia', 'importancia', 'necessidad', 'recurso', 'regiao', 'saudar', 'saudar', 'saudar', 'saudar', 'saudar', 'saudar', 'saudar', 'variacao']","[2, 2, 2, 2, 1, 1, 1, 1, 1, 1, 1, 1, 2, 2, 1, 1, 1, 7, 7, 7, 7, 7, 7, 7, 1]","['usuario', 'verificar']","[1, 1]",25,2,27,1
276,"['elaborar', 'estagio', 'exministro', 'exministro', 'interino', 'ministrar', 'nelson', 'pastar', 'pastar', 'pastar', 'saudar', 'saudar', 'teich']","[1, 1, 2, 2, 1, 1, 1, 3, 3, 3, 2, 2, 1]","[]","[]",13,0,13,1
277,"['conjuntar', 'crise', 'definitivo', 'esforco', 'infancia', 'inicialment', 'precedent', 'privar', 'propagacao', 'regiao', 'situacao']","[1, 1, 1, 1, 1, 1, 1, 1, 1, 1, 1]","[]","[]",11,0,11,1
281,"['aurelio', 'internar', 'liderar', 'magistrado', 'mello', 'ministrar', 'ministrar']","[1, 1, 1, 1, 1, 2, 2]","['acidentar', 'acidentar']","[2, 2]",7,2,9,1
282,"['consequencia', 'imunizacao', 'prioritario', 'ricardo']","[1, 1, 1, 1]","[]","[]",4,0,4,1
286,"['domingo']","[1]","[]","[]",1,0,1,1
287,"['autoridad', 'comprometido', 'domingo', 'sabado']","[1, 1, 1, 1]","[]","[]",4,0,4,1
288,"['capitar', 'integro', 'ribeiro', 'situacao']","[1, 1, 1, 1]","[]","[]",4,0,4,1
289,"['hospitalizacao', 'impactar', 'imunizacao', 'internacao', 'internacao', 'necessidad', 'observar', 'periodo', 'positivar', 'reforcar', 'respiratorio', 'saudar', 'vulneravel']","[1, 1, 1, 2, 2, 1, 1, 1, 1, 1, 1, 1, 1]","[]","[]",13,0,13,1
290,"['adulto', 'autonomia', 'autonomia', 'autorizacao', 'carat', 'cenario', 'contemplar', 'decorrencia', 'demandar', 'enfrentamento', 'enfrentamento', 'infraestrutura', 'necessario', 'necessario', 'recurso', 'saudar', 'saudar', 'saudar', 'saudar', 'saudar', 'temporario']","[1, 2, 2, 1, 1, 1, 1, 1, 1, 2, 2, 1, 2, 2, 1, 5, 5, 5, 5, 5, 1]","[]","[]",21,0,21,1
292,"['autoridad', 'contabilizar', 'flexibilizacao', 'merkel', 'propagacao', 'prorrogar', 'restritivo', 'reuniao', 'rotina', 'superar']","[1, 1, 1, 1, 1, 1, 1, 1, 1, 1]","[]","[]",10,0,10,1
293,"['complicacao', 'intenso', 'internar', 'risco']","[1, 1, 1, 1]","[]","[]",4,0,4,1
295,"['imunizacao', 'painel', 'painel', 'painel', 'saudar', 'saudar']","[1, 3, 3, 3, 2, 2]","[]","[]",6,0,6,1
296,"['articulacao', 'edson', 'escalar', 'gorinchteyn', 'implementar', 'iniciativo', 'oficio', 'planar', 'preocupacao', 'saudar', 'saudar', 'saudar']","[1, 1, 1, 1, 1, 1, 1, 1, 1, 3, 3, 3]","[]","[]",12,0,12,1
298,"['alvorar', 'aprovacao', 'atuacao', 'converso', 'crise', 'desempenhar', 'enfrentamento', 'negativar', 'palacio', 'patamar', 'quedo', 'republico', 'republico']","[1, 1, 1, 1, 1, 1, 1, 1, 1, 1, 1, 2, 2]","[]","[]",13,0,13,1
301,"['adotada', 'balancar', 'decorrencia', 'prever', 'quarentenar', 'restritivo']","[1, 1, 1, 1, 1, 1]","[]","[]",6,0,6,1
303,"['barroso', 'congresso', 'converso', 'converso', 'jorg', 'pacheco', 'republico', 'supremo', 'supremo', 'supremo']","[1, 1, 2, 2, 1, 1, 1, 3, 3, 3]","['lixar']","[1]",10,1,11,1
304,"['anvisa', 'avancar', 'avancar', 'boletim', 'boletim', 'calculo', 'circulacao', 'companhia', 'consecutivo', 'consorcio', 'decisao', 'decisao', 'desenvolvido', 'desenvolvimento', 'desgast', 'domingo', 'entregu', 'enxergar', 'escassez', 'esforco', 'estabilidad', 'estatistico', 'expansao', 'folhar', 'gripezinha', 'hospitalizacao', 'infectar', 'iniciativo', 'instituto', 'instituto', 'levantamento', 'levantamento', 'minimizar', 'ministrar', 'ministrar', 'ministrar', 'notificar', 'oficio', 'palacio', 'parceria', 'parceria', 'pastar', 'planalto', 'plantao', 'previsto', 'quedo', 'realizacao', 'realizacao', 'realizacao', 'recordar', 'recurso', 'ribeiro', 'saudar', 'saudar', 'saudar', 'saudar', 'saudar', 'saudar', 'spaulo', 'sputnik', 'sputnik', 'tendencia', 'tendencia', 'transmissao', 'trimestr', 'vigilancia', 'vulneravel']","[1, 2, 2, 2, 2, 1, 1, 1, 1, 1, 2, 2, 1, 1, 1, 1, 1, 1, 1, 1, 1, 1, 1, 1, 1, 1, 1, 1, 2, 2, 2, 2, 1, 3, 3, 3, 1, 1, 1, 2, 2, 1, 1, 1, 1, 1, 3, 3, 3, 1, 1, 1, 6, 6, 6, 6, 6, 6, 1, 2, 2, 2, 2, 1, 1, 1, 1]","['tampouco']","[1]",67,1,68,1
305,"['congresso', 'congresso', 'constituicao', 'constituicao', 'domingo', 'inicialment', 'integro', 'obtido', 'republico', 'supremo', 'supremo']","[2, 2, 2, 2, 1, 1, 1, 1, 1, 2, 2]","[]","[]",11,0,11,1
306,"['adotada', 'autoridad', 'autoridad', 'infectar', 'internar', 'passageiro', 'positivar', 'precaucao', 'quarentenar', 'sabado']","[1, 2, 2, 1, 1, 1, 1, 1, 1, 1]","['incendio', 'interaco', 'padrar', 'padrar']","[1, 1, 2, 2]",10,4,14,1
307,"['destacar', 'divergencia', 'escalar', 'hospitalizar', 'nelson', 'pastar', 'saudar', 'saudar', 'teich']","[1, 1, 1, 1, 1, 1, 2, 2, 1]","[]","[]",9,0,9,1
309,"['exercicio', 'saudar']","[1, 1]","[]","[]",2,0,2,1
311,"['enfrentamento', 'enfrentamento', 'pastar', 'periodo', 'reforcar', 'saudar', 'saudar', 'saudar', 'saudar', 'saudar']","[2, 2, 1, 1, 1, 5, 5, 5, 5, 5]","['ganhar']","[1]",10,1,11,1
312,"['adversario', 'bancada', 'comportamento', 'legislativo', 'opcao', 'pacheco', 'planalto', 'respostar', 'sessao']","[1, 1, 1, 1, 1, 1, 1, 1, 1]","[]","[]",9,0,9,1
314,"['desenvolvimento', 'desenvolvimento', 'destacar', 'destinar', 'economia', 'emprestimo', 'emprestimo', 'importancia', 'recurso', 'resolucao']","[2, 2, 1, 1, 1, 2, 2, 1, 1, 1]","[]","[]",10,0,10,1
317,"['empatar', 'exprefeito', 'prazo', 'respectivament', 'totalizar']","[1, 1, 1, 1, 1]","[]","[]",5,0,5,1
318,"['comparacao', 'consorcio', 'estabilidad', 'obtido', 'roraima', 'saudar', 'variacao']","[1, 1, 1, 1, 1, 1, 1]","[]","[]",7,0,7,1
320,"['afetado', 'autoridad', 'balancar', 'coreia', 'epicentro', 'habitant', 'hubei', 'hubei', 'infectar', 'kong', 'mexico', 'provincia', 'provincia', 'saudar', 'saudar', 'subir', 'suspeito']","[1, 1, 1, 1, 1, 1, 2, 2, 1, 1, 1, 2, 2, 2, 2, 1, 1]","[]","[]",17,0,17,1
321,"['articulacao', 'crise', 'desafio', 'desenvolvimento', 'desigualdad', 'dosar', 'estrategico', 'igualitario', 'insuficient', 'intenso', 'saudar', 'superar']","[1, 1, 1, 1, 1, 1, 1, 1, 1, 1, 1, 1]","['sequer']","[1]",12,1,13,1
322,"['metropolitano', 'preventivo', 'propagacao', 'quarentenar', 'regiao']","[1, 1, 1, 1, 1]","[]","[]",5,0,5,1
324,"['anvisa', 'desigu', 'destacar', 'vigilancia']","[1, 1, 1, 1]","[]","[]",4,0,4,1
325,"['boletim', 'corpu', 'mexico', 'quilometro', 'regiao', 'sigla', 'sudest', 'temporada']","[1, 1, 1, 1, 1, 1, 1, 1]","[]","[]",8,0,8,1
326,"['abordagem', 'externo']","[1, 1]","['enganoso', 'imagem', 'manipular']","[1, 1, 1]",2,3,5,1
328,"[]","[]","[]","[]",0,0,0,1
329,"['anvisa', 'crise', 'decisao', 'enfrentamento', 'epidemiar', 'fundamentar', 'manutencao', 'movimentacao', 'mudanca', 'provisorio', 'provisorio', 'saudar', 'surtir', 'suspensao', 'vigilancia', 'voo', 'voo', 'wilson', 'witzel']","[1, 1, 1, 1, 1, 1, 1, 1, 1, 2, 2, 1, 1, 1, 1, 2, 2, 1, 1]","[]","[]",19,0,19,1
330,"['exigencia', 'imunizacao', 'integro', 'mudanca', 'pratico', 'previsto', 'prioritario', 'saudar']","[1, 1, 1, 1, 1, 1, 1, 1]","[]","[]",8,0,8,1
332,"['alerj', 'desempenhar', 'desvio', 'esquema', 'esquema', 'flavio', 'gabinet', 'gabinet', 'inquerito', 'legislativo', 'oficio', 'pagamento', 'rachadinha', 'republicanosrj', 'servidor']","[1, 1, 1, 2, 2, 1, 2, 2, 1, 1, 1, 1, 1, 1, 1]","[]","[]",15,0,15,1
334,"['conjuntar', 'parceria', 'parceria', 'parceria', 'parceria', 'parceria', 'quarentenar']","[1, 5, 5, 5, 5, 5, 1]","['gravacao']","[1]",7,1,8,1
343,"['aplicacao', 'aplicacao', 'aplicacao', 'aplicacao', 'aplicacao', 'capitar', 'dosar', 'dosar', 'dosar', 'dosar', 'dosar', 'saudar', 'suspenso', 'suspenso']","[5, 5, 5, 5, 5, 1, 5, 5, 5, 5, 5, 1, 2, 2]","[]","[]",14,0,14,1
349,"['apurar', 'arrecadacao', 'arrecadacao', 'biliao', 'biliao', 'biliao', 'desempenhar', 'periodo', 'periodo', 'quedo', 'recuar', 'reuter', 'reuter', 'semestr']","[1, 2, 2, 3, 3, 3, 1, 2, 2, 1, 1, 2, 2, 1]","[]","[]",14,0,14,1
352,"['benjamin', 'companhia', 'companhia', 'companhia', 'demanda', 'epidemia', 'equipamento', 'expectativa', 'milho', 'reuter']","[1, 3, 3, 3, 1, 1, 1, 1, 1, 1]","[]","[]",10,0,10,1
354,"['congresso', 'congresso', 'contrato', 'decisao', 'discussao', 'flexibilizacao', 'flexibilizacao', 'ministrar', 'possibilidad', 'prever', 'reuter', 'saudar']","[2, 2, 1, 1, 1, 2, 2, 1, 1, 1, 1, 1]","[]","[]",12,0,12,1
356,"['autoridad', 'deteccao', 'dinamarca', 'mutacao', 'mutacao', 'mutacao', 'saudar']","[1, 1, 1, 3, 3, 3, 1]","['pelar', 'versao', 'versao']","[1, 2, 2]",7,3,10,1
358,"['comportamento', 'justicar']","[1, 1]","['menino', 'menino', 'soltar', 'trafico', 'trafico']","[2, 2, 1, 2, 2]",2,5,7,1
364,"['benjamin', 'benjamin', 'cnj', 'entendimento', 'entendimento', 'federar', 'humberto', 'jorg', 'justicar', 'justicar', 'justicar', 'martim', 'ministrar', 'ministrar', 'ministrar', 'ministrar', 'presidir', 'processo', 'recurso', 'sessao', 'sessao']","[2, 2, 1, 2, 2, 1, 1, 1, 3, 3, 3, 1, 4, 4, 4, 4, 1, 1, 1, 2, 2]","[]","[]",21,0,21,1
365,"['autoridad', 'autoridad', 'ideologico', 'periferia', 'reuniao']","[2, 2, 1, 1, 1]","['parir']","[1]",5,1,6,1
366,"['autoridad', 'colombio', 'intensivo', 'intervalar', 'pastar', 'recordar', 'reportar', 'saudar', 'subir', 'taxar']","[1, 1, 1, 1, 1, 1, 1, 1, 1, 1]","[]","[]",10,0,10,1
367,"['domingo', 'infectar', 'privar', 'saudar', 'saudar', 'saudar', 'suspeito']","[1, 1, 1, 3, 3, 3, 1]","[]","[]",7,0,7,1
371,"['assintomatico', 'balancar', 'contabilizar', 'coreia', 'epidemiar', 'epidemiar', 'instituto', 'intensivo', 'internar', 'regiao', 'regiao', 'sabado', 'saudar']","[1, 1, 1, 1, 2, 2, 1, 1, 1, 2, 2, 1, 1]","[]","[]",13,0,13,1
374,"['barroso', 'capitar', 'colegiado', 'colegiado', 'comissao', 'demmg', 'exprefeito', 'instalacao', 'ministrar', 'pacheco', 'possibilidad', 'posturar', 'recurso', 'requerimento', 'reuniao', 'supremo', 'suspeito']","[1, 1, 2, 2, 1, 1, 1, 1, 1, 1, 1, 1, 1, 1, 1, 1, 1]","['bandeiro']","[1]",17,1,18,1
381,"['adotada', 'epidemiar', 'expressar', 'gabinet', 'minoria', 'necessidad', 'respostar', 'saudar', 'saudar', 'situacao', 'universitario']","[1, 1, 1, 1, 1, 1, 1, 2, 2, 1, 1]","['supostament']","[1]",11,1,12,1
383,"['atrasar', 'atuam', 'avancar', 'calculo', 'congresso', 'crescimento', 'decisao', 'economia', 'infectar', 'normalidad', 'pagamento', 'prorrogar', 'quarentenar', 'recurso', 'saudar', 'situacao']","[1, 1, 1, 1, 1, 1, 1, 1, 1, 1, 1, 1, 1, 1, 1, 1]","[]","[]",16,0,16,1
385,"['alerj', 'congresso', 'fabricio', 'flavio', 'gabinet', 'integro', 'oliveira', 'parcelar', 'queiroz', 'revogar']","[1, 1, 1, 1, 1, 1, 1, 1, 1, 1]","[]","[]",10,0,10,1
386,"['balancar', 'hospitalizar', 'hospitalizar', 'intensivo', 'regiao', 'regiao', 'saudar', 'subir', 'totalizar']","[1, 2, 2, 1, 2, 2, 1, 1, 1]","[]","[]",9,0,9,1
388,"['afp', 'afp', 'observar', 'suspenso']","[2, 2, 1, 1]","[]","[]",4,0,4,1
391,"['amplo', 'autoridad', 'domingo', 'imunizacao', 'primeiroministro', 'suprimento']","[1, 1, 1, 1, 1, 1]","[]","[]",6,0,6,1
392,"['aprovacao', 'aurelio', 'concedido', 'decisao', 'entendimento', 'mello', 'ministrar', 'mudanca', 'punicao', 'regrar', 'supremo', 'supremo', 'suspenso', 'turma', 'turma']","[1, 1, 1, 1, 1, 1, 1, 1, 1, 1, 2, 2, 1, 2, 2]","['faccao', 'soltura']","[1, 1]",15,2,17,1
393,"['acumular', 'crescimento', 'economia', 'estatistico', 'geografia', 'ibg', 'ibg', 'ibg', 'instituto', 'patamar', 'quedo', 'quedo', 'recordar', 'recuperacao', 'recuperacao', 'ritmar']","[1, 1, 1, 1, 1, 3, 3, 3, 1, 1, 2, 2, 1, 2, 2, 1]","['disseminar', 'tampouco']","[1, 1]",16,2,18,1
396,"['decisao', 'processo', 'processo', 'sociai']","[1, 2, 2, 1]","[]","[]",4,0,4,1
397,"['colleg', 'impactar', 'lancamento', 'minimizar', 'observacao']","[1, 1, 1, 1, 1]","['imagem', 'imagem', 'imagem']","[3, 3, 3]",5,3,8,1
398,"['carla', 'desafiar', 'epidemiar', 'estrategico', 'indicador', 'interino', 'ministrar', 'oficialment', 'pslsp', 'recurso', 'reuniao', 'saudar', 'saudar', 'zambelli', 'zambelli']","[1, 1, 1, 1, 1, 1, 1, 1, 1, 1, 1, 2, 2, 2, 2]","['auditoria']","[1]",15,1,16,1
402,"['decisao', 'inquerito', 'justificativo', 'legislativo', 'pslsp', 'reafirmar', 'supremo', 'suspenso', 'suspenso', 'suspenso']","[1, 1, 1, 1, 1, 1, 1, 3, 3, 3]","['expulsar', 'mentiroso']","[1, 1]",10,2,12,1
404,"['fase', 'fase', 'fase', 'fase', 'marilia', 'planar', 'planar', 'planar', 'regiao', 'regiao', 'restritivo', 'sorocaba']","[4, 4, 4, 4, 1, 3, 3, 3, 2, 2, 1, 1]","[]","[]",12,0,12,1
406,"['autorizacao', 'deslocamento', 'deslocamento', 'deslocamento', 'epicentro', 'epidemiar', 'necessidad', 'necessidad', 'reforcar']","[1, 3, 3, 3, 1, 1, 2, 2, 1]","[]","[]",9,0,9,1
408,"['folhar', 'integro', 'painel', 'suportar']","[1, 1, 1, 1]","[]","[]",4,0,4,1
409,"['infectar', 'saudar', 'surtir']","[1, 1, 1]","['soltar']","[1]",3,1,4,1
411,"['enfrentamento', 'exercicio', 'exercicio', 'habito', 'hospitalizacao', 'intensivo', 'internacao', 'internacao', 'internar', 'necessidad', 'pratico', 'reducao', 'ventilacao']","[1, 2, 2, 1, 1, 1, 2, 2, 1, 1, 1, 1, 1]","[]","[]",13,0,13,1
413,"['amplo', 'biliao', 'conjunto', 'decisao', 'desempenhar', 'favorito', 'impactar', 'implementacao', 'infraestrutura', 'interferencia', 'justicar', 'pratico', 'sigla', 'temporario']","[1, 1, 1, 1, 1, 1, 1, 1, 1, 1, 1, 1, 1, 1]","['protestar', 'protestar']","[2, 2]",14,2,16,1
418,"['administrativo', 'aglomeracao', 'aglomeracao', 'aglomeracao', 'amplo', 'autoridad', 'constituicao', 'demandar', 'economia', 'fabricio', 'fundacao', 'higienizacao', 'improbidad', 'jurista', 'minimizar', 'orientacao', 'orientacao', 'possibilidad', 'prever', 'prever', 'provisorio', 'respostar', 'sancao', 'saudar', 'saudar', 'varga']","[1, 3, 3, 3, 1, 1, 1, 1, 1, 1, 1, 1, 1, 1, 1, 2, 2, 1, 2, 2, 1, 1, 1, 2, 2, 1]","[]","[]",26,0,26,1
422,"['aprovacao', 'arthur', 'determinacao', 'lira', 'mudanca', 'plenario', 'ppal', 'prever', 'pslrj', 'requerimento', 'resolucao', 'ribeiro', 'silveiro', 'supremo', 'tramitar']","[1, 1, 1, 1, 1, 1, 1, 1, 1, 1, 1, 1, 1, 1, 1]","[]","[]",15,0,15,1
425,"['aplicacao', 'desenvolvido', 'dosar', 'folhar', 'instituto', 'internacao', 'minimizar', 'necessidad', 'parceria', 'reafirmar', 'spaulo']","[1, 1, 1, 1, 1, 1, 1, 1, 1, 1, 1]","[]","[]",11,0,11,1
427,"['integro', 'ministrar', 'saudar', 'saudar']","[1, 1, 2, 2]","[]","[]",4,0,4,1
430,"['ambientar', 'colegiado', 'crise', 'depressao', 'economia', 'economia', 'economia', 'externo', 'indicador', 'monetario', 'possibilidad', 'recuperacao', 'recuperacao', 'trimestr']","[1, 1, 1, 1, 3, 3, 3, 1, 1, 1, 1, 2, 2, 1]","[]","[]",14,0,14,1
432,"['complicacao']","[1]","['amigar', 'amigar']","[2, 2]",1,2,3,1
433,"['antonio', 'associacao', 'circulacao', 'circulacao', 'circulacao', 'cometido', 'distrito', 'infraestrutura', 'ministrar', 'passageiro', 'passageiro', 'passageiro', 'regrar', 'suspenso', 'velocidad']","[1, 1, 3, 3, 3, 1, 1, 1, 1, 3, 3, 3, 1, 1, 1]","['compartilhar', 'imagem', 'imagem', 'motorista']","[1, 2, 2, 1]",15,4,19,1
434,"['almeida', 'atendido', 'condenacao', 'constatar', 'investigacao', 'irregularidad', 'justicar', 'justicar', 'justicar', 'pagamento', 'pagamento', 'pastar', 'pratico', 'reclamacao', 'saudar', 'saudar', 'saudar', 'saudar', 'saudar']","[1, 1, 1, 1, 1, 1, 3, 3, 3, 2, 2, 1, 1, 1, 5, 5, 5, 5, 5]","[]","[]",19,0,19,1
437,"['boletim', 'bruto', 'crescimento', 'economia', 'economia', 'expectativa', 'pib', 'pib', 'prever', 'previsao', 'projecao']","[1, 1, 1, 2, 2, 1, 2, 2, 1, 1, 1]","[]","[]",11,0,11,1
439,"['anuncio', 'bruto', 'congresso', 'crescimento', 'destacar', 'dificuldad', 'economia', 'expectativa', 'gued', 'internar', 'minimizar', 'negativar', 'pib', 'positivar', 'prorrogacao', 'quedo', 'reuniao', 'reuniao', 'trimestr']","[1, 1, 1, 1, 1, 1, 1, 1, 1, 1, 1, 1, 1, 1, 1, 1, 2, 2, 1]","[]","[]",19,0,19,1
440,"['atuacao', 'calheiro', 'comissao', 'comissao', 'enfrentamento', 'inquerito', 'mdbal', 'ministrar', 'ministrar', 'ministrar', 'queiroga', 'queiroga', 'recurso', 'saudar', 'saudar']","[1, 1, 2, 2, 1, 1, 1, 3, 3, 3, 2, 2, 1, 2, 2]","[]","[]",15,0,15,1
441,"['assistencia', 'condicao', 'distant', 'henriqu', 'parceiro', 'privar', 'queixar', 'recurso', 'universitario']","[1, 1, 1, 1, 1, 1, 1, 1, 1]","[]","[]",9,0,9,1
442,"['adiamento', 'alternativo', 'ministrar', 'ministrar', 'previsao', 'proposto', 'transmissao']","[1, 1, 2, 2, 1, 1, 1]","['inscricao']","[1]",7,1,8,1
444,"['consenso', 'fabricio', 'necessidad', 'queiroz', 'sabado', 'situacao']","[1, 1, 1, 1, 1, 1]","[]","[]",6,0,6,1
448,"['anteriorment', 'autoridad', 'californio', 'client', 'interrupcao', 'journal', 'planar', 'plano', 'possibilidad', 'reabertura', 'reabertura', 'reabrir', 'reportar', 'revisar', 'salao', 'salao', 'suspensao']","[1, 1, 1, 1, 1, 1, 1, 1, 1, 2, 2, 1, 1, 1, 2, 2, 1]","[]","[]",17,0,17,1
449,"['conduta', 'exministro', 'internar', 'punicao', 'regulamentar', 'regulamentar', 'saudar', 'subir']","[1, 1, 1, 1, 2, 2, 1, 1]","[]","[]",8,0,8,1
450,"['anuncio', 'fundacao', 'instalacao', 'integro', 'ministrar', 'oswaldo', 'previsao', 'queiroga', 'saudar']","[1, 1, 1, 1, 1, 1, 1, 1, 1]","[]","[]",9,0,9,1
451,"['cirurgico', 'folhar', 'opcao']","[1, 1, 1]","['imagem']","[1]",3,1,4,1
453,"['alternativo', 'cilindro', 'circulacao', 'equipamento', 'impulsionar', 'saudar', 'ventilacao', 'ventilacao', 'ventilacao', 'ventilacao']","[1, 1, 1, 1, 1, 1, 4, 4, 4, 4]","[]","[]",10,0,10,1
454,"['autoridad', 'autoridad', 'colombio', 'notificar', 'quarentenar', 'revisar', 'viajant', 'visitant']","[2, 2, 1, 1, 1, 1, 1, 1]","[]","[]",8,0,8,1
456,"['adversario', 'convencao', 'defendido', 'juro', 'periferia', 'privar', 'privar', 'proposto', 'proposto', 'recurso', 'sabado']","[1, 1, 1, 1, 1, 2, 2, 2, 2, 1, 1]","['bandeiro']","[1]",11,1,12,1
460,"['michael', 'posicionamento', 'primeiroministro', 'prioridad', 'reconhecimento', 'reconhecimento', 'reconhecimento']","[1, 1, 1, 1, 3, 3, 3]","['compartilhar']","[1]",7,1,8,1
461,"['apoio', 'quatro', 'risco', 'sabado', 'tambem']","[1, 1, 1, 1, 1]","[]","[]",5,0,5,1
462,"['adotada', 'anvisa', 'anvisa', 'anvisa', 'anvisa', 'anvisa', 'aprovacao', 'autorizacao', 'comissao', 'companhia', 'decisao', 'destinar', 'europeu', 'europeu', 'europeu', 'fabricacao', 'fase', 'gabinet', 'integrant', 'lewandowski', 'ministrar', 'moderno', 'parceria', 'pratico', 'prazo', 'prever', 'previsao', 'primeiroministro', 'prioridad', 'relativo', 'respostar', 'reuniao', 'ricardo', 'sabado', 'sabado', 'saudar', 'sputnik', 'sputnik', 'vigilancia']","[1, 5, 5, 5, 5, 5, 1, 1, 1, 1, 1, 1, 3, 3, 3, 1, 1, 1, 1, 1, 1, 1, 1, 1, 1, 1, 1, 1, 1, 1, 1, 1, 1, 2, 2, 1, 2, 2, 1]","[]","[]",39,0,39,1
466,"['argumentar', 'autoridad', 'dificuldad', 'integro', 'sessao']","[1, 1, 1, 1, 1]","[]","[]",5,0,5,1
467,"['cirurgico', 'estrategia', 'estrategia', 'intensivo', 'levantamento', 'respostar', 'variacao', 'variacao', 'variacao', 'variacao']","[1, 2, 2, 1, 1, 1, 4, 4, 4, 4]","[]","[]",10,0,10,1
468,"['adotada', 'agravamento', 'antecipar', 'decisao', 'fluminens', 'relativo', 'restritivo']","[1, 1, 1, 1, 1, 1, 1]","[]","[]",7,0,7,1
470,"['companhia', 'conformar', 'consumidor', 'demandar', 'importacao', 'integro', 'necessidad', 'reajustar', 'reuter']","[1, 1, 1, 1, 1, 1, 1, 1, 1]","['gasolina']","[1]",9,1,10,1
475,"['autorizacao', 'autorizacao', 'cupula', 'decisao', 'especifico', 'esperancar', 'exportacao', 'exportacao', 'exportacao', 'exportacao', 'flexibilizar', 'necessidad', 'pratico', 'preocupacao', 'prever']","[2, 2, 1, 1, 1, 1, 4, 4, 4, 4, 1, 1, 1, 1, 1]","['instrucao', 'instrucao']","[2, 2]",15,2,17,1
476,"['positivar', 'treinamento']","[1, 1]","[]","[]",2,0,2,1
477,"['argumentar', 'articulacao', 'condicao', 'crise', 'crise', 'destacar', 'federar', 'fundamentar', 'necessario', 'necessario', 'superar', 'suportar', 'tendencia']","[1, 1, 1, 2, 2, 1, 1, 1, 2, 2, 1, 1, 1]","['basto']","[1]",13,1,14,1
480,"['complicacao', 'globonew', 'intensivo', 'ribeiro', 'saudar', 'saudar']","[1, 1, 1, 1, 2, 2]","[]","[]",6,0,6,1
481,"['calculo', 'observar', 'reuniao', 'saudar', 'suspenso', 'temporada', 'treinar']","[1, 1, 1, 1, 1, 1, 1]","['vazio']","[1]",7,1,8,1
485,"['andrea', 'crise', 'orientacao', 'periodo', 'propagacao', 'situacao', 'turma']","[1, 1, 1, 1, 1, 1, 1]","[]","[]",7,0,7,1
487,"['apreensao', 'apurar', 'deflagrar', 'desenvolvimento', 'desvio', 'federar', 'federar', 'fundeb', 'investigacao', 'manutencao', 'recurso', 'recurso', 'regiao', 'saudar']","[1, 1, 1, 1, 1, 2, 2, 1, 1, 1, 2, 2, 1, 1]","['fraudar']","[1]",14,1,15,1
488,"['argumentar', 'argumentar', 'coletivo', 'coletivo', 'enfrentamento', 'equivalent', 'fase', 'ministrar', 'planar', 'restritivo', 'saudar', 'saudar', 'supremo']","[2, 2, 2, 2, 1, 1, 1, 1, 1, 1, 2, 2, 1]","['atribuir', 'legendar']","[1, 1]",13,2,15,1
490,"['equipamento', 'sabado', 'sabado', 'saudar', 'saudar']","[1, 2, 2, 2, 2]","[]","[]",5,0,5,1
491,"['dosar', 'epidemiar', 'etapa', 'expectativa', 'fase', 'fundacao', 'infeccioso', 'inovacao', 'moderno', 'periodo', 'preparacao']","[1, 1, 1, 1, 1, 1, 1, 1, 1, 1, 1]","[]","[]",11,0,11,1
492,"['anticorpo', 'anticorpo', 'esforco', 'gestant', 'gestant', 'gestant', 'impactar', 'infectar', 'infectar', 'saudar', 'transferir']","[2, 2, 1, 3, 3, 3, 1, 2, 2, 1, 1]","[]","[]",11,0,11,1
494,"['adulto', 'plantao', 'presenciar', 'regiao']","[1, 1, 1, 1]","['compartilhar']","[1]",4,1,5,1
495,"['complicacao', 'internacao', 'periodo']","[1, 1, 1]","['amigar']","[1]",3,1,4,1
496,"['europeu']","[1]","['clicar']","[1]",1,1,2,1
502,"['alergia', 'avancar', 'forcatarefa', 'forcatarefa', 'infeccioso', 'instituto', 'integro', 'mandatario', 'necessario']","[1, 1, 2, 2, 1, 1, 1, 1, 1]","[]","[]",9,0,9,1
503,"['estrategico', 'indicado', 'interferencia', 'mudanca', 'necessidad', 'nelson', 'nomeacao', 'palacio', 'planalto', 'porqu', 'proximo', 'recebido', 'tambem', 'tambem', 'teich', 'teich', 'teich', 'teich']","[1, 1, 1, 1, 1, 1, 1, 1, 1, 1, 1, 1, 2, 2, 4, 4, 4, 4]","['ganhar']","[1]",18,1,19,1
505,"['adotada', 'aplicacao', 'assistencia', 'assistencia', 'comparacao', 'decisao', 'desenvolvimento', 'economia', 'fabricacao', 'fundamentar', 'geraldo', 'necessario', 'painel', 'processo', 'processo', 'realizacao', 'relativo', 'saudar', 'saudar', 'saudar', 'saudar', 'saudar', 'saudar', 'saudar', 'saudar', 'saudar', 'saudar', 'treinamento']","[1, 1, 2, 2, 1, 1, 1, 1, 1, 1, 1, 1, 1, 2, 2, 1, 1, 10, 10, 10, 10, 10, 10, 10, 10, 10, 10, 1]","['descricao', 'descricao', 'descricao', 'descricao']","[4, 4, 4, 4]",28,4,32,1
506,"['apoio', 'ausencia', 'autonomia', 'habito', 'necessidad', 'periodo', 'periodo', 'proprio', 'situacao']","[1, 1, 1, 1, 1, 2, 2, 1, 1]","[]","[]",9,0,9,1
507,"['bolsonarista', 'pslsp', 'regiao']","[1, 1, 1]","['compartilhar', 'estranhar', 'fraudar', 'postagen']","[1, 1, 1, 1]",3,4,7,1
510,"['feriar', 'sudest']","[1, 1]","[]","[]",2,0,2,1
511,"['anvisa', 'aprovacao', 'avancar', 'avancar', 'definitivo', 'desenvolvido', 'etapa', 'imunizacao', 'parceiro', 'reuter']","[1, 1, 2, 2, 1, 1, 1, 1, 1, 1]","[]","[]",10,0,10,1
512,"['acordo', 'ambientar', 'ambientar', 'araujo', 'compromisso', 'concreto', 'condicao', 'crise', 'desembarcar', 'diplomata', 'diplomata', 'economia', 'ernesto', 'europeu', 'gued', 'itamarati', 'ministrar', 'mudanca', 'pastar', 'preocupacao', 'proferir', 'quilometro']","[1, 2, 2, 1, 1, 1, 1, 1, 1, 2, 2, 1, 1, 1, 1, 1, 1, 1, 1, 1, 1, 1]","[]","[]",22,0,22,1
514,"['anuncio', 'fornecimento', 'instituto']","[1, 1, 1]","[]","[]",3,0,3,1
516,"['antecipar', 'comissao', 'economia', 'economia', 'juro', 'ministrar', 'ministrar', 'pagamento', 'pagamento', 'periodo', 'periodo', 'proposto', 'relativo', 'sigla', 'situacao', 'vencimento', 'vencimento']","[1, 1, 2, 2, 1, 2, 2, 2, 2, 2, 2, 1, 1, 1, 1, 2, 2]","[]","[]",17,0,17,1
517,"['adotada', 'alvorar', 'excecao', 'impacto', 'integro', 'palacio']","[1, 1, 1, 1, 1, 1]","[]","[]",6,0,6,1
518,"['anticorpo']","[1]","['abortar', 'realment']","[1, 1]",1,2,3,1
519,"['academiar', 'aprovacao', 'atrasar', 'autoridad', 'conduta', 'congresso', 'contabilizar', 'entendimento', 'epidemiar', 'estrategia', 'extraordinario', 'implementacao', 'imunizacao', 'imunizacao', 'infectar', 'legislativo', 'legislativo', 'paralelo', 'planar', 'planar', 'plano', 'prioritario', 'realizacao', 'saudar']","[1, 1, 1, 1, 1, 1, 1, 1, 1, 1, 1, 1, 2, 2, 1, 2, 2, 1, 2, 2, 1, 1, 1, 1]","[]","[]",24,0,24,1
521,"['ampliacao', 'demandar', 'demrj', 'dialogo', 'economia', 'economia', 'economia', 'economia', 'equilibrio', 'equilibrio', 'importancia', 'instituto', 'justicar', 'prever', 'quedo', 'quedo', 'quedo', 'recurso', 'volumar']","[1, 1, 1, 1, 4, 4, 4, 4, 2, 2, 1, 1, 1, 1, 3, 3, 3, 1, 1]","[]","[]",19,0,19,1
524,"['demrj', 'proposta', 'substituto']","[1, 1, 1]","[]","[]",3,0,3,1
525,"['aprovacao', 'desgastar', 'justicar', 'margem', 'mendonca', 'ministrar', 'notificar', 'palacio', 'percepcao', 'planalto', 'reducao', 'reflexo', 'transmissao']","[1, 1, 1, 1, 1, 1, 1, 1, 1, 1, 1, 1, 1]","[]","[]",13,0,13,1
527,"['apoio', 'comparacao', 'condicao', 'domicilio', 'geografia', 'ibg', 'ibg', 'impacto', 'instituto', 'levantamento', 'milho', 'milho', 'milho', 'milho', 'milho', 'milho', 'subir', 'tambem', 'temporariament']","[1, 1, 1, 1, 1, 2, 2, 1, 1, 1, 6, 6, 6, 6, 6, 6, 1, 1, 1]","['versao']","[1]",19,1,20,1
528,"['balancar', 'decisao', 'ministrar', 'ministrar', 'nelson', 'previo', 'saudar', 'teich', 'teich']","[1, 1, 2, 2, 1, 1, 1, 2, 2]","[]","[]",9,0,9,1
529,"['autorizacao', 'batalhar', 'domingo', 'espirito', 'ideologico', 'inedito', 'internacao', 'internacao', 'interrupcao']","[1, 1, 1, 1, 1, 1, 2, 2, 1]","['abortar', 'abortar', 'estuprar', 'estuprar', 'menino', 'menino']","[2, 2, 2, 2, 2, 2]",9,6,15,1
530,"['crise', 'crise', 'crise', 'crise', 'crise', 'crise', 'desenvolvimento', 'saudar', 'saudar']","[6, 6, 6, 6, 6, 6, 1, 2, 2]","[]","[]",9,0,9,1
532,"['concorrent', 'funcao', 'recurso']","[1, 1, 1]","['ganhar', 'ganhar']","[2, 2]",3,2,5,1
538,"['afetado', 'conjuntar', 'queixar']","[1, 1, 1]","['amplament', 'desmaiar']","[1, 1]",3,2,5,1
539,"['funcionamento', 'prever', 'reuniao', 'rotina', 'saudar', 'saudar', 'transferir']","[1, 1, 1, 1, 2, 2, 1]","[]","[]",7,0,7,1
542,"['avancar', 'balancar', 'circulacao', 'desafio', 'diagnosticar', 'economia', 'etapa', 'habitant', 'planar', 'reabertura', 'reportar', 'reportar', 'sabado', 'santiago', 'santiago', 'suspeito']","[1, 1, 1, 1, 1, 1, 1, 1, 1, 1, 2, 2, 1, 2, 2, 1]","[]","[]",16,0,16,1
544,"['afp', 'superar']","[1, 1]","[]","[]",2,0,2,1
545,"['adversario', 'carat', 'henriqu', 'periodo', 'respectivament']","[1, 1, 1, 1, 1]","['imagem', 'intitular']","[1, 1]",5,2,7,1
547,"['elaborar', 'implementacao', 'imunizacao', 'julgamento', 'ministrar', 'necessario', 'oficio', 'planar', 'planar', 'planar', 'planar', 'prazo', 'saudar', 'saudar', 'vigilancia']","[1, 1, 1, 1, 1, 1, 1, 4, 4, 4, 4, 1, 2, 2, 1]","[]","[]",15,0,15,1
548,"['ampliacao', 'consorcio', 'coreia', 'distrito', 'igualitario', 'instituto', 'pastar', 'previsao', 'prioritario', 'prioritario', 'remessar', 'remessar', 'sabado', 'saudar', 'saudar', 'saudar', 'vigilancia']","[1, 1, 1, 1, 1, 1, 1, 1, 2, 2, 2, 2, 1, 3, 3, 3, 1]","[]","[]",17,0,17,1
552,"['conformar', 'instituto', 'instituto', 'integro', 'pastar', 'saudar', 'saudar']","[1, 2, 2, 1, 1, 2, 2]","[]","[]",7,0,7,1
553,"['estagio', 'inicialment', 'instituto', 'reuter']","[1, 1, 1, 1]","[]","[]",4,0,4,1
563,"['aglomeracao', 'facilitar', 'fundacao', 'higienizacao', 'instituto', 'instituto', 'mutacao', 'oswaldo', 'oswaldo', 'quadro', 'roraima', 'saudar', 'transmissao']","[1, 1, 1, 1, 2, 2, 1, 2, 2, 1, 1, 1, 1]","[]","[]",13,0,13,1
569,"['anteriorment', 'autoridad', 'desenvolvimento', 'desenvolvimento', 'estimular', 'europeu', 'parceria', 'periodo', 'plano', 'saudar']","[1, 1, 2, 2, 1, 1, 1, 1, 1, 1]","[]","[]",10,0,10,1
570,"['moderno', 'moderno']","[2, 2]","[]","[]",2,0,2,1
571,"['adiamento', 'atuacao', 'barroso', 'comissao', 'comissao', 'congresso', 'contencao', 'crise', 'decisao', 'decisao', 'demmg', 'enfrentamento', 'expectativa', 'funcionamento', 'inquerito', 'inquerito', 'instalacao', 'pacheco', 'plenario', 'plenario', 'recurso', 'sido', 'supremo']","[1, 1, 1, 2, 2, 1, 1, 1, 2, 2, 1, 1, 1, 1, 2, 2, 1, 1, 2, 2, 1, 1, 1]","[]","[]",23,0,23,1
573,"['ambientar', 'ambientar', 'ambientar', 'aplicacao', 'disseminacao', 'escalar', 'impacto', 'instituto', 'instituto', 'mudanca', 'observar', 'reducao', 'reflexo', 'respostar', 'saudar', 'trafego']","[3, 3, 3, 1, 1, 1, 1, 2, 2, 1, 1, 1, 1, 1, 1, 1]","[]","[]",16,0,16,1
576,"['associacao', 'celebrar', 'internar', 'isolar', 'regiao', 'servidor', 'universitario']","[1, 1, 1, 1, 1, 1, 1]","[]","[]",7,0,7,1
579,"['alvorar', 'anvisa', 'anvisa', 'anvisa', 'anvisa', 'aprovacao', 'instituto', 'necessario', 'palacio', 'vigilancia']","[1, 4, 4, 4, 4, 1, 1, 1, 1, 1]","['verdadeiro']","[1]",10,1,11,1
587,"['anteriorment', 'autoridad', 'avancar', 'crise', 'paralelo', 'preventivo', 'pulmonar', 'saudar']","[1, 1, 1, 1, 1, 1, 1, 1]","['atribuir', 'espalhar']","[1, 1]",8,2,10,1
588,"['acompanhamento', 'aurelio', 'aurelio', 'boletim', 'boletim', 'domingo', 'mello', 'mello', 'ministrar', 'ministrar', 'ministrar', 'ministrar', 'necessario', 'recuperacao', 'sabado', 'sessao', 'supremo', 'supremo']","[1, 2, 2, 2, 2, 1, 2, 2, 4, 4, 4, 4, 1, 1, 1, 1, 2, 2]","[]","[]",18,0,18,1
592,"['bbc', 'psicologo', 'quarentenar', 'quarentenar', 'reportar']","[1, 1, 2, 2, 1]","['espalhar']","[1]",5,1,6,1
593,"['internar', 'sabado', 'saudar']","[1, 1, 1]","['biblia']","[1]",3,1,4,1
594,"['academiar', 'academiar', 'preocupacao', 'presenciar', 'prever', 'previsao', 'privar', 'temor']","[2, 2, 1, 1, 1, 1, 1, 1]","['imagem']","[1]",8,1,9,1
598,"['atrasar', 'moderno', 'moderno', 'moderno', 'remessar', 'ritmar']","[1, 3, 3, 3, 1, 1]","[]","[]",6,0,6,1
599,"['acordo', 'aurelio', 'fux', 'fux', 'fux', 'integrant', 'lewandowski', 'medida', 'medida', 'mello', 'periodo', 'processo', 'processo', 'quatro', 'quatro', 'ricardo', 'spaulo', 'supremo', 'tambem', 'ultimo']","[1, 1, 3, 3, 3, 1, 1, 2, 2, 1, 1, 2, 2, 2, 2, 1, 1, 1, 1, 1]","[]","[]",20,0,20,1
612,"['afetado', 'anuncio', 'comissao', 'congresso', 'enfrentamento', 'enquadrar', 'lorenzoni', 'ministrar', 'onyx', 'onyx', 'operacionalizacao', 'pagamento', 'pagamento', 'parcelar', 'parcelar', 'parcelar', 'parcelar', 'parcelar', 'prever']","[1, 1, 1, 1, 1, 1, 1, 1, 2, 2, 1, 2, 2, 5, 5, 5, 5, 5, 1]","[]","[]",19,0,19,1
613,"['administrativo', 'administrativo', 'decisao', 'determinacao', 'exjuiz', 'guaruja', 'justicar', 'oliveira', 'triplex', 'varar']","[2, 2, 1, 1, 1, 1, 1, 1, 1, 1]","[]","[]",10,0,10,1
614,"['administrativo', 'articulacao', 'articulacao', 'carat', 'circulacao', 'coletivo', 'comunitario', 'constituicao', 'crise', 'decisao', 'determinacao', 'disseminacao', 'especializar', 'espirito', 'federativo', 'flexibilizar', 'higienizacao', 'limitacao', 'necessidad', 'necessidad', 'passageiro', 'passageiro', 'passageiro', 'passageiro', 'passageiro', 'prever', 'reducao', 'resolucao', 'resolucao', 'situacao', 'situacao', 'situacao', 'suspenso', 'transmissao', 'viagem', 'wilson', 'witzel']","[1, 2, 2, 1, 1, 1, 1, 1, 1, 1, 1, 1, 1, 1, 1, 1, 1, 1, 2, 2, 5, 5, 5, 5, 5, 1, 1, 2, 2, 3, 3, 3, 1, 1, 1, 1, 1]","['realment']","[1]",37,1,38,1
616,"['confirmado', 'relacao', 'resultado']","[1, 1, 1]","[]","[]",3,0,3,1
617,"['avancar', 'consequencia', 'hospitalizacao', 'imunizacao', 'quedo', 'reducao', 'saudar', 'surtir']","[1, 1, 1, 1, 1, 1, 1, 1]","[]","[]",8,0,8,1
618,"['advocaciager', 'ambito', 'augusto', 'entregu', 'fundacao', 'gued', 'lewandowski', 'oswaldo', 'preservar', 'respiratorio', 'resultado', 'ricardo', 'sarampo', 'spaulo', 'supremo', 'tambem']","[1, 1, 1, 1, 1, 1, 1, 1, 1, 1, 1, 1, 1, 1, 1, 1]","['imagem', 'imagem', 'privacidad']","[2, 2, 1]",16,3,19,1
620,"['calendario', 'celebrar', 'facilitar', 'limitacao', 'mandatario', 'ministrar', 'recordar', 'regrar', 'resistencia', 'supremo']","[1, 1, 1, 1, 1, 1, 1, 1, 1, 1]","[]","[]",10,0,10,1
621,"['enfermagem', 'especializar', 'parceiro', 'sabado', 'saudar', 'transmissao', 'transmissao', 'transmissao']","[1, 1, 1, 1, 1, 3, 3, 3]","['amigar', 'chorar']","[1, 1]",8,2,10,1
623,"['adulto', 'anticorpo', 'anticorpo', 'fase', 'infectar', 'inquerito', 'inquerito']","[1, 2, 2, 1, 1, 2, 2]","[]","[]",7,0,7,1
624,"['fase', 'guarulho', 'logistico', 'logistico', 'ministrar', 'planar', 'prazo', 'saudar', 'saudar']","[1, 1, 2, 2, 1, 1, 1, 2, 2]","['lixar']","[1]",9,1,10,1
625,"['balancar', 'consequencia', 'diagnosticar', 'exministro', 'exministro', 'privar', 'recordar', 'respirador', 'saudar', 'significativo']","[1, 1, 1, 2, 2, 1, 1, 1, 1, 1]","['renunciar']","[1]",10,1,11,1
626,"['araujo', 'decisao', 'enfrentamento', 'fase', 'restritivo', 'servidor']","[1, 1, 1, 1, 1, 1]","[]","[]",6,0,6,1
627,"['crise', 'europeu', 'ministrar', 'parceria', 'saudar', 'transmissao']","[1, 1, 1, 1, 1, 1]","[]","[]",6,0,6,1
629,"['condenacao', 'corpu', 'decisao', 'decisao', 'desvio', 'edson', 'fachin', 'fachin', 'guaruja', 'habea', 'instituto', 'ministrar', 'ministrar', 'movimentacao', 'processo', 'recurso', 'republico', 'triplex', 'varar']","[1, 1, 2, 2, 1, 1, 2, 2, 1, 1, 1, 2, 2, 1, 1, 1, 1, 1, 1]","[]","[]",19,0,19,1
630,"['condenacao', 'decisao', 'decisao', 'enxergar', 'governista', 'regiao', 'revogar', 'supremo']","[1, 2, 2, 1, 1, 1, 1, 1]","['atribuir']","[1]",8,1,9,1
631,"['esperancar', 'saudar']","[1, 1]","['soldar']","[1]",2,1,3,1
632,"['biliao', 'biliao', 'biliao', 'biliao', 'biliao', 'broadcast', 'congresso', 'congresso', 'congresso', 'congresso', 'desenvolvimento', 'desenvolvimento', 'infraestrutura', 'legislativo', 'marinhar', 'ministrar', 'ministrar', 'paralisar', 'pastar', 'planar', 'proposto', 'recurso', 'regiao', 'saudar', 'tesourar']","[5, 5, 5, 5, 5, 1, 4, 4, 4, 4, 2, 2, 1, 1, 1, 2, 2, 1, 1, 1, 1, 1, 1, 1, 1]","['ganhar']","[1]",25,1,26,1
633,"['adhanom', 'condicao', 'equipamento', 'equipamento', 'escassez', 'especializar', 'infectar', 'reforcar', 'saudar', 'saudar', 'saudar', 'saudar', 'tedro']","[1, 1, 2, 2, 1, 1, 1, 1, 4, 4, 4, 4, 1]","[]","[]",13,0,13,1
635,"['dosar', 'dosar', 'internacao', 'internacao', 'internacao', 'preliminar', 'saudar', 'significativo']","[2, 2, 3, 3, 3, 1, 1, 1]","['parir']","[1]",8,1,9,1
638,"['aplicacao', 'autoridad', 'comissao', 'comissao', 'comissao', 'comissao', 'conduta', 'constituicao', 'investigacao', 'supremo']","[1, 1, 4, 4, 4, 4, 1, 1, 1, 1]","['espalhar']","[1]",10,1,11,1
639,"['biliao', 'condicao', 'contencao', 'especialment', 'investigacao', 'jantar', 'necessario', 'periodo', 'recuar', 'rotina']","[1, 1, 1, 1, 1, 1, 1, 1, 1, 1]","[]","[]",10,0,10,1
640,"['acompanhamento', 'acordo', 'assintomatico', 'assistencia', 'diariament', 'enfrentamento', 'informaco', 'medida', 'necessidad', 'palacio', 'planalto', 'planalto', 'resultado', 'secretariager', 'servidor', 'servidor', 'servidor', 'suspeito', 'testagem']","[1, 1, 1, 1, 1, 1, 1, 1, 1, 1, 2, 2, 1, 1, 3, 3, 3, 1, 1]","[]","[]",19,0,19,1
643,"['afp', 'calculo', 'conformar', 'europeu', 'preliminar', 'saudar', 'situacao', 'videoconferencia']","[1, 1, 1, 1, 1, 1, 1, 1]","[]","[]",8,0,8,1
645,"['aprovacao', 'argumentar', 'concreto', 'congresso', 'congresso', 'congresso', 'legislativo', 'legislativo', 'necessidad', 'plano', 'pratico', 'privatizacao', 'supremo']","[1, 1, 1, 3, 3, 3, 2, 2, 1, 1, 1, 1, 1]","[]","[]",13,0,13,1
647,"['adicionar', 'atuam', 'destinar', 'distrito', 'esquema', 'estrategia', 'fundacao', 'igualitario', 'imunizacao', 'instituto', 'materiaprima', 'observar', 'orientacao', 'oswaldo', 'remessar', 'reuniao', 'revisar', 'saudar', 'saudar', 'saudar', 'vigilancia']","[1, 1, 1, 1, 1, 1, 1, 1, 1, 1, 1, 1, 1, 1, 1, 1, 1, 3, 3, 3, 1]","[]","[]",21,0,21,1
648,"['consecutivo', 'infectar', 'portavoz', 'propagacao', 'saudar']","[1, 1, 1, 1, 1]","[]","[]",5,0,5,1
649,"['enfatizar', 'rejeitar']","[1, 1]","['enderecar']","[1]",2,1,3,1
651,"['autoridad', 'folhar', 'integro', 'saudar']","[1, 1, 1, 1]","[]","[]",4,0,4,1
652,"['atuacao', 'decisao', 'decisao', 'exonerar', 'fundacao', 'isolar', 'justicar', 'justicar', 'quarentenar', 'ricardo']","[1, 2, 2, 1, 1, 1, 2, 2, 1, 1]","[]","[]",10,0,10,1
654,"['compilar', 'decorrencia', 'intervalar', 'levantamento', 'oficialment', 'periodo', 'recebido', 'saudar', 'subir', 'taxar']","[1, 1, 1, 1, 1, 1, 1, 1, 1, 1]","[]","[]",10,0,10,1
655,"['abordagem', 'especifico', 'necessario', 'paralisar', 'paralisar', 'prioridad', 'realizacao', 'realizacao', 'toquio']","[1, 1, 1, 2, 2, 1, 2, 2, 1]","['atribuir']","[1]",9,1,10,1
658,"['autorizacao', 'benjamin', 'contrato', 'decisao', 'destacar', 'escassez', 'especifico', 'eventualment', 'implementar', 'imunizacao', 'ministrar', 'ministrar', 'ministrar', 'necessario', 'planar', 'possibilidad', 'respostar', 'saudar', 'tcu', 'tcu', 'tcu']","[1, 1, 1, 1, 1, 1, 1, 1, 1, 1, 3, 3, 3, 1, 1, 1, 1, 1, 3, 3, 3]","[]","[]",21,0,21,1
660,"[]","[]","[]","[]",0,0,0,1
661,"['alerj', 'decisao', 'julgamento', 'justicar', 'legislativo', 'mello', 'reuniao', 'reuniao', 'wilson', 'witzel', 'witzel', 'witzel']","[1, 1, 1, 1, 1, 1, 2, 2, 1, 3, 3, 3]","['bandeiro']","[1]",12,1,13,1
664,"['alunar', 'ampliacao', 'anteriorment', 'anuncio', 'autoridad', 'circulacao', 'comunitario', 'comunitario', 'comunitario', 'conduta', 'contencao', 'decisao', 'destinar', 'epidemiar', 'fundamentar', 'fundamentar', 'henriqu', 'iniciativo', 'ministrar', 'mudanca', 'organizador', 'orientacao', 'posturar', 'privar', 'privar', 'recurso', 'reuniao', 'saudar', 'saudar', 'saudar', 'saudar', 'situacao', 'situacao', 'suspensao', 'transmissao', 'transmissao', 'transmissao', 'transmissao', 'transmissao', 'velocidad']","[1, 1, 1, 1, 1, 1, 3, 3, 3, 1, 1, 1, 1, 1, 2, 2, 1, 1, 1, 1, 1, 1, 1, 2, 2, 1, 1, 4, 4, 4, 4, 2, 2, 1, 5, 5, 5, 5, 5, 1]","[]","[]",40,0,40,1
666,"['acumular', 'amplo', 'ansiedad', 'anuncio', 'aumento', 'biliao', 'consequencia', 'consequencia', 'depressao', 'extensao', 'moderno', 'prorrogacao', 'saudar', 'saudar', 'submetido']","[1, 1, 1, 1, 1, 1, 2, 2, 1, 1, 1, 1, 2, 2, 1]","[]","[]",15,0,15,1
667,"['bolsonarista', 'colegiado', 'folhar', 'instaurar', 'integro', 'processo', 'pslrj', 'silveiro']","[1, 1, 1, 1, 1, 1, 1, 1]","['sortear']","[1]",8,1,9,1
668,"['decorrent', 'fase', 'flexibilizacao', 'previsao', 'previsto', 'regrar', 'turistico', 'turistico', 'turistico', 'visitant']","[1, 1, 1, 1, 1, 1, 3, 3, 3, 1]","['quinzena']","[1]",10,1,11,1
670,"['aglomeracao', 'atrair', 'autoridad', 'californio', 'normalment', 'propagacao', 'reuniao', 'saudar', 'situacao']","[1, 1, 1, 1, 1, 1, 1, 1, 1]","[]","[]",9,0,9,1
673,"['demrj', 'diagnosticar', 'importancia', 'internar', 'periodo', 'periodo', 'propagacao', 'reforcar']","[1, 1, 1, 1, 2, 2, 1, 1]","[]","[]",8,0,8,1
674,"['aglomeracao', 'aglomeracao', 'claudio', 'conjunto', 'decisao', 'economia', 'funcionamento', 'palacio', 'preservar', 'reuniao', 'saudar']","[2, 2, 1, 1, 1, 1, 1, 1, 1, 1, 1]","[]","[]",11,0,11,1
675,"['atuacao', 'folhar', 'integro', 'regrar', 'respostar']","[1, 1, 1, 1, 1]","[]","[]",5,0,5,1
678,"['demandar', 'dificuldad', 'espanha', 'espanha', 'estagio', 'europeu', 'habitant', 'instituto', 'internacao', 'previsto', 'quedo', 'saudar', 'testagem']","[1, 1, 2, 2, 1, 1, 1, 1, 1, 1, 1, 1, 1]","[]","[]",13,0,13,1
682,"['aliquota', 'decisao', 'diminuicao', 'economia', 'folhar', 'importacao', 'importacao', 'integro', 'reducao', 'reducao']","[1, 1, 1, 1, 1, 2, 2, 1, 2, 2]","[]","[]",10,0,10,1
683,"['restritivo']","[1]","[]","[]",1,0,1,1
684,"['compromisso', 'globonew']","[1, 1]","['assassinar', 'motorista']","[1, 1]",2,2,4,1
688,"['autoridad', 'competicao', 'competicao', 'domingo', 'espanha', 'espanha', 'fase', 'fase', 'fase', 'fase', 'mudanca', 'quarentenar', 'treinamento', 'treinamento']","[1, 2, 2, 1, 2, 2, 4, 4, 4, 4, 1, 1, 2, 2]","[]","[]",14,0,14,1
689,"['acumular', 'acumular', 'consumidor', 'crise', 'folhar', 'fundacao', 'instituto', 'integro', 'planar', 'superar']","[2, 2, 1, 1, 1, 1, 1, 1, 1, 1]","[]","[]",10,0,10,1
690,"['perspectivo']","[1]","[]","[]",1,0,1,1
691,"['absoluto', 'distrito', 'distrito', 'epidemiologico', 'habitant', 'habitant', 'periodo', 'saudar', 'suspeito', 'suspeito', 'taxar', 'taxar', 'taxar', 'taxar', 'taxar']","[1, 2, 2, 1, 2, 2, 1, 1, 2, 2, 5, 5, 5, 5, 5]","['parir', 'parir']","[2, 2]",15,2,17,1
693,"['desgastar', 'respostar']","[1, 1]","[]","[]",2,0,2,1
696,"['autoridad', 'crescimento', 'funcionamento', 'gorinchteyn', 'gorinchteyn', 'instituto']","[1, 1, 1, 2, 2, 1]","[]","[]",6,0,6,1
697,"['adotada', 'alternativo', 'concedido', 'minimizar', 'ministrar', 'opcao', 'possibilidad', 'queiroga', 'saudar', 'saudar']","[1, 1, 1, 1, 1, 1, 1, 1, 2, 2]","['mencao']","[1]",10,1,11,1
700,"['agravar', 'atuacao', 'destacar', 'expectativa', 'sabado', 'situacao']","[1, 1, 1, 1, 1, 1]","[]","[]",6,0,6,1
702,"['arthur', 'bastidor', 'desenvolvido', 'instituto', 'lira', 'lira', 'lira', 'logistico', 'ministrar', 'ministrar', 'ministrar', 'opcao', 'parceria', 'pastar', 'ppal', 'preocupacao', 'ricardo', 'saudar', 'saudar', 'saudar']","[1, 1, 1, 1, 3, 3, 3, 1, 3, 3, 3, 1, 1, 1, 1, 1, 1, 3, 3, 3]","['atirar', 'atirar']","[2, 2]",20,2,22,1
703,"['assistencia', 'elaborar', 'estrategia', 'investigacao', 'michael', 'rastreamento', 'respostar', 'saudar', 'saudar', 'saudar', 'surto', 'testagem']","[1, 1, 1, 1, 1, 1, 1, 3, 3, 3, 1, 1]","['atribuir']","[1]",12,1,13,1
705,"['administrativo', 'aprovacao', 'aprovacao', 'ccj', 'ccj', 'comissao', 'comissao', 'constituicao', 'discussao', 'fundacao', 'justicar', 'proposto', 'proposto', 'regrar', 'republico', 'servidor', 'sessao']","[1, 2, 2, 2, 2, 2, 2, 1, 1, 1, 1, 2, 2, 1, 1, 1, 1]","[]","[]",17,0,17,1
706,"['autoridad', 'claudio', 'distrito', 'necessario', 'pastar', 'republico', 'republico', 'republico']","[1, 1, 1, 1, 1, 3, 3, 3]","['agredir', 'protestar']","[1, 1]",8,2,10,1
707,"['acordo', 'confirmado', 'coreia', 'decisao', 'decisao', 'fez', 'mexico', 'portavoz', 'processo', 'reconhecimento', 'resultado']","[1, 1, 1, 2, 2, 1, 1, 1, 1, 1, 1]","[]","[]",11,0,11,1
708,"['administrativo', 'carat', 'decisao', 'demandar', 'demandar', 'destinar', 'improbidad', 'justicar', 'justicar', 'nelson', 'provisorio', 'realizacao', 'tucano', 'tucano']","[1, 1, 1, 2, 2, 1, 1, 2, 2, 1, 1, 1, 2, 2]","[]","[]",14,0,14,1
711,"['adversario', 'adversario', 'diagnosticar', 'intensivo', 'internar', 'liderar', 'saudar', 'saudar', 'transferir']","[2, 2, 1, 1, 1, 1, 2, 2, 1]","['misturar']","[1]",9,1,10,1
715,"['cenario', 'diagnosticar', 'estrategia', 'infectar', 'internar', 'positivar', 'prazo', 'reportar', 'toquio']","[1, 1, 1, 1, 1, 1, 1, 1, 1]","[]","[]",9,0,9,1
716,"['destacar', 'dificuldad', 'epidemiar', 'regiao', 'regiao', 'surtir', 'urbano']","[1, 1, 1, 2, 2, 1, 1]","[]","[]",7,0,7,1
719,"['carat', 'contribuicao', 'contribuicao', 'contribuicao', 'discussao', 'distrito', 'emendar', 'emendar', 'necessario', 'possibilidad', 'pratico', 'proposto', 'saudar', 'servidor', 'servidor']","[1, 3, 3, 3, 1, 1, 2, 2, 1, 1, 1, 1, 1, 2, 2]","[]","[]",15,0,15,1
720,"['batalhar', 'discussao']","[1, 1]","['ganhar']","[1]",2,1,3,1
721,"['arrecadar', 'arrecadar', 'destinar', 'recurso', 'saudar']","[2, 2, 1, 1, 1]","['estampar', 'estampar', 'logotipo']","[2, 2, 1]",5,3,8,1
722,"['complicacao', 'privar', 'respostar', 'risco', 'risco', 'saudar', 'transferir']","[1, 1, 1, 2, 2, 1, 1]","[]","[]",7,0,7,1
727,"['assistencia', 'autoridad', 'embora', 'funcao', 'levantamento', 'orientacao', 'orientacao', 'profissionai', 'tambem']","[1, 1, 1, 1, 1, 2, 2, 1, 1]","['ampla']","[1]",9,1,10,1
728,"['alvorar', 'aprovacao', 'articulacao', 'calculo', 'congresso', 'governista', 'palacio', 'possibilidad', 'proposto', 'prorrogacao', 'reuniao', 'ricardo']","[1, 1, 1, 1, 1, 1, 1, 1, 1, 1, 1, 1]","[]","[]",12,0,12,1
730,"['aliquota', 'aliquota', 'aliquota', 'aliquota', 'congresso', 'contribuicao', 'economia', 'excecao', 'folhar', 'gued', 'gued', 'importacao', 'ministrar', 'proposto', 'proposto', 'proposto', 'proposto', 'tributario', 'tributario']","[4, 4, 4, 4, 1, 1, 1, 1, 1, 2, 2, 1, 1, 4, 4, 4, 4, 2, 2]","[]","[]",19,0,19,1
731,"['autoridad', 'epidemiar', 'infectar', 'isolar', 'passageiro', 'positivar', 'quarentenar', 'quarentenar', 'situacao', 'tripulacao']","[1, 1, 1, 1, 1, 1, 2, 2, 1, 1]","[]","[]",10,0,10,1
736,"['aglomeracao', 'comissao', 'condenacao', 'consenso', 'constituicao', 'demrj', 'emendar', 'emendar', 'especifico', 'mudanca', 'proposto', 'suspenso', 'transmissao']","[1, 1, 1, 1, 1, 1, 2, 2, 1, 1, 1, 1, 1]","[]","[]",13,0,13,1
739,"['carat', 'confirmado', 'correspondent', 'espirito', 'medida', 'pulmonar', 'pulmonar', 'reforca', 'temporario', 'ventilatorio', 'ventilatorio']","[1, 1, 1, 1, 1, 2, 2, 1, 1, 2, 2]","[]","[]",11,0,11,1
741,"['domingo', 'lancamento', 'paralisar', 'prever']","[1, 1, 1, 1]","['compartilhar', 'imagem', 'imagem', 'sequer']","[1, 2, 2, 1]",4,4,8,1
742,"['consecutivo', 'consorcio', 'obtido', 'periodo', 'saudar']","[1, 1, 1, 1, 1]","[]","[]",5,0,5,1
743,"['atuacao', 'esforco', 'exjuiz', 'guaruja', 'julgamento', 'julgamento', 'processo', 'supremo', 'suspeicao', 'triplex', 'triplex', 'turma']","[1, 1, 1, 1, 2, 2, 1, 1, 1, 2, 2, 1]","[]","[]",12,0,12,1
747,"['aglomeracao', 'araujo', 'caxia', 'compromisso', 'decisao', 'distrito', 'domingo', 'domingo', 'duqu', 'justicar', 'justificativo', 'oficio', 'oficio', 'prazo', 'regiao', 'republico', 'saudar', 'saudar']","[1, 1, 1, 1, 1, 1, 2, 2, 1, 1, 1, 2, 2, 1, 1, 1, 2, 2]","[]","[]",18,0,18,1
749,"['acordo', 'ampliacao', 'atuacao', 'atuacao', 'colombio', 'consenso', 'equipamento', 'esforco', 'facilitar', 'iniciativo', 'iniciativo', 'iniciativo', 'necessidad', 'proposto', 'respostar', 'transferencia']","[1, 1, 2, 2, 1, 1, 1, 1, 1, 3, 3, 3, 1, 1, 1, 1]","['compartilhar', 'equador', 'intitular']","[1, 1, 1]",16,3,19,1
751,"['avancar', 'biliao', 'biliao', 'biliao', 'impactar', 'necessario', 'primeiroministro', 'recurso', 'respostar', 'saudar', 'saudar', 'surtir', 'surtir']","[1, 3, 3, 3, 1, 1, 1, 1, 1, 2, 2, 2, 2]","[]","[]",13,0,13,1
752,"['arrecadar', 'biliao', 'biliao', 'despesa', 'estimativo', 'jorg', 'oliveira', 'pastar', 'prever', 'previsao', 'secretariager']","[1, 2, 2, 1, 1, 1, 1, 1, 1, 1, 1]","[]","[]",11,0,11,1
754,"['compilar', 'processo', 'pslsp']","[1, 1, 1]","['compartilhar', 'compartilhar', 'facada']","[2, 2, 1]",3,3,6,1
756,"['decisao', 'esquema', 'fabricio', 'flavio', 'flavio', 'gabinet', 'globonew', 'justicar', 'justicar', 'oliveira', 'presenca', 'preventivo', 'preventivo', 'queiroz', 'queiroz', 'queiroz', 'rachadinha', 'saudar', 'servidor', 'suspeito']","[1, 1, 1, 2, 2, 1, 1, 2, 2, 1, 1, 2, 2, 3, 3, 3, 1, 1, 1, 1]","['imagem']","[1]",20,1,21,1
757,"['comissao', 'periodo', 'quarentenar']","[1, 1, 1]","['camisa', 'ganhar', 'ganhar', 'ganhar']","[1, 3, 3, 3]",3,4,7,1
758,"['aprovacao', 'arrecadacao', 'arrecadacao', 'arrecadacao', 'avancar', 'biliao', 'biliao', 'biliao', 'biliao', 'biliao', 'cenario', 'negativar', 'prever', 'previsao', 'sancao']","[1, 3, 3, 3, 1, 5, 5, 5, 5, 5, 1, 1, 1, 1, 1]","[]","[]",15,0,15,1
759,"['condicao', 'decisao', 'primeiroministro', 'situacao', 'suspenso', 'suspenso', 'treinamento']","[1, 1, 1, 1, 2, 2, 1]","[]","[]",7,0,7,1
760,"['adulto', 'aplicacao', 'distant', 'domingo', 'dosar', 'dosar', 'efetividad', 'habitant', 'liderar']","[1, 1, 1, 1, 2, 2, 1, 1, 1]","[]","[]",9,0,9,1
761,"['almeida', 'carla', 'carla', 'quarentenar', 'quarentenar']","[1, 2, 2, 2, 2]","['amigar']","[1]",5,1,6,1
764,"['decisao', 'desenvolvido', 'fase', 'instituto', 'parceria', 'pastar', 'pastar', 'saudar']","[1, 1, 1, 1, 1, 2, 2, 1]","[]","[]",8,0,8,1
765,"['ampliacao', 'lancamento', 'proposto', 'saneamento', 'saudar', 'sustentabilidad']","[1, 1, 1, 1, 1, 1]","[]","[]",6,0,6,1
766,"['afp', 'colombio', 'especialment', 'mexico', 'panamericana', 'saudar']","[1, 1, 1, 1, 1, 1]","[]","[]",6,0,6,1
767,"['associacao', 'autoridad', 'client', 'propagacao', 'reabrir', 'toquio', 'velocidad', 'visitant']","[1, 1, 1, 1, 1, 1, 1, 1]","[]","[]",8,0,8,1
768,"['anteriorment', 'disseminacao', 'florido', 'positivar', 'possibilidad', 'possibilidad', 'reforcar', 'respirador', 'vetar', 'vetar', 'voo', 'voo', 'voo']","[1, 1, 1, 1, 2, 2, 1, 1, 2, 2, 3, 3, 3]","[]","[]",13,0,13,1
769,"['condicao', 'interlocutor', 'respostar', 'situacao', 'trimestr']","[1, 1, 1, 1, 1]","[]","[]",5,0,5,1
773,"['decisao', 'delacao', 'delacao', 'delacao', 'determinacao', 'edson', 'exprefeito', 'exprefeito', 'fachin', 'justicar', 'ministrar', 'reafirmar', 'supremo', 'turma']","[1, 3, 3, 3, 1, 1, 2, 2, 1, 1, 1, 1, 1, 1]","[]","[]",14,0,14,1
774,"['consorcio', 'estabilidad', 'levantamento', 'saudar', 'totalizar', 'variacao']","[1, 1, 1, 1, 1, 1]","[]","[]",6,0,6,1
776,"['biliao', 'compromisso', 'conformar', 'conformar', 'dengu', 'implementacao', 'iniciativo', 'metropolitano', 'prever', 'prever', 'regiao']","[1, 1, 2, 2, 1, 1, 1, 1, 2, 2, 1]","['barragem', 'rompimento']","[1, 1]",11,2,13,1
778,"['anvisa', 'capitar', 'circulacao', 'circulacao', 'deslocamento', 'distrito', 'espirito', 'fluxo', 'fronteiro', 'gabbardo', 'limitacao', 'respostar', 'saudar', 'saudar', 'saudar', 'secretarioexecutivo', 'situacao', 'tendencia', 'voo', 'wilson', 'witzel', 'witzel', 'witzel']","[1, 1, 2, 2, 1, 1, 1, 1, 1, 1, 1, 1, 3, 3, 3, 1, 1, 1, 1, 1, 3, 3, 3]","[]","[]",23,0,23,1
779,"['contencao', 'desafiar', 'desafiar', 'destacar', 'epidemiar', 'escalar', 'europeu', 'expressar', 'gripezinha', 'posturar', 'preocupacao', 'restritivo', 'surtir', 'surtir']","[1, 2, 2, 1, 1, 1, 1, 1, 1, 1, 1, 1, 2, 2]","[]","[]",14,0,14,1
783,"['domingo', 'expressivo', 'infectar', 'mexico', 'sputnik']","[1, 1, 1, 1, 1]","[]","[]",5,0,5,1
784,"['condicao', 'congresso', 'demrj', 'despesa', 'discussao', 'economia', 'estrategia', 'federativo', 'folhar', 'gued', 'impactar', 'impactar', 'ministrar', 'pagamento', 'proposto', 'proposto', 'prorrogacao', 'prorrogar', 'recurso', 'recurso']","[1, 1, 1, 1, 1, 1, 1, 1, 1, 1, 2, 2, 1, 1, 2, 2, 1, 1, 2, 2]","['misturar']","[1]",20,1,21,1
785,"['aplicacao', 'consorcio', 'dosar', 'dosar', 'dosar', 'dosar', 'saudar']","[1, 1, 4, 4, 4, 4, 1]","[]","[]",7,0,7,1
789,"['competicao', 'integrant', 'lesao', 'preparacao']","[1, 1, 1, 1]","['filmar']","[1]",4,1,5,1
790,"['aspecto', 'aspecto', 'crise', 'economia', 'estimular', 'exministro', 'henriqu', 'importancia', 'reducao', 'republico', 'saudar', 'saudar', 'saudar', 'saudar', 'saudar']","[2, 2, 1, 1, 1, 1, 1, 1, 1, 1, 5, 5, 5, 5, 5]","['circular', 'falsar']","[1, 1]",15,2,17,1
791,"['associacao', 'boletim', 'boletim', 'intensivo', 'internacao', 'levantamento', 'levantamento', 'observar', 'obtido', 'privar', 'privar', 'privar', 'recuar', 'saudar', 'tendencia']","[1, 2, 2, 1, 1, 2, 2, 1, 1, 3, 3, 3, 1, 1, 1]","['verificar']","[1]",15,1,16,1
792,"['instituto', 'levantamento', 'orientacao', 'saudar', 'saudar', 'situacao']","[1, 1, 1, 2, 2, 1]","['questionario']","[1]",6,1,7,1
793,"['acompanhamento', 'anvisa', 'anvisa', 'apoio', 'aprovacao', 'avanca', 'calculo', 'circulacao', 'consorcio', 'consorcio', 'diariament', 'entregu', 'enxergar', 'escassez', 'estabilidad', 'estatistico', 'exemplo', 'expectativa', 'expectativa', 'fez', 'fundacao', 'gripezinha', 'henriqu', 'hipertensao', 'imunizacao', 'imunizacao', 'imunizacao', 'imunizacao', 'inconsistencia', 'informaco', 'informaco', 'instituto', 'levantamento', 'medida', 'milho', 'milho', 'milho', 'milho', 'milho', 'milho', 'nelson', 'none', 'none', 'none', 'none', 'oswaldo', 'parceria', 'periodo', 'plano', 'plantao', 'reabertura', 'recurso', 'reducao', 'relacao', 'relacao', 'secretarioexecutivo', 'spaulo', 'sputnik', 'tambem', 'tambem', 'teich', 'tendencia', 'tendencia', 'totaliza']","[1, 2, 2, 1, 1, 1, 1, 1, 2, 2, 1, 1, 1, 1, 1, 1, 1, 2, 2, 1, 1, 1, 1, 1, 4, 4, 4, 4, 1, 2, 2, 1, 1, 1, 6, 6, 6, 6, 6, 6, 1, 4, 4, 4, 4, 1, 1, 1, 1, 1, 1, 1, 1, 2, 2, 1, 1, 1, 2, 2, 1, 2, 2, 1]","[]","[]",64,0,64,1
797,"['alternativo', 'anteriorment', 'anticorpo', 'ausencia', 'funcao', 'funcao', 'habito', 'normalment', 'normalment', 'oswaldo', 'parceria', 'realizacao', 'respectivament', 'saudar', 'submetido']","[1, 1, 1, 1, 2, 2, 1, 2, 2, 1, 1, 1, 1, 1, 1]","['limao']","[1]",15,1,16,1
801,"['inglaterra', 'quarentenar']","[1, 1]","['basto', 'ganhar', 'ganhar', 'imagem']","[1, 2, 2, 1]",2,4,6,1
802,"['adversario', 'celso', 'condicao', 'enxergar', 'especialment', 'esperancar', 'favorito', 'folhar', 'jorg', 'jorg', 'justicar', 'mello', 'mello', 'mendonca', 'mendonca', 'mendonca', 'ministrar', 'ministrar', 'ministrar', 'ministrar', 'oliveira', 'oliveira']","[1, 1, 1, 1, 1, 1, 1, 1, 2, 2, 1, 2, 2, 3, 3, 3, 4, 4, 4, 4, 2, 2]","['ganhar']","[1]",22,1,23,1
808,"['boletim', 'caxia', 'caxia', 'duqu', 'duqu', 'goncalo', 'goncalo', 'infectar', 'infectar', 'investigacao', 'liderar', 'monitoramento', 'painel', 'redondo', 'saudar']","[1, 2, 2, 2, 2, 2, 2, 2, 2, 1, 1, 1, 1, 1, 1]","[]","[]",15,0,15,1
809,"['estrategia', 'folhar', 'integro', 'justicar', 'lewandowski', 'ministrar', 'ministrar', 'obtido', 'ribeiro', 'ricardo', 'supremo']","[1, 1, 1, 1, 1, 2, 2, 1, 1, 1, 1]","[]","[]",11,0,11,1
814,"['boletim', 'guarulho', 'relaxamento', 'taxar', 'taxar', 'taxar']","[1, 1, 1, 3, 3, 3]","[]","[]",6,0,6,1
815,"['bruno', 'colaborar', 'contrato', 'demanda', 'domingo', 'especifico', 'medida', 'porqu', 'proposta', 'proprio', 'proximo']","[1, 1, 1, 1, 1, 1, 1, 1, 1, 1, 1]","[]","[]",11,0,11,1
816,"['ampliacao', 'assistencia', 'contabilizar', 'diagnosticar', 'estrategico', 'facilitar', 'funcionamento', 'importancia', 'instalacao', 'regiao', 'regiao', 'regiao', 'regiao', 'saudar', 'saudar']","[1, 1, 1, 1, 1, 1, 1, 1, 1, 4, 4, 4, 4, 2, 2]","[]","[]",15,0,15,1
819,"['calamidad', 'circulacao', 'coletivo', 'concessionario', 'decorrent', 'higienizacao', 'plenario', 'prever', 'privar', 'privar', 'regulamentar', 'reuniao', 'sancao']","[1, 1, 1, 1, 1, 1, 1, 1, 2, 2, 1, 1, 1]","['usuario']","[1]",13,1,14,1
825,"['infectar', 'internar', 'isolar', 'negativar', 'parcelar', 'positivar', 'reportar', 'significativo', 'tripulacao']","[1, 1, 1, 1, 1, 1, 1, 1, 1]","[]","[]",9,0,9,1
826,"['crise', 'escassez', 'regiao', 'saudar']","[1, 1, 1, 1]","[]","[]",4,0,4,1
827,"['alternativo', 'associacao', 'escalar', 'psicologo']","[1, 1, 1, 1]","['circular', 'circular']","[2, 2]",4,2,6,1
828,"['amplo', 'anvisa', 'calendario', 'especifico', 'especifico', 'esperancar', 'estagio', 'pastar', 'patamar', 'planar', 'saudar', 'saudar']","[1, 1, 1, 2, 2, 1, 1, 1, 1, 1, 2, 2]","[]","[]",12,0,12,1
830,"['contabilizar', 'federar', 'saudar', 'superar']","[1, 1, 1, 1]","[]","[]",4,0,4,1
832,"['consolidar', 'pastar', 'saudar', 'saudar', 'saudar']","[1, 1, 3, 3, 3]","['checar', 'clicar']","[1, 1]",5,2,7,1
834,"['assistencia', 'assistencia', 'assistencia', 'atrasar', 'atrasar', 'biliao', 'biliao', 'coletivo', 'compromisso', 'consumidor', 'consumidor', 'consumidor', 'pagamento', 'planar', 'plano', 'plano', 'proposto', 'saudar', 'saudar', 'saudar', 'saudar', 'situacao']","[3, 3, 3, 2, 2, 2, 2, 1, 1, 3, 3, 3, 1, 1, 2, 2, 1, 4, 4, 4, 4, 1]","['abusar']","[1]",22,1,23,1
835,"['minoria', 'reflexo', 'situacao']","[1, 1, 1]","[]","[]",3,0,3,1
836,"['competicao', 'desenvolvimento', 'europeu', 'pagamento', 'pagamento', 'parceiro', 'parcelar', 'parcelar', 'situacao', 'temporada', 'temporada', 'temporada']","[1, 1, 1, 2, 2, 1, 2, 2, 1, 3, 3, 3]","['parir', 'patrocinador']","[1, 1]",12,2,14,1
837,"['acompanhamento', 'acordo', 'acumular', 'distrito', 'higienizacao', 'igualitario', 'imunizacao', 'internacao', 'pastar', 'pastar', 'sabado', 'saudar', 'saudar', 'saudar', 'saudar', 'saudar', 'transmissao']","[1, 1, 1, 1, 1, 1, 1, 1, 2, 2, 1, 5, 5, 5, 5, 5, 1]","[]","[]",17,0,17,1
839,"['absoluto', 'adotada', 'autoridad', 'desgastar', 'estrategia', 'europeu', 'europeu', 'europeu', 'europeu', 'interpretar', 'justicar', 'regiao', 'resolucao']","[1, 1, 1, 1, 1, 4, 4, 4, 4, 1, 1, 1, 1]","['imagem']","[1]",13,1,14,1
840,"['comissao', 'pratico', 'quarentenar', 'reajustar', 'ricardo', 'rotina']","[1, 1, 1, 1, 1, 1]","['amigar', 'camisa', 'parir']","[1, 1, 1]",6,3,9,1
844,"['adhanom', 'desenvolvimento', 'preliminar', 'saudar', 'sputnik', 'tedro']","[1, 1, 1, 1, 1, 1]","[]","[]",6,0,6,1
845,"['adulto', 'adulto', 'ambientar', 'ambientar', 'ansiedad', 'ansiedad', 'ansiedad', 'atendido', 'comportamento', 'comportamento', 'consequencia', 'depressao', 'depressao', 'depressao', 'desafiar', 'desenvolvimento', 'destacar', 'diagnosticar', 'diagnosticar', 'especifico', 'infancia', 'lancamento', 'normalment', 'parceria', 'piorar', 'preocupacao', 'reforcar', 'saudar', 'saudar', 'situacao']","[2, 2, 2, 2, 3, 3, 3, 1, 2, 2, 1, 3, 3, 3, 1, 1, 1, 2, 2, 1, 1, 1, 1, 1, 1, 1, 1, 2, 2, 1]","['adorar', 'assaltar', 'camisa', 'chorar', 'fingir', 'menino', 'menino']","[1, 1, 1, 1, 1, 2, 2]",30,7,37,1
846,"['aglomeracao', 'client', 'normalidad', 'prever']","[1, 1, 1, 1]","[]","[]",4,0,4,1
848,"['adotada', 'amplo', 'autoridad', 'comorbidad', 'estabilidad', 'estrategia', 'estrategico', 'estrategico', 'fase', 'necessidad', 'subir', 'vulneravel']","[1, 1, 1, 1, 1, 1, 2, 2, 1, 1, 1, 1]","[]","[]",12,0,12,1
849,"['almeida', 'quarentenar', 'recurso', 'rocha', 'sabado']","[1, 1, 1, 1, 1]","[]","[]",5,0,5,1
850,"['acumular', 'consorcio', 'consorcio', 'consorcio', 'contabilizar', 'estatistico', 'infectar', 'levantamento', 'levantamento', 'observar', 'periodo', 'recordar', 'tendencia', 'variacao']","[1, 3, 3, 3, 1, 1, 1, 2, 2, 1, 1, 1, 1, 1]","[]","[]",14,0,14,1
851,"['antecipar', 'anuncio', 'avancar', 'flexibilizacao', 'integro', 'recuar', 'restritivo']","[1, 1, 1, 1, 1, 1, 1]","[]","[]",7,0,7,1
854,"['adotada', 'crescimento', 'curvo', 'fase', 'instituto', 'relaxamento', 'saudar', 'saudar']","[1, 1, 1, 1, 1, 1, 2, 2]","[]","[]",8,0,8,1
856,"[]","[]","[]","[]",0,0,0,1
857,"['boletim', 'infectar', 'intensivo', 'internar', 'periferia', 'periodo', 'piorar', 'quilometro']","[1, 1, 1, 1, 1, 1, 1, 1]","[]","[]",8,0,8,1
858,"['associacao', 'colaboracao', 'iniciativo', 'instituto', 'instituto', 'vulneravel']","[1, 1, 1, 2, 2, 1]","[]","[]",6,0,6,1
859,"['antecipar', 'biliao', 'biliao', 'companhia', 'crise', 'impactar', 'perspectivo', 'quedo', 'trafego', 'trimestr', 'trimestr', 'trimestr', 'trimestr', 'trimestr']","[1, 2, 2, 1, 1, 1, 1, 1, 1, 5, 5, 5, 5, 5]","[]","[]",14,0,14,1
860,"['ambito', 'anteriorment', 'argumentar', 'argumentar', 'aurelio', 'aurelio', 'barroso', 'barroso', 'colegiado', 'condenacao', 'condenacao', 'corpu', 'corpu', 'curvo', 'decisao', 'decisao', 'decisao', 'decisao', 'decisao', 'decisao', 'decisao', 'decisao', 'divergencia', 'edson', 'edson', 'edson', 'edson', 'excecao', 'exjuiz', 'exjuiz', 'fachin', 'fachin', 'fachin', 'fachin', 'fachin', 'fachin', 'fachin', 'fachin', 'fachin', 'flexibilizar', 'fux', 'guaruja', 'guaruja', 'habea', 'habea', 'instituto', 'internar', 'julgamento', 'julgamento', 'julgamento', 'julgamento', 'julgamento', 'justicar', 'justicar', 'lewandowski', 'lewandowski', 'lewandowski', 'lewandowski', 'magistrado', 'mantido', 'mantido', 'mantido', 'mello', 'mello', 'ministrar', 'ministrar', 'ministrar', 'ministrar', 'plenario', 'plenario', 'plenario', 'plenario', 'plenario', 'plenario', 'plenario', 'plenario', 'posicionamento', 'pratico', 'precedent', 'processo', 'processo', 'processo', 'proferir', 'recurso', 'recurso', 'recurso', 'recurso', 'regrar', 'remessar', 'republico', 'requerimento', 'ricardo', 'ricardo', 'sentenca', 'supremo', 'supremo', 'supremo', 'supremo', 'supremo', 'suspeicao', 'transferir', 'triplex', 'triplex', 'turma', 'turma', 'turma', 'turma', 'varar', 'varar', 'varar']","[1, 1, 2, 2, 2, 2, 2, 2, 1, 2, 2, 2, 2, 1, 8, 8, 8, 8, 8, 8, 8, 8, 1, 4, 4, 4, 4, 1, 2, 2, 9, 9, 9, 9, 9, 9, 9, 9, 9, 1, 1, 2, 2, 2, 2, 1, 1, 5, 5, 5, 5, 5, 2, 2, 4, 4, 4, 4, 1, 3, 3, 3, 2, 2, 4, 4, 4, 4, 8, 8, 8, 8, 8, 8, 8, 8, 1, 1, 1, 3, 3, 3, 1, 4, 4, 4, 4, 1, 1, 1, 1, 2, 2, 1, 5, 5, 5, 5, 5, 1, 1, 2, 2, 4, 4, 4, 4, 3, 3, 3]","[]","[]",110,0,110,1
861,"['decisao', 'economia', 'folhar', 'gued', 'integro', 'ministrar']","[1, 1, 1, 1, 1, 1]","[]","[]",6,0,6,1
868,"['alerj', 'condicao', 'esquema', 'esquema', 'gabinet', 'implementar', 'mprj', 'mprj', 'pslrj', 'rachadinha', 'rachadinha', 'sigla', 'suspeito']","[1, 1, 2, 2, 1, 1, 2, 2, 1, 2, 2, 1, 1]","[]","[]",13,0,13,1
869,"['apurar', 'assistencia', 'barroso', 'benjamin', 'comissao', 'conduta', 'conduta', 'conduta', 'crise', 'crise', 'decisao', 'exministro', 'necessario', 'plano', 'plenario', 'posicionamento', 'supremo', 'tcu', 'tcu']","[1, 1, 1, 1, 1, 3, 3, 3, 2, 2, 1, 1, 1, 1, 1, 1, 1, 2, 2]","[]","[]",19,0,19,1
871,"['autoridad', 'deteccao', 'europeu', 'recordar', 'reducao', 'reuniao', 'situacao', 'surtir', 'taxar']","[1, 1, 1, 1, 1, 1, 1, 1, 1]","[]","[]",9,0,9,1
872,"['autoridad', 'client', 'decisao', 'esquema', 'facilitar', 'justicar', 'lavagem', 'lavagem', 'lavagem', 'mantido', 'recurso', 'sentenca']","[1, 1, 1, 1, 1, 1, 3, 3, 3, 1, 1, 1]","[]","[]",12,0,12,1
873,"['barroso', 'barroso', 'barroso', 'feriar', 'funcionamento', 'ministrar', 'ministrar', 'primeiroministro', 'supremo']","[3, 3, 3, 1, 1, 2, 2, 1, 1]","['cbn']","[1]",9,1,10,1
875,"['autoridad', 'companhia', 'companhia', 'especializar', 'especializar', 'estimativo', 'manutencao', 'manutencao', 'propagacao', 'saudar', 'saudar']","[1, 2, 2, 2, 2, 1, 2, 2, 1, 2, 2]","[]","[]",11,0,11,1
877,"['destacar', 'epidemiar', 'facilitar', 'implementacao', 'periodo']","[1, 1, 1, 1, 1]","[]","[]",5,0,5,1
878,"['academiar', 'advocaciager', 'alvorar', 'anuncio', 'descumprimento', 'descumprimento', 'justicar', 'minimizar', 'ministrar', 'nelson', 'pastar', 'salao', 'saudar', 'saudar', 'situacao', 'sugestao', 'teich']","[1, 1, 1, 1, 2, 2, 1, 1, 1, 1, 1, 1, 2, 2, 1, 1, 1]","['casamentar']","[1]",17,1,18,1
881,"['apurar', 'comissao', 'comparacao', 'esquema', 'inquerito', 'jorg', 'rejeitar', 'rejeitar', 'ribeiro']","[1, 1, 1, 1, 1, 1, 2, 2, 1]","[]","[]",9,0,9,1
883,"['aglomeracao', 'impactar', 'impactar', 'instituto', 'mudanca', 'plano', 'prever', 'regrar']","[1, 2, 2, 1, 1, 1, 1, 1]","[]","[]",8,0,8,1
884,"['domingo', 'reforcar']","[1, 1]","['facada', 'ganhar', 'lixar']","[1, 1, 1]",2,3,5,1
885,"['embora', 'exministro', 'exministro', 'inquerito', 'interferencia', 'interferencia', 'interferencia', 'investigacao', 'irregularidad', 'processo', 'processo', 'relacao', 'sociai']","[1, 2, 2, 1, 3, 3, 3, 1, 1, 2, 2, 1, 1]","[]","[]",13,0,13,1
888,"['antecipar', 'fundacao']","[1, 1]","[]","[]",2,0,2,1
892,"['assistenci', 'associacao', 'cnj', 'condicao', 'decisao', 'destinar', 'equipamento', 'federar', 'federar', 'justicar', 'levantamento', 'processo', 'recurso', 'recurso', 'regrar', 'saudar', 'saudar', 'saudar', 'saudar', 'superar', 'transferir']","[1, 1, 1, 1, 1, 1, 1, 2, 2, 1, 1, 1, 2, 2, 1, 4, 4, 4, 4, 1, 1]","[]","[]",21,0,21,1
896,"['articulacao', 'comportamento', 'congresso', 'crise', 'dialogo', 'expressivo', 'florido', 'florido', 'integrant', 'integrant', 'jantar', 'liderar', 'minimizar', 'mudanca', 'necessario', 'palacio', 'planalto', 'saudar', 'transmissao', 'wajngarten']","[1, 1, 1, 1, 1, 1, 2, 2, 2, 2, 1, 1, 1, 1, 1, 1, 1, 1, 1, 1]","['imagem']","[1]",20,1,21,1
897,"['avancar', 'comissao', 'decisao', 'ministrar', 'necessario', 'prorrogacao', 'quarentenar', 'quarentenar', 'saudar', 'surtir']","[1, 1, 1, 1, 1, 1, 2, 2, 1, 1]","[]","[]",10,0,10,1
898,"['amplo', 'estrategia', 'exministro', 'henriqu', 'indicador', 'interino', 'interino', 'ministrar', 'nelson', 'pastar', 'pastar', 'sabado', 'saudar', 'saudar', 'saudar', 'saudar', 'saudar', 'saudar', 'teich', 'teich', 'teich', 'teich', 'transicao']","[1, 1, 1, 1, 1, 2, 2, 1, 1, 2, 2, 1, 6, 6, 6, 6, 6, 6, 4, 4, 4, 4, 1]","[]","[]",23,0,23,1
901,"['anuncio', 'bancada', 'bancada', 'biliao', 'biliao', 'congresso', 'decisao', 'economia', 'emendar', 'emendar', 'henriqu', 'individuar', 'individuar', 'ministrar', 'recurso', 'recurso', 'saudar', 'saudar', 'saudar', 'videoconferencia']","[1, 2, 2, 2, 2, 1, 1, 1, 2, 2, 1, 2, 2, 1, 2, 2, 3, 3, 3, 1]","[]","[]",20,0,20,1
902,"['compromisso', 'conformar', 'economia', 'fluminens', 'gued', 'ministrar', 'saneamento', 'saneamento']","[1, 1, 1, 1, 1, 1, 2, 2]","['carrefour']","[1]",8,1,9,1
904,"['fluminens', 'funcionamento', 'goncalo', 'inicialment', 'internacao', 'levantamento', 'metropolitano', 'parceria', 'privar', 'regiao', 'temporario', 'wilson', 'witzel']","[1, 1, 1, 1, 1, 1, 1, 1, 1, 1, 1, 1, 1]","[]","[]",13,0,13,1
910,"['benjamin', 'cepa', 'cepa', 'disseminacao', 'ministrar', 'planar', 'prazo', 'regiao', 'saudar', 'tcu', 'tcu']","[1, 2, 2, 1, 1, 1, 1, 1, 1, 2, 2]","[]","[]",11,0,11,1
912,"['constatar', 'destacar', 'efetividad', 'efetividad', 'hospitalizacao', 'impactar', 'imunizacao', 'inglaterra', 'inglaterra', 'sabado', 'saudar', 'saudar']","[1, 1, 2, 2, 1, 1, 1, 2, 2, 1, 2, 2]","[]","[]",12,0,12,1
914,"['araujo', 'circulacao', 'intensivo', 'internacao', 'internacao', 'saudar', 'saudar']","[1, 1, 1, 2, 2, 2, 2]","[]","[]",7,0,7,1
916,"['folhar', 'regulamentar', 'sabatino', 'sabatino']","[1, 1, 2, 2]","[]","[]",4,0,4,1
917,"['desempenhar', 'distrito', 'rocha']","[1, 1, 1]","[]","[]",3,0,3,1
923,"['adversario', 'antecipar', 'destinar', 'estrategia', 'planar', 'pratico', 'pratico', 'republico', 'transmissao']","[1, 1, 1, 1, 1, 2, 2, 1, 1]","['fraudar', 'mentiroso']","[1, 1]",9,2,11,1
927,"['caxia', 'caxia', 'caxia', 'caxia', 'dedicar', 'descumprir', 'dificuldad', 'duqu', 'duqu', 'fluminens', 'fluminens', 'habitant', 'infectar', 'internar', 'redondo', 'sabado', 'saudar', 'taxar', 'taxar']","[4, 4, 4, 4, 1, 1, 1, 2, 2, 2, 2, 1, 1, 1, 1, 1, 1, 2, 2]","[]","[]",19,0,19,1
929,"['aprovacao', 'exigencia', 'inicialment', 'planar', 'plano', 'prazo', 'prazo', 'prazo', 'prorrogacao', 'prorrogacao', 'reuter', 'tesourar']","[1, 1, 1, 1, 1, 3, 3, 3, 2, 2, 1, 1]","[]","[]",12,0,12,1
930,"['cepa', 'contagioso', 'desembarcar', 'domingo', 'genoma', 'isolar', 'mutacao', 'mutacao', 'saudar']","[1, 1, 1, 1, 1, 1, 2, 2, 1]","[]","[]",9,0,9,1
931,"['cenario', 'comparacao', 'consequencia', 'crescimento', 'crescimento', 'demandar', 'demandar', 'demandar', 'demandar', 'demandar', 'estimativo', 'expectativa', 'extraordinario', 'implementar', 'oficialment', 'projecao', 'quedo', 'quedo', 'quedo', 'quedo', 'reflexo', 'respostar']","[1, 1, 1, 2, 2, 5, 5, 5, 5, 5, 1, 1, 1, 1, 1, 1, 4, 4, 4, 4, 1, 1]","[]","[]",22,0,22,1
932,"['araujo', 'carla', 'cenario', 'colunista', 'levantamento', 'ministrar', 'quedo']","[1, 1, 1, 1, 1, 1, 1]","[]","[]",7,0,7,1
938,"['aglomeracao', 'autorizacao', 'coletivo', 'infectar', 'infectar', 'justicar', 'justicar', 'justicar', 'justicar', 'periodo', 'periodo', 'realizacao', 'regrar', 'saudar', 'souza', 'videoconferencia', 'videoconferencia']","[1, 1, 1, 2, 2, 4, 4, 4, 4, 2, 2, 1, 1, 1, 1, 2, 2]","[]","[]",17,0,17,1
942,"['afetado', 'destacar', 'inconsistencia', 'inconsistencia', 'monitoramento', 'monitoramento', 'pagamento', 'pagamento', 'pagamento', 'processo', 'profissionai']","[1, 1, 2, 2, 2, 2, 3, 3, 3, 1, 1]","[]","[]",11,0,11,1
943,"['alckmin', 'bancada', 'calheiro', 'cerimonia', 'comissao', 'enxerga', 'estrategico', 'fez', 'geraldo', 'inquerito', 'investigacao', 'mdbal', 'nogueira', 'nogueira', 'nogueira', 'nogueira', 'planalto', 'planalto', 'planalto', 'quatro', 'sessao']","[1, 1, 1, 1, 1, 1, 1, 1, 1, 1, 1, 1, 4, 4, 4, 4, 3, 3, 3, 1, 1]","[]","[]",21,0,21,1
945,"['araujo', 'cenario', 'conjuntar', 'conjuntar', 'diplomata', 'ernesto', 'espirito', 'exministro', 'itamarati', 'quedo']","[1, 1, 2, 2, 1, 1, 1, 1, 1, 1]","['atribuir', 'versao']","[1, 1]",10,2,12,1
946,"['imunizacao', 'imunizacao', 'normalidad', 'pastar', 'saudar', 'saudar']","[2, 2, 1, 1, 2, 2]","[]","[]",6,0,6,1
949,"['aplicacao', 'carat', 'conformar', 'dosar', 'epidemiar', 'imunizacao', 'integrant', 'provincia', 'regiao']","[1, 1, 1, 1, 1, 1, 1, 1, 1]","[]","[]",9,0,9,1
951,"['expressivo', 'obtido', 'recordar', 'saudar', 'saudar', 'transmissao', 'transmissao']","[1, 1, 1, 2, 2, 2, 2]","['abencoar', 'imagem']","[1, 1]",7,2,9,1
953,"['colaboracao', 'desenvolvimento', 'equipamento', 'escalar', 'isolar', 'logistico', 'modelo', 'saudar', 'saudar', 'saudar', 'ventilacao']","[1, 1, 1, 1, 1, 1, 1, 3, 3, 3, 1]","['compartilhar', 'compartilhar']","[2, 2]",11,2,13,1
955,"['associacao', 'economia', 'economia', 'pratico', 'republico']","[1, 2, 2, 1, 1]","['greve', 'greve']","[2, 2]",5,2,7,1
961,"['adicionar', 'conformar', 'estatistico', 'impactar', 'inglaterra', 'positivar', 'preocupacao', 'recordar', 'reuter', 'saudar', 'taxar', 'vulneravel']","[1, 1, 1, 1, 1, 1, 1, 1, 1, 1, 1, 1]","['espalhar']","[1]",12,1,13,1
962,"['concessionario', 'guaruja', 'guaruja', 'martim', 'periodo', 'regrar', 'sabado', 'sabado', 'transmissao']","[1, 2, 2, 1, 1, 1, 2, 2, 1]","[]","[]",9,0,9,1
964,"['comissao', 'congresso', 'justicar', 'justicar', 'justicar', 'ministrar', 'necessario', 'pastar', 'pastar', 'prioridad', 'republico', 'servidor', 'supremo', 'supremo']","[1, 1, 3, 3, 3, 1, 1, 2, 2, 1, 1, 1, 2, 2]","[]","[]",14,0,14,1
965,"['calendario', 'milho', 'milho', 'milho', 'milho', 'publicoalvo', 'situacao']","[1, 4, 4, 4, 4, 1, 1]","[]","[]",7,0,7,1
968,"['dedicar', 'elaborar', 'inovacao', 'periferia', 'positivar', 'rotina']","[1, 1, 1, 1, 1, 1]","['misturar']","[1]",6,1,7,1
969,"['compilar', 'decorrencia', 'intervalar', 'levantamento', 'oficialment', 'periodo', 'recebido', 'saudar', 'subir', 'taxar']","[1, 1, 1, 1, 1, 1, 1, 1, 1, 1]","[]","[]",10,0,10,1
970,"['atendido', 'atuacao', 'desenvolvimento', 'destinar', 'emendar', 'emendar', 'investigacao', 'levantamento', 'marinhar', 'marinhar', 'orcamentaria', 'pastar', 'pastar', 'saneamento', 'saudar', 'superar', 'tcu', 'volumar']","[1, 1, 1, 1, 2, 2, 1, 1, 2, 2, 1, 2, 2, 1, 1, 1, 1, 1]","[]","[]",18,0,18,1
975,"['celebrar', 'confederacao', 'obtido']","[1, 1, 1]","[]","[]",3,0,3,1
976,"['anticorpo', 'avancar', 'companhia', 'economia', 'estagio', 'expectativa', 'moderno', 'recuperacao', 'reuter', 'saudar', 'subir', 'variacao', 'vespera']","[1, 1, 1, 1, 1, 1, 1, 1, 1, 1, 1, 1, 1]","['ganhar']","[1]",13,1,14,1
977,"['sugestao']","[1]","['revoltar']","[1]",1,1,2,1
981,"['antecipar', 'atrair', 'estrategia', 'federar', 'fronteiro', 'fronteiro', 'funcionamento', 'interrupcao', 'modelo', 'turista', 'turista', 'turista']","[1, 1, 1, 1, 2, 2, 1, 1, 1, 3, 3, 3]","['parir']","[1]",12,1,13,1
983,"['acordo', 'aplicacao', 'apoio', 'autonomia', 'conselho', 'conselho', 'conselho', 'distrito', 'esquema', 'imunizacao', 'instituto', 'milho', 'milho', 'necessidad', 'oficio', 'operacionalizacao', 'plano', 'prioritario', 'prioritario']","[1, 1, 1, 1, 3, 3, 3, 1, 1, 1, 1, 2, 2, 1, 1, 1, 1, 2, 2]","[]","[]",19,0,19,1
986,"['desenvolvimento', 'gorinchteyn', 'gorinchteyn', 'habitant', 'internacao', 'necessidad', 'regiao', 'saudar', 'saudar']","[1, 2, 2, 1, 1, 1, 1, 2, 2]","[]","[]",9,0,9,1
987,"['antonio', 'reuniao']","[1, 1]","[]","[]",2,0,2,1
989,"['absoluto', 'boletim', 'comparacao', 'crescimento', 'epidemiologico', 'levantamento', 'observar', 'observar']","[1, 1, 1, 1, 1, 1, 2, 2]","['verificar']","[1]",8,1,9,1
991,"['avancar', 'consolidar', 'expectativa']","[1, 1, 1]","[]","[]",3,0,3,1
992,"['cirurgico', 'intensivo', 'reuter']","[1, 1, 1]","['imagem']","[1]",3,1,4,1
995,"['arrecadar', 'colleg', 'converso', 'desafiar', 'destacar', 'exercicio', 'expressar', 'mudanca', 'preservar', 'preservar', 'quarentenar', 'rotina', 'saudad', 'saudad', 'situacao', 'souza', 'ufrj']","[1, 1, 1, 1, 1, 1, 1, 1, 2, 2, 1, 1, 2, 2, 1, 1, 1]","['ilustrar', 'sortir']","[1, 1]",17,2,19,1
996,"['antecipar', 'condicao', 'estimativo', 'imunizacao', 'imunizacao', 'imunizacao', 'ministrar', 'queiroga', 'reuniao', 'saudar', 'saudar', 'wellington', 'wellington', 'wellington']","[1, 1, 1, 3, 3, 3, 1, 1, 1, 2, 2, 3, 3, 3]","[]","[]",14,0,14,1
997,"['dinamarca', 'dinamarca', 'espanha', 'mutacao', 'preocupacao', 'surto', 'tambem', 'transmissao']","[2, 2, 1, 1, 1, 1, 1, 1]","[]","[]",8,0,8,1
999,"['adversario', 'bandeirant', 'gabinet', 'henriqu', 'integrant', 'ministrar', 'negativar', 'palacio', 'palacio', 'palacio', 'pastar', 'permanencia', 'planalto', 'positivar', 'reforcar', 'saudar', 'tucano']","[1, 1, 1, 1, 1, 1, 1, 3, 3, 3, 1, 1, 1, 1, 1, 1, 1]","['atribuir']","[1]",17,1,18,1
1000,"['acordo', 'acumular', 'adhanom', 'disseminacao', 'esforco', 'esquema', 'europeu', 'impulsionar', 'infectar', 'prazo', 'preocupacao', 'reuter', 'saudar', 'saudar', 'tedro', 'tedro', 'tedro', 'vulneravel']","[1, 1, 1, 1, 1, 1, 1, 1, 1, 1, 1, 1, 2, 2, 3, 3, 3, 1]","[]","[]",18,0,18,1
1003,"['azevedo', 'congresso', 'excecao', 'individuar', 'ministrar']","[1, 1, 1, 1, 1]","[]","[]",5,0,5,1
1004,"['emendar', 'enfrentamento', 'henriqu', 'ministrar', 'ministrar', 'pastar', 'reafirmar', 'reuniao', 'saudar']","[1, 1, 1, 2, 2, 1, 1, 1, 1]","[]","[]",9,0,9,1
1008,"['adulto', 'andrea', 'autonomia', 'fase', 'infancia', 'movimentacao']","[1, 1, 1, 1, 1, 1]","['ganhar']","[1]",6,1,7,1
1010,"['argumentar', 'competicao', 'decorrencia', 'elaborar', 'funcao', 'paralisar', 'possibilidad', 'sugestao', 'treinamento']","[1, 1, 1, 1, 1, 1, 1, 1, 1]","[]","[]",9,0,9,1
1012,"['atuacao', 'congresso', 'converso', 'demrj', 'dificuldad', 'emendar', 'funcao', 'ministrar', 'ministrar', 'mudanca', 'mudanca', 'mudanca', 'opcao', 'proposto', 'regulamentar']","[1, 1, 1, 1, 1, 1, 1, 2, 2, 3, 3, 3, 1, 1, 1]","[]","[]",15,0,15,1
1016,"['associacao', 'contabilizar', 'correspondent', 'correspondent', 'estrategia', 'isolar', 'particularment', 'saudar', 'saudar', 'videoconferencia', 'vulneravel']","[1, 1, 2, 2, 1, 1, 1, 2, 2, 1, 1]","[]","[]",11,0,11,1
1019,"['araujo', 'carla', 'carla', 'colunista', 'colunista', 'companhia', 'gued', 'gued', 'proprio', 'tambem', 'trimestr']","[1, 2, 2, 2, 2, 1, 2, 2, 1, 1, 1]","[]","[]",11,0,11,1
1021,"['acordo', 'acordo', 'consorcio', 'contrato', 'habitant', 'imunizacao', 'imunizacao', 'imunizacao', 'instituto', 'instituto', 'margem', 'milho', 'milho', 'none', 'percepcao', 'proporcao', 'relacao', 'resultado', 'sabado', 'sendo', 'sendo', 'serao', 'tambem', 'velocidad']","[2, 2, 1, 1, 1, 3, 3, 3, 2, 2, 1, 2, 2, 1, 1, 1, 1, 1, 1, 2, 2, 1, 1, 1]","[]","[]",24,0,24,1
1025,"['ambientar', 'comissao', 'destacar']","[1, 1, 1]","['incendio']","[1]",3,1,4,1
1027,"['decisao', 'julgamento', 'justicar', 'realizacao', 'recurso', 'rossi']","[1, 1, 1, 1, 1, 1]","[]","[]",6,0,6,1
1029,"['destinar', 'emprestimo', 'mudanca', 'prazo', 'prazo', 'privar', 'prorrogacao', 'prorrogar']","[1, 1, 1, 2, 2, 1, 1, 1]","[]","[]",8,0,8,1
1037,"['adiamento', 'folhar', 'integro']","[1, 1, 1]","['desfilar']","[1]",3,1,4,1
1038,"['acumular', 'balancar', 'biliao', 'comparacao', 'economia', 'exportacao', 'exportacao', 'importacao', 'importacao', 'quedo', 'quedo', 'superar']","[1, 1, 1, 1, 1, 2, 2, 2, 2, 2, 2, 1]","[]","[]",12,0,12,1
1044,"['afetado', 'afetado', 'alcolumbr', 'congresso', 'congresso', 'congresso', 'congresso', 'demap', 'feriar', 'justicar', 'sessao', 'sessao', 'supremo']","[2, 2, 1, 4, 4, 4, 4, 1, 1, 1, 2, 2, 1]","[]","[]",13,0,13,1
1046,"['fabricio', 'justicar', 'queiroz', 'randolf']","[1, 1, 1, 1]","['catedr']","[1]",4,1,5,1
1048,"['circulacao', 'circulacao', 'diretoria', 'fundacao', 'integro', 'monitoramento', 'varga']","[2, 2, 1, 1, 1, 1, 1]","['circular', 'visualizacao']","[1, 1]",7,2,9,1
1053,"['alcolumbr', 'comissao', 'consenso', 'economia', 'enfrentamento', 'entendimento', 'interlocutor', 'legislativo', 'necessario', 'paralisar', 'presenciar', 'prioridad', 'prioridad', 'prioridad', 'proposto', 'reuniao', 'semestr', 'tramitacao', 'tramitar', 'tramitar', 'tributario', 'tributario', 'tributario', 'tributario']","[1, 1, 1, 1, 1, 1, 1, 1, 1, 1, 1, 3, 3, 3, 1, 1, 1, 1, 2, 2, 4, 4, 4, 4]","[]","[]",24,0,24,1
1054,"['constituicao', 'constituicao', 'decisao', 'palacio', 'planalto']","[2, 2, 1, 1, 1]","[]","[]",5,0,5,1
1057,"['comissao', 'depressao', 'estagio', 'inglaterra', 'isolar', 'isolar', 'isolar', 'quarentenar', 'saudar']","[1, 1, 1, 1, 3, 3, 3, 1, 1]","['menino', 'parir', 'verdadeiro']","[1, 1, 1]",9,3,12,1
1059,"['desenvolvido', 'efetividad', 'fase', 'globonew']","[1, 1, 1, 1]","[]","[]",4,0,4,1
1060,"['enfrentamento', 'enfrentamento', 'enfrentamento', 'reconhecimento']","[3, 3, 3, 1]","[]","[]",4,0,4,1
1061,"['inglaterra', 'oposto', 'positivar', 'recuperacao', 'situacao']","[1, 1, 1, 1, 1]","['abencoar']","[1]",5,1,6,1
1062,"['agravar', 'associacao', 'dinamarca', 'espanha', 'geografia', 'hospitalizacao', 'hospitalizacao', 'hospitalizar', 'hospitalizar', 'hospitalizar', 'hospitalizar', 'instituto', 'internacao', 'investigacao', 'investigacao', 'investigacao', 'journal', 'journal', 'liderar', 'negativar', 'negativar', 'piorar', 'positivar', 'positivar', 'presenca', 'regiao', 'saudar']","[1, 1, 1, 1, 1, 2, 2, 4, 4, 4, 4, 1, 1, 3, 3, 3, 2, 2, 1, 2, 2, 1, 2, 2, 1, 1, 1]","[]","[]",27,0,27,1
1067,"['apostar', 'autorizacao', 'especifico', 'expectativa', 'fase', 'fase', 'imunizacao', 'imunizacao', 'inicialment', 'observar', 'parceiro', 'parceiro', 'parcelar', 'regiao']","[1, 1, 1, 1, 2, 2, 2, 2, 1, 1, 2, 2, 1, 1]","[]","[]",14,0,14,1
1069,"['desafio', 'fez', 'humberto', 'sociai']","[1, 1, 1, 1]","[]","[]",4,0,4,1
1070,"['atrair', 'disseminacao', 'kong', 'kong']","[1, 1, 2, 2]","[]","[]",4,0,4,1
1073,"['aumento', 'conjuntar', 'desempenhar', 'flexibilizar', 'fluxo', 'fluxo', 'fluxo', 'levantamento', 'movimentacao', 'parceria', 'regiao', 'regiao', 'regiao', 'regiao', 'respectivament', 'sudest', 'sudest']","[1, 1, 1, 1, 3, 3, 3, 1, 1, 1, 4, 4, 4, 4, 1, 2, 2]","[]","[]",17,0,17,1
1075,"['arrecadar', 'domingo', 'marilia', 'mendonca', 'periferia', 'periodo', 'saudar', 'transmissao', 'urbano', 'vulneravel']","[1, 1, 1, 1, 1, 1, 1, 1, 1, 1]","[]","[]",10,0,10,1
1076,"['academiar', 'autorizacao', 'exercicio', 'flavio', 'republico', 'treinamento', 'treinamento', 'treino']","[1, 1, 1, 1, 1, 2, 2, 1]","[]","[]",8,0,8,1
1077,"['desmatamento', 'desmatamento', 'deteccao', 'instituto', 'monitoramento', 'monitoramento', 'monitoramento', 'palacio', 'planalto']","[2, 2, 1, 1, 3, 3, 3, 1, 1]","['imagem']","[1]",9,1,10,1
1079,"['alcolumbr', 'alcolumbr', 'alcolumbr', 'conduta', 'conformar', 'congresso', 'demap', 'diagnosticar', 'negativar', 'positivar', 'saudar']","[3, 3, 3, 1, 1, 1, 1, 1, 1, 1, 1]","[]","[]",11,0,11,1
1083,"['autoridad', 'colunista', 'colunista', 'investigacao', 'investigacao', 'investigacao', 'sabado', 'tendencia']","[1, 2, 2, 3, 3, 3, 1, 1]","['minutar']","[1]",8,1,9,1
1085,"['acordo', 'apoio', 'apoio', 'apoio', 'apoio', 'bancada', 'concorrent', 'defendido', 'demmg', 'jorg', 'levantamento', 'necessario', 'necessario', 'oficialment', 'pacheco', 'pacheco', 'pacheco', 'palacio', 'planalto', 'pslsp', 'tambem']","[1, 4, 4, 4, 4, 1, 1, 1, 1, 1, 1, 2, 2, 1, 3, 3, 3, 1, 1, 1, 1]","[]","[]",21,0,21,1
1086,"['ambientar', 'colegio', 'decisao', 'dificuldad', 'etapa', 'periodo', 'rotina']","[1, 1, 1, 1, 1, 1, 1]","[]","[]",7,0,7,1
1087,"['palac', 'palac', 'palac', 'palac', 'palac', 'palac', 'palac', 'palac', 'palac', 'palac', 'palac', 'palac', 'palac', 'palac', 'palac', 'pslrj', 'pslrj', 'silveiro', 'silveiro', 'silveiro', 'silveiro', 'silveiro', 'silveiro', 'silveiro', 'silveiro', 'silveiro', 'silveiro', 'silveiro', 'silveiro', 'silveiro', 'silveiro', 'silveiro', 'silveiro', 'silveiro', 'supremo', 'transferir']","[15, 15, 15, 15, 15, 15, 15, 15, 15, 15, 15, 15, 15, 15, 15, 2, 2, 17, 17, 17, 17, 17, 17, 17, 17, 17, 17, 17, 17, 17, 17, 17, 17, 17, 1, 1]","['bandeiro', 'bandeiro', 'bandeiro', 'bandeiro', 'camisa', 'camisa', 'camisa', 'cartaz', 'cartaz', 'cartaz', 'cartaz', 'imagem']","[4, 4, 4, 4, 3, 3, 3, 4, 4, 4, 4, 1]",36,12,48,1
1088,"['argumentar', 'argumentar', 'atuacao', 'atuacao', 'decisao', 'equilibrio', 'especifico', 'julgamento', 'julgamento', 'justicar', 'magistrado', 'necessario', 'prever', 'sentenca', 'suspeicao', 'suspeicao', 'turma']","[2, 2, 2, 2, 1, 1, 1, 2, 2, 1, 1, 1, 1, 1, 2, 2, 1]","['instrucao']","[1]",17,1,18,1
1089,"['adicionar', 'adulto']","[1, 1]","['amigar', 'compartilhar']","[1, 1]",2,2,4,1
1090,"['congresso', 'pagamento', 'pagamento', 'pagamento', 'republico']","[1, 3, 3, 3, 1]","['versao']","[1]",5,1,6,1
1091,"['balancar', 'boletim', 'contabilizar', 'distrito', 'espirito', 'monitoramento', 'oliveira', 'oliveira', 'saudar', 'saudar', 'saudar', 'subir', 'suspeito', 'suspeito', 'suspeito', 'vigilancia']","[1, 1, 1, 1, 1, 1, 2, 2, 3, 3, 3, 1, 3, 3, 3, 1]","[]","[]",16,0,16,1
1093,"['ambito', 'delacao', 'distrito', 'forcatarefa', 'fundacao', 'justicar', 'justicar', 'montant', 'oswaldo', 'recurso', 'recurso']","[1, 1, 1, 1, 1, 2, 2, 1, 1, 2, 2]","[]","[]",11,0,11,1
1094,"['chefiar', 'exonerar', 'funcao', 'gabinet', 'nomeacao', 'republico', 'republico', 'ricardo', 'secretariager', 'souza', 'souza', 'souza']","[1, 1, 1, 1, 1, 2, 2, 1, 1, 3, 3, 3]","[]","[]",12,0,12,1
1095,"['concessionario', 'decorrent', 'dificuldad', 'impacto', 'manutencao', 'notificar', 'oficio', 'oficio', 'preocupacao', 'randolf', 'randolf', 'randolf', 'reducao']","[1, 1, 1, 1, 1, 1, 2, 2, 1, 3, 3, 3, 1]","[]","[]",13,0,13,1
1096,"['almeida', 'reforcar', 'salao']","[1, 1, 1]","['amigar', 'caixao', 'chorar', 'chorar', 'chorar', 'compartilhar']","[1, 1, 3, 3, 3, 1]",3,6,9,1
1099,"['alvorar', 'integro', 'palacio', 'prever', 'prever', 'reajustar', 'reajustar', 'reducao']","[1, 1, 1, 2, 2, 2, 2, 1]","[]","[]",8,0,8,1
1101,"['assintomatico', 'boletim', 'boletim', 'boletim', 'constatar', 'domingo', 'domingo', 'examinar', 'prever', 'saudar', 'saudar', 'saudar', 'surtir', 'tripulacao']","[1, 3, 3, 3, 1, 2, 2, 1, 1, 3, 3, 3, 1, 1]","['garganta']","[1]",14,1,15,1
1102,"['adhanom', 'afp', 'desenvolvimento', 'disseminacao', 'especializar', 'iniciativo', 'necessidad', 'resistencia', 'resistencia', 'saudar', 'tedro']","[1, 1, 1, 1, 1, 1, 1, 2, 2, 1, 1]","[]","[]",11,0,11,1
1104,"['argumentar', 'biliao', 'mudanca', 'presenca']","[1, 1, 1, 1]","[]","[]",4,0,4,1
1105,"['autorizacao', 'cnj', 'decisao', 'justicar', 'justicar', 'lavagem']","[1, 1, 1, 2, 2, 1]","['rompimento', 'trafico']","[1, 1]",6,2,8,1
1108,"['fundacao', 'fundacao', 'inedito', 'nomeacao', 'presidir']","[2, 2, 1, 1, 1]","[]","[]",5,0,5,1
1110,"['arthur', 'consorcio', 'intervalar', 'levantamento', 'recordar', 'reportar', 'saudar', 'saudar', 'saudar']","[1, 1, 1, 1, 1, 1, 3, 3, 3]","[]","[]",9,0,9,1
1113,"['concedido', 'domingo', 'escalar', 'fase', 'imunizacao', 'imunizacao', 'nogueira']","[1, 1, 1, 1, 2, 2, 1]","[]","[]",7,0,7,1
1116,"['depoimento', 'depoimento', 'motivacao', 'oliveira', 'oliveira']","[2, 2, 1, 2, 2]","['adelio', 'adelio', 'bispar', 'bispar', 'facada']","[2, 2, 2, 2, 1]",5,5,10,1
1117,"['economia', 'etapa', 'integro', 'orcamentaria', 'previsto', 'proposto']","[1, 1, 1, 1, 1, 1]","[]","[]",6,0,6,1
1118,"['balancar', 'publicoalvo', 'publicoalvo', 'saudar', 'situacao']","[1, 2, 2, 1, 1]","[]","[]",5,0,5,1
1119,"['ambientar', 'cardiologista', 'cardiologista', 'destacar', 'saudar']","[1, 2, 2, 1, 1]","['pelar']","[1]",5,1,6,1
1123,"['complicacao', 'decorrent', 'gabinet', 'medeiro', 'medeiro']","[1, 1, 1, 2, 2]","['atribuir', 'circular', 'gravacao', 'gravacao']","[1, 1, 2, 2]",5,4,9,1
1124,"['algun', 'investigacao', 'necessario', 'sendo', 'sendo', 'sido', 'sociai', 'tambem']","[1, 1, 1, 2, 2, 1, 1, 1]","['caixao', 'caixao', 'imagem', 'imagem', 'imagem', 'vazio', 'vazio', 'verificacao']","[2, 2, 3, 3, 3, 2, 2, 1]",8,8,16,1
1125,"['autorizacao', 'bandeirant', 'defendido', 'palacio', 'prever', 'revogar', 'saudar', 'saudar', 'saudar']","[1, 1, 1, 1, 1, 1, 3, 3, 3]","[]","[]",9,0,9,1
1126,"['compromisso', 'condicao', 'exjuiz', 'infectar', 'intenso', 'respiratorio', 'saudar']","[1, 1, 1, 1, 1, 1, 1]","[]","[]",7,0,7,1
1127,"['afastamento', 'forcatarefa', 'motivacao', 'motivacao', 'republico', 'republico', 'republico', 'respostar', 'saudar', 'suspeito', 'wilson', 'witzel', 'witzel', 'witzel']","[1, 1, 2, 2, 3, 3, 3, 1, 1, 1, 1, 3, 3, 3]","['fraudar']","[1]",14,1,15,1
1131,"['argumentar', 'arrecadacao', 'decisao', 'disseminacao', 'economia', 'espirito', 'fux', 'ministrar', 'ministrar', 'ministrar', 'recurso', 'reflexo', 'supremo', 'supremo']","[1, 1, 1, 1, 1, 1, 1, 3, 3, 3, 1, 1, 2, 2]","[]","[]",14,0,14,1
1134,"['calamidad', 'equivalent', 'exemplo', 'medida', 'necessidad', 'proposta']","[1, 1, 1, 1, 1, 1]","[]","[]",6,0,6,1
1135,"['arthur', 'articulacao', 'autorizacao', 'biliao', 'conformar', 'contemplar', 'demmg', 'desenvolvimento', 'destinar', 'domingo', 'lira', 'lira', 'pacheco', 'planalto', 'ppal', 'recurso', 'recurso', 'recurso', 'rossi']","[1, 1, 1, 1, 1, 1, 1, 1, 1, 1, 2, 2, 1, 1, 1, 3, 3, 3, 1]","[]","[]",19,0,19,1
1137,"['absoluto', 'adotada', 'alteracao', 'cometido', 'congresso', 'congresso', 'contencao', 'funcionamento', 'impactar', 'observar', 'palacio', 'planalto', 'possibilidad', 'pratico', 'pratico', 'provisorio']","[1, 1, 1, 1, 2, 2, 1, 1, 1, 1, 1, 1, 1, 2, 2, 1]","[]","[]",16,0,16,1
1138,"['bruto', 'crise', 'economia', 'economia', 'economia', 'economia', 'indicador', 'medida', 'medida', 'pib', 'pib', 'pib', 'projeco', 'sendo']","[1, 1, 4, 4, 4, 4, 1, 2, 2, 3, 3, 3, 1, 1]","[]","[]",14,0,14,1
1140,"['crise', 'disseminacao', 'epidemiar', 'ministrar', 'precaucao', 'prever', 'previsto', 'recurso', 'respiratorio', 'saudar', 'saudar', 'vigilancia']","[1, 1, 1, 1, 1, 1, 1, 1, 1, 2, 2, 1]","['espalhar']","[1]",12,1,13,1
1142,"['adiamento', 'antonio', 'comissao', 'depoimento', 'domingo', 'domingo', 'equilibrio', 'exministro', 'inquerito', 'nogueira', 'oliveira', 'saudar', 'saudar', 'situacao', 'superar', 'varar']","[1, 1, 1, 1, 2, 2, 1, 1, 1, 1, 1, 2, 2, 1, 1, 1]","['imagem']","[1]",16,1,17,1
1144,"['apostar', 'araujo', 'concorrent', 'crise', 'temporada']","[1, 1, 1, 1, 1]","['amigar', 'amigar']","[2, 2]",5,2,7,1
1145,"['bancada', 'ccj', 'ccj', 'comissao', 'comissao', 'comissao', 'condicao', 'constituicao', 'dialogo', 'funcao', 'justicar', 'justificativo', 'minoria', 'presidir', 'regrar', 'reuniao']","[1, 2, 2, 3, 3, 3, 1, 1, 1, 1, 1, 1, 1, 1, 1, 1]","[]","[]",16,0,16,1
1147,"['comparacao', 'desenvolvimento', 'dificuldad', 'especializar', 'journal', 'negativar', 'observar', 'positivar', 'respiratorio', 'suspeito']","[1, 1, 1, 1, 1, 1, 1, 1, 1, 1]","[]","[]",10,0,10,1
1150,"['agravar', 'assistencia', 'capitar', 'cenario', 'comissao', 'contribuicao', 'converso', 'elaborar', 'elaborar', 'enfrentamento', 'epidemiologico', 'especifico', 'orientacao', 'primario', 'primario', 'primario', 'primario', 'reuniao', 'saudar', 'saudar', 'saudar', 'saudar', 'saudar', 'saudar', 'saudar', 'saudar', 'saudar']","[1, 1, 1, 1, 1, 1, 1, 2, 2, 1, 1, 1, 1, 4, 4, 4, 4, 1, 9, 9, 9, 9, 9, 9, 9, 9, 9]","[]","[]",27,0,27,1
1151,"['campino', 'campino', 'constatar', 'epidemiar', 'infeccioso', 'infectar', 'infectar', 'infectar', 'molecular', 'mutacao', 'mutacao', 'saudar', 'transmissao', 'transmissao', 'variacao']","[2, 2, 1, 1, 1, 3, 3, 3, 1, 2, 2, 1, 2, 2, 1]","['circular', 'humanar', 'humanar', 'humanar']","[1, 3, 3, 3]",15,4,19,1
1153,"['desmatamento', 'desmatamento', 'desmatamento', 'inicialment', 'instituto', 'monitoramento', 'observar', 'observar', 'quedo', 'subir']","[3, 3, 3, 1, 1, 1, 2, 2, 1, 1]","[]","[]",10,0,10,1
1154,"['especialment', 'justificativo', 'positivar', 'regrar', 'temporada']","[1, 1, 1, 1, 1]","['imagem']","[1]",5,1,6,1
1156,"['client', 'client', 'situacao', 'vetar']","[2, 2, 1, 1]","['imagem']","[1]",4,1,5,1
1158,"['associacao', 'regiao']","[1, 1]","[]","[]",2,0,2,1
1159,"['anteontem', 'diagnosticar', 'fase', 'gabbardo', 'gabbardo', 'pastar', 'preocupacao', 'previsao', 'saudar', 'saudar']","[1, 1, 1, 2, 2, 1, 1, 1, 2, 2]","[]","[]",10,0,10,1
1161,"['adiamento', 'autorizacao', 'desenvolvido', 'facilitar', 'fase', 'fase', 'instituto', 'justificativo', 'parceria', 'pastar', 'saudar', 'secretarioexecutivo']","[1, 1, 1, 1, 2, 2, 1, 1, 1, 1, 1, 1]","[]","[]",12,0,12,1
1162,"['acordo', 'acordo', 'armazenamento', 'circulacao', 'contrato', 'contrato', 'contrato', 'contribuicao', 'crise', 'definitivo', 'especifico', 'estrategia', 'implementar', 'medida', 'medida', 'milho', 'milho', 'milho', 'milho', 'milho', 'milho', 'modelo', 'necessidad', 'none', 'none', 'porqu', 'queiroga', 'queiroga', 'queiroga', 'queiroga', 'reducao', 'resultado', 'risco', 'tambem', 'tambem', 'testagem', 'testagem']","[2, 2, 1, 1, 3, 3, 3, 1, 1, 1, 1, 1, 1, 2, 2, 6, 6, 6, 6, 6, 6, 1, 1, 2, 2, 1, 4, 4, 4, 4, 1, 1, 1, 2, 2, 2, 2]","[]","[]",37,0,37,1
1163,"['assintomatico', 'contabilizar', 'dificultar', 'escassez', 'gabbardo', 'presenca', 'presenca', 'saudar', 'saudar', 'subir', 'taxar', 'velocidad']","[1, 1, 1, 1, 1, 2, 2, 2, 2, 1, 1, 1]","['verificar']","[1]",12,1,13,1
1164,"['exministro', 'henriqu', 'nelson']","[1, 1, 1]","[]","[]",3,0,3,1
1165,"['epidemiar', 'minimizar', 'minimizar', 'quarentenar', 'reuter', 'sabado', 'saneamento', 'saudar']","[1, 2, 2, 1, 1, 1, 1, 1]","[]","[]",8,0,8,1
1166,"['ampliacao', 'calamidad', 'contrato', 'contrato', 'fase', 'fase', 'pagamento', 'pagamento', 'parcelar', 'parcelar', 'parcelar', 'periodo', 'periodo', 'suspensao', 'suspensao']","[1, 1, 2, 2, 2, 2, 2, 2, 3, 3, 3, 2, 2, 2, 2]","[]","[]",15,0,15,1
1170,"['claudio', 'cupula', 'desempenhar', 'observar', 'recurso', 'reuniao']","[1, 1, 1, 1, 1, 1]","[]","[]",6,0,6,1
1171,"['aprovacao', 'prazo', 'preventivo', 'prever', 'queiroz', 'regrar', 'saudar', 'saudar', 'tramitar', 'vetar']","[1, 1, 1, 1, 1, 1, 2, 2, 1, 1]","[]","[]",10,0,10,1
1172,"['adulto', 'autonomia', 'autorizacao', 'carat', 'cenario', 'conformar', 'correspondent', 'decorrencia', 'demandar', 'distrito', 'enfrentamento', 'necessario', 'pastar', 'recurso', 'reforcar', 'saudar', 'saudar', 'temporario']","[1, 1, 1, 1, 1, 1, 1, 1, 1, 1, 1, 1, 1, 1, 1, 2, 2, 1]","[]","[]",18,0,18,1
1174,"['adversario', 'destacar', 'exgovernador', 'exprefeito']","[1, 1, 1, 1]","[]","[]",4,0,4,1
1175,"['consecutivo', 'crise', 'desenvolvimento', 'epidemiologico', 'internacao', 'internacao', 'internacao', 'quedo', 'reducao', 'regiao', 'ribeiro', 'saudar', 'saudar', 'secretarioexecutivo', 'taxar']","[1, 1, 1, 1, 3, 3, 3, 1, 1, 1, 1, 2, 2, 1, 1]","[]","[]",15,0,15,1
1179,"['adulto', 'biliao', 'necessario', 'orientacao', 'parcelar', 'pastar', 'planar', 'prorrogacao', 'prorrogacao', 'prorrogar', 'prorrogar', 'prorrogar', 'saudar', 'saudar', 'saudar', 'saudar', 'taxar']","[1, 1, 1, 1, 1, 1, 1, 2, 2, 3, 3, 3, 4, 4, 4, 4, 1]","[]","[]",17,0,17,1
1183,"['distrito', 'dosar', 'esquema', 'fase', 'igualitario', 'instituto', 'necessario', 'operacionalizacao', 'pastar', 'pastar', 'periodo', 'planar', 'publicoalvo', 'remessar', 'saudar', 'saudar', 'vigilancia']","[1, 1, 1, 1, 1, 1, 1, 1, 2, 2, 1, 1, 1, 1, 2, 2, 1]","[]","[]",17,0,17,1
1185,"['autoridad', 'gabinet', 'hospitalizar', 'infectar', 'ministrar', 'positivar', 'positivar', 'primeiroministro', 'quarentenar', 'restritivo', 'saudar']","[1, 1, 1, 1, 1, 2, 2, 1, 1, 1, 1]","['garganta', 'instrucao']","[1, 1]",11,2,13,1
1188,"['abordagem', 'coletivo', 'descumprir', 'determinacao', 'disseminacao', 'martim', 'metropolitano', 'regiao', 'restritivo', 'varar']","[1, 1, 1, 1, 1, 1, 1, 1, 1, 1]","[]","[]",10,0,10,1
1194,"['aprovacao', 'companhia', 'congresso', 'congresso', 'contribuicao', 'crise', 'crise', 'enfrentamento', 'estrategia', 'impacto', 'jornada', 'legislativo', 'legislativo', 'levantamento', 'manutencao', 'medida', 'medida', 'medida', 'medida', 'motivacao', 'pagamento', 'plena', 'prazo', 'reducao', 'sido']","[1, 1, 2, 2, 1, 2, 2, 1, 1, 1, 1, 2, 2, 1, 1, 4, 4, 4, 4, 1, 1, 1, 1, 1, 1]","[]","[]",25,0,25,1
1198,"['alckmin', 'bancada', 'calheiro', 'cerimonia', 'comissao', 'enxergar', 'estrategico', 'geraldo', 'inquerito', 'investigacao', 'legislativo', 'liderar', 'mdbal', 'nogueira', 'nogueira', 'nogueira', 'nogueira', 'observar', 'planalto', 'planalto', 'planalto', 'sessao']","[1, 1, 1, 1, 1, 1, 1, 1, 1, 1, 1, 1, 1, 4, 4, 4, 4, 1, 3, 3, 3, 1]","['casamentar']","[1]",22,1,23,1
1201,"['competicao', 'competicao', 'comportamento', 'enfatizar', 'especialment', 'prioridad', 'reuter', 'saudar']","[2, 2, 1, 1, 1, 1, 1, 1]","[]","[]",8,0,8,1
1204,"['aplicacao', 'balancar', 'consorcio', 'distrito', 'dosar', 'dosar', 'dosar', 'espirito', 'folhar', 'parceria', 'spaulo', 'spaulo']","[1, 1, 1, 1, 3, 3, 3, 1, 1, 1, 2, 2]","[]","[]",12,0,12,1
1206,"['atendido', 'boletim', 'investigacao', 'negativar', 'reuter', 'saudar', 'saudar', 'suspeito', 'suspeito', 'suspeito', 'viagem', 'viagem']","[1, 1, 1, 1, 1, 2, 2, 3, 3, 3, 2, 2]","[]","[]",12,0,12,1
1207,"['antecipar', 'cupula', 'desmatamento', 'distant', 'ideologico', 'medida', 'pratico', 'prazo']","[1, 1, 1, 1, 1, 1, 1, 1]","['arvor', 'captura', 'carbono', 'carbono']","[1, 1, 2, 2]",8,4,12,1
1208,"[]","[]","['compartilhar']","[1]",0,1,1,1
1212,"['ambientar', 'antonio', 'desigualdad', 'economia', 'economia', 'estimular', 'preocupacao', 'recuperacao', 'recuperacao', 'risco']","[1, 1, 1, 2, 2, 1, 1, 2, 2, 1]","['carbono', 'versao']","[1, 1]",10,2,12,1
1213,"['andrea', 'colegio', 'desafio', 'desempenhar', 'dificuldad', 'etapa', 'possibilidad', 'psicologo', 'ritmar', 'segredar']","[1, 1, 1, 1, 1, 1, 1, 1, 1, 1]","[]","[]",10,0,10,1
1214,"['biliao', 'consequencia', 'dengu', 'folhar', 'impacto', 'instituto', 'levantamento', 'mergulhar', 'minimizar', 'orientacao', 'proliferacao', 'saneamento', 'saneamento', 'saudar', 'saudar', 'saudar']","[1, 1, 1, 1, 1, 1, 1, 1, 1, 1, 1, 2, 2, 3, 3, 3]","['pego']","[1]",16,1,17,1
1215,"['comparacao', 'decorrencia', 'quarentenar', 'saudar', 'situacao', 'tedro', 'transmissao']","[1, 1, 1, 1, 1, 1, 1]","['escutar']","[1]",7,1,8,1
1216,"['economia', 'gued', 'gued', 'gued', 'gued', 'gued', 'ministrar', 'ministrar', 'ministrar', 'presidir', 'substituto']","[1, 5, 5, 5, 5, 5, 3, 3, 3, 1, 1]","[]","[]",11,0,11,1
1217,"['apurar', 'domingo', 'equivalent']","[1, 1, 1]","[]","[]",3,0,3,1
1219,"['boletim', 'contabilizar', 'crise', 'letalidad', 'saudar', 'superar']","[1, 1, 1, 1, 1, 1]","[]","[]",6,0,6,1
1221,"['contribuicao', 'coordenar', 'destacar', 'epidemiar', 'imunizacao', 'inovacao', 'mandatario', 'merkel', 'merkel', 'portavoz', 'preparacao', 'respostar', 'saudar']","[1, 1, 1, 1, 1, 1, 1, 2, 2, 1, 1, 1, 1]","[]","[]",13,0,13,1
1227,"['curso', 'desafiar', 'desafio', 'domingo', 'importancia', 'mudanca', 'necessario', 'prescricao', 'reforcar']","[1, 1, 1, 1, 1, 1, 1, 1, 1]","[]","[]",9,0,9,1
1228,"['comportamento', 'epidemiar', 'epidemiar', 'instaurar', 'ministrar', 'ministrar', 'ministrar', 'ministrar', 'observar', 'relaxamento', 'saudar', 'transmissao']","[1, 2, 2, 1, 4, 4, 4, 4, 1, 1, 1, 1]","['circular']","[1]",12,1,13,1
1230,"['ambito', 'cometido', 'conformar', 'entendimento', 'entendimento', 'ideologico', 'justicar', 'prever', 'risco', 'tendencia']","[1, 1, 1, 2, 2, 1, 1, 1, 1, 1]","['barragem', 'rompimento']","[1, 1]",10,2,12,1
1235,"['exministro', 'exministro', 'exministro', 'integrant', 'justicar']","[3, 3, 3, 1, 1]","['indignacao']","[1]",5,1,6,1
1237,"['anvisa', 'balancar', 'domingo', 'imunizacao', 'levantamento', 'liderar', 'ministrar', 'saudar', 'unanimidad']","[1, 1, 1, 1, 1, 1, 1, 1, 1]","[]","[]",9,0,9,1
1241,"['esperancar', 'esperancar', 'plano']","[2, 2, 1]","['obama']","[1]",3,1,4,1
1243,"['alcolumbr', 'congresso', 'congresso', 'congresso', 'demap', 'desenvolvimento', 'fundeb', 'fundeb', 'internar', 'manutencao', 'prever', 'recurso', 'sessao', 'sessao', 'sessao', 'sessao', 'sessao', 'sessao']","[1, 3, 3, 3, 1, 1, 2, 2, 1, 1, 1, 1, 6, 6, 6, 6, 6, 6]","[]","[]",18,0,18,1
1245,"['conflito', 'conflito', 'justicar', 'silveiro', 'vespera']","[2, 2, 1, 1, 1]","['carrefour', 'lixar', 'pelar', 'postagen']","[1, 1, 1, 1]",5,4,9,1
1248,"['ambito', 'argumentar', 'autonomia', 'avancar', 'comissao', 'comissao', 'constituicao', 'distrit', 'elaborar', 'federar', 'federar', 'justificativo', 'manutencao', 'plenario', 'reconhecimento', 'restritivo', 'situacao', 'submetido']","[1, 1, 1, 1, 2, 2, 1, 1, 1, 2, 2, 1, 1, 1, 1, 1, 1, 1]","[]","[]",18,0,18,1
1249,"['consolidar', 'consorcio', 'levantamento', 'saudar', 'situacao', 'variacao', 'variacao']","[1, 1, 1, 1, 1, 2, 2]","[]","[]",7,0,7,1
1250,"['cnj', 'condicao', 'decisao', 'enquadrar', 'extraordinario', 'fabricio', 'fabricio', 'flavio', 'justicar', 'justicar', 'lavagem', 'ministrar', 'oliveira', 'queiroz', 'queiroz', 'queiroz', 'republicanosrj', 'saudar', 'situacao']","[1, 1, 1, 1, 1, 2, 2, 1, 2, 2, 1, 1, 1, 3, 3, 3, 1, 1, 1]","[]","[]",19,0,19,1
1252,"['afastamento', 'afastamento', 'afastamento', 'decisao', 'decisao', 'decisao', 'demrj', 'destinar', 'globonew', 'globonew', 'plenario', 'recurso', 'republico', 'santiago', 'santiago', 'santiago', 'santiago', 'supremo', 'wilson', 'wilson']","[3, 3, 3, 3, 3, 3, 1, 1, 2, 2, 1, 1, 1, 4, 4, 4, 4, 1, 2, 2]","['supostament']","[1]",20,1,21,1
1256,"['argumentar', 'atendido', 'crise', 'liderar', 'proposto', 'resolucao', 'saudar', 'saudar', 'saudar', 'situacao', 'situacao']","[1, 1, 1, 1, 1, 1, 3, 3, 3, 2, 2]","[]","[]",11,0,11,1
1260,"['avancar', 'avancar', 'distrito', 'dosar', 'dosar', 'dosar', 'federar', 'imunizacao', 'imunizacao', 'ministrar', 'ministrar', 'saudar', 'saudar', 'supremo']","[2, 2, 1, 3, 3, 3, 1, 2, 2, 2, 2, 2, 2, 1]","[]","[]",14,0,14,1
1264,"['araujo', 'araujo', 'araujo', 'benjamin', 'desenvolvimento', 'ernesto', 'importacao', 'primeiroministro', 'viagem']","[3, 3, 3, 1, 1, 1, 1, 1, 1]","['nasal']","[1]",9,1,10,1
1265,"['demanda', 'economia', 'economia', 'gued', 'impacto', 'insuficient', 'obtido', 'oficio', 'realizacao', 'ribeiro', 'risco', 'tambem']","[1, 2, 2, 1, 1, 1, 1, 1, 1, 1, 1, 1]","['imenso']","[1]",12,1,13,1
1266,"['autoridad', 'autoridad', 'autoridad', 'autoridad', 'comunitario', 'preliminar', 'preliminar', 'saudar', 'saudar', 'saudar', 'vulneravel']","[4, 4, 4, 4, 1, 2, 2, 3, 3, 3, 1]","[]","[]",11,0,11,1
1267,"['abordagem', 'abordagem', 'araujo', 'araujo', 'defendido', 'depoimento', 'diagnosticar', 'necessario', 'necessario', 'saudar', 'suspeito', 'suspeito', 'transmissao']","[2, 2, 2, 2, 1, 1, 1, 2, 2, 1, 2, 2, 1]","[]","[]",13,0,13,1
1268,"['comissao', 'conduta', 'investigacao', 'mudanca', 'necessario', 'previsto', 'reuter', 'sigla']","[1, 1, 1, 1, 1, 1, 1, 1]","['compartilhar', 'disfarcar', 'privacidad']","[1, 1, 1]",8,3,11,1
1269,"['condicao', 'intensivo', 'saudar']","[1, 1, 1]","['menino']","[1]",3,1,4,1
1272,"['adiamento', 'adotada', 'afp', 'calendario', 'contemplar', 'dinamarca', 'dosar', 'estrategia', 'intervalar', 'parceria']","[1, 1, 1, 1, 1, 1, 1, 1, 1, 1]","[]","[]",10,0,10,1
1273,"['avancar', 'azevedo', 'azevedo', 'azevedo', 'compromisso', 'consequencia', 'crise', 'entendimento', 'ministrar', 'ministrar', 'spaulo']","[1, 3, 3, 3, 1, 1, 1, 1, 2, 2, 1]","[]","[]",11,0,11,1
1275,"['condicao', 'dengu', 'dengu', 'dengu', 'dengu', 'destacar', 'destacar', 'impactar', 'limitacao', 'panamericana', 'periodo', 'regiao', 'regiao', 'respostar', 'saudar', 'saudar', 'surtir', 'vulneravel']","[1, 4, 4, 4, 4, 2, 2, 1, 1, 1, 1, 2, 2, 1, 2, 2, 1, 1]","['circular']","[1]",18,1,19,1
1278,"['publicitario', 'publicitario', 'quarentenar', 'reuniao']","[2, 2, 1, 1]","['espalhar']","[1]",4,1,5,1
1280,"['anuncio', 'autoridad', 'disseminacao', 'julgamento']","[1, 1, 1, 1]","[]","[]",4,0,4,1
1281,"['proposto', 'recuperacao']","[1, 1]","[]","[]",2,0,2,1
1284,"['cerimonia', 'decorrencia', 'transmissao']","[1, 1, 1]","['manobrar']","[1]",3,1,4,1
1285,"['afp', 'domingo', 'infectar', 'infectar', 'mexico', 'mexico']","[1, 1, 2, 2, 2, 2]","[]","[]",6,0,6,1
1286,"['agravamento', 'anvisa', 'argumentar', 'calendario', 'conformar', 'disseminacao', 'escassez', 'interrupcao', 'operacionalizacao', 'planar', 'saudar', 'supremo', 'vigilancia']","[1, 1, 1, 1, 1, 1, 1, 1, 1, 1, 1, 1, 1]","[]","[]",13,0,13,1
1287,"['acordo', 'acordo', 'companhia', 'conselho', 'consenso', 'cooperacao', 'exemplo', 'expressivo', 'indicado', 'mantido', 'parcela', 'serao', 'tambem']","[2, 2, 1, 1, 1, 1, 1, 1, 1, 1, 1, 1, 1]","[]","[]",13,0,13,1
1289,"['interino', 'ministrar', 'ministrar', 'pastar', 'pastar', 'pastar', 'quadro', 'rigoroso', 'saudar', 'servidor']","[1, 2, 2, 3, 3, 3, 1, 1, 1, 1]","[]","[]",10,0,10,1
1290,"['absoluto', 'crise', 'decisao', 'ministrar', 'nogueira', 'nogueira', 'oposto', 'ribeiro']","[1, 1, 1, 1, 2, 2, 1, 1]","['camiseta']","[1]",8,1,9,1
1291,"['administrativo', 'alerj', 'atuam', 'claudio', 'enfrentamento', 'exercicio', 'exercicio', 'exercicio', 'improbidad', 'legislativo', 'mprj', 'palacio', 'pratico', 'privar', 'relativo', 'servidor']","[1, 1, 1, 1, 1, 3, 3, 3, 1, 1, 1, 1, 1, 1, 1, 1]","['verificar']","[1]",16,1,17,1
1295,"['facilitar']","[1]","['inscricao']","[1]",1,1,2,1
1298,"['conformar', 'domingo', 'regrar', 'regrar']","[1, 1, 2, 2]","['mesario', 'mesario']","[2, 2]",4,2,6,1
1299,"['agravamento', 'boletim', 'complicacao', 'decorrencia', 'decorrencia', 'fundacao', 'manutencao', 'oswaldo', 'positivar', 'presenca', 'quedo', 'quedo', 'reportar', 'reportar', 'respiratorio', 'respiratorio', 'respiratorio', 'respiratorio', 'tendencia']","[1, 1, 1, 2, 2, 1, 1, 1, 1, 1, 2, 2, 2, 2, 4, 4, 4, 4, 1]","[]","[]",19,0,19,1
1300,"['discussao', 'discussao', 'discussao', 'gabinet', 'investigacao', 'justicar', 'justicar', 'justificativo']","[3, 3, 3, 1, 1, 2, 2, 1]","['espalhar', 'usuario']","[1, 1]",8,2,10,1
1301,"['administrativo', 'barroso', 'decisao', 'elaborar', 'exercicio', 'funcao', 'improbidad', 'irregularidad', 'ministrar', 'ministrar', 'prever', 'recurso', 'regiao', 'rejeitar', 'rejeitar', 'relativo', 'sudest', 'tcu', 'tcu', 'tcu']","[1, 1, 1, 1, 1, 1, 1, 1, 2, 2, 1, 1, 1, 2, 2, 1, 1, 3, 3, 3]","[]","[]",20,0,20,1
1303,"['pastar', 'portavoz', 'portavoz', 'portavoz', 'saudar', 'trimestr', 'trimestr']","[1, 3, 3, 3, 1, 2, 2]","[]","[]",7,0,7,1
1304,"['decorrencia', 'hospitalizar', 'infectar', 'saudar', 'surtir']","[1, 1, 1, 1, 1]","['compartilhar', 'espalhar']","[1, 1]",5,2,7,1
1306,"['anvisa', 'aprovacao', 'autorizacao', 'curso', 'exigencia', 'importacao', 'informaco', 'instituto', 'lewandowski', 'prazo', 'prazo', 'ricardo', 'sputnik', 'sputnik', 'supremo', 'tambem', 'vigilancia']","[1, 1, 1, 1, 1, 1, 1, 1, 1, 2, 2, 1, 2, 2, 1, 1, 1]","[]","[]",17,0,17,1
1307,"['celso', 'decisao', 'determinacao', 'exministro', 'inquerito', 'integro', 'investigacao', 'justicar', 'levantamento', 'machadar', 'mello', 'ministrar', 'ministrar', 'ministrar', 'ministrar', 'republico', 'reuniao', 'reuniao', 'supremo', 'supremo', 'videoconferencia']","[1, 1, 1, 1, 1, 1, 1, 1, 1, 1, 1, 4, 4, 4, 4, 1, 2, 2, 2, 2, 1]","['gravacao']","[1]",21,1,22,1
1309,"['periodo', 'presenca']","[1, 1]","['circular', 'escutar']","[1, 1]",2,2,4,1
1310,"['augusto', 'augusto', 'competicao', 'competicao', 'curvo', 'decisao', 'resolucao', 'treinamento', 'treinamento', 'treinar']","[2, 2, 2, 2, 1, 1, 1, 2, 2, 1]","[]","[]",10,0,10,1
1311,"['client', 'dificuldad', 'importancia', 'imunizacao', 'perspectivo', 'plano', 'plano', 'privar', 'proposto', 'proposto', 'saudar', 'saudar', 'saudar', 'saudar', 'situacao', 'tramitar']","[1, 1, 1, 1, 1, 2, 2, 1, 2, 2, 4, 4, 4, 4, 1, 1]","[]","[]",16,0,16,1
1314,"['associacao', 'corpu', 'decisao', 'exgovernador', 'habea', 'ideologico', 'ideologico', 'justicar', 'ministrar', 'ministrar', 'recurso', 'recurso', 'sessao', 'unanimidad']","[1, 1, 1, 1, 1, 2, 2, 1, 2, 2, 2, 2, 1, 1]","['fraudar']","[1]",14,1,15,1
1315,"['presenca', 'recordar']","[1, 1]","[]","[]",2,0,2,1
1316,"['anvisa', 'anvisa', 'coordenar', 'diretoria', 'etapa', 'federar', 'forcatarefa', 'previsao', 'resolucao', 'saudar', 'saudar', 'vigilancia']","[2, 2, 1, 1, 1, 1, 1, 1, 1, 2, 2, 1]","[]","[]",12,0,12,1
1317,"['ambientar', 'bbc', 'compromisso', 'cooperacao', 'epidemiar', 'plenario', 'plenario', 'reafirmar', 'regiao', 'transmissao', 'transmissao']","[1, 1, 1, 1, 1, 2, 2, 1, 1, 2, 2]","[]","[]",11,0,11,1
1318,"['academia', 'academia', 'medida', 'medida', 'suspensa', 'tambem']","[2, 2, 2, 2, 1, 1]","[]","[]",6,0,6,1
1320,"['periodo', 'periodo', 'periodo', 'respiratorio', 'respiratorio', 'respiratorio', 'respiratorio']","[3, 3, 3, 4, 4, 4, 4]","[]","[]",7,0,7,1
1322,"['concessionario', 'interferencia', 'privatizacao', 'volumar']","[1, 1, 1, 1]","[]","[]",4,0,4,1
1324,"['desenvolvimento', 'instituto', 'resolucao', 'saudar']","[1, 1, 1, 1]","['imagem']","[1]",4,1,5,1
1332,"['coreia', 'epidemiar', 'epidemiar', 'habito', 'infectar', 'oferecido', 'parceria', 'periodo', 'portavoz', 'quarentenar', 'regrar']","[1, 2, 2, 1, 1, 1, 1, 1, 1, 1, 1]","[]","[]",11,0,11,1
1334,"['apurar', 'consorcio', 'diminuicao', 'domingo', 'estabilidad', 'estatistico', 'excecao', 'quedo', 'saudar']","[1, 1, 1, 1, 1, 1, 1, 1, 1]","['basto']","[1]",9,1,10,1
1338,"['batalhar', 'comissao', 'conjuntar', 'conjunto', 'cooperacao', 'coordenar', 'decisao', 'esforco', 'europeu', 'europeu', 'europeu', 'importancia', 'necessario', 'respostar', 'sabado', 'sabado', 'saudar']","[1, 1, 1, 1, 1, 1, 1, 1, 3, 3, 3, 1, 1, 1, 2, 2, 1]","['ganhar']","[1]",17,1,18,1
1339,"['flavio', 'folhar', 'gabinet', 'legislativo', 'rachadinha', 'rachadinha', 'rachadinha', 'transferir']","[1, 1, 1, 1, 3, 3, 3, 1]","[]","[]",8,0,8,1
1341,"['henriqu', 'ministrar', 'saudar', 'saudar', 'saudar']","[1, 1, 3, 3, 3]","[]","[]",5,0,5,1
1342,"['aplicacao', 'atendido', 'decisao', 'entregu', 'materiaprima', 'ministrar', 'ministrar', 'pastar', 'previsao', 'saudar', 'saudar', 'vigilancia']","[1, 1, 1, 1, 1, 2, 2, 1, 1, 2, 2, 1]","[]","[]",12,0,12,1
1343,"['belgica', 'boletim', 'consecutivo', 'ministrar', 'nelson', 'oficialment', 'recordar', 'saudar', 'saudar', 'teich']","[1, 1, 1, 1, 1, 1, 1, 2, 2, 1]","[]","[]",10,0,10,1
1345,"['autoridad', 'decisao', 'destacar', 'flexibilizar', 'fronteiro', 'quarentenar', 'saudar', 'saudar', 'viajant', 'voo']","[1, 1, 1, 1, 1, 1, 2, 2, 1, 1]","[]","[]",10,0,10,1
1346,"['comportamento', 'desempenhar', 'epicentro', 'impactar']","[1, 1, 1, 1]","['motorista']","[1]",4,1,5,1
1348,"['agravar', 'agravar', 'antonio', 'calamidad', 'cometido', 'funcao', 'justicar', 'ministrar', 'prazo', 'presenca', 'supremo', 'varar']","[2, 2, 1, 1, 1, 1, 1, 1, 1, 1, 1, 1]","['caixao', 'protestar']","[1, 1]",12,2,14,1
1349,"['biliao', 'biliao', 'biliao', 'biliao', 'companhia', 'contrato', 'distant', 'esquema', 'impulsionar', 'infraestrutura', 'montant', 'montant', 'patamar', 'superar', 'vencimento']","[4, 4, 4, 4, 1, 1, 1, 1, 1, 1, 2, 2, 1, 1, 1]","['imagem']","[1]",15,1,16,1
1351,"['turistico']","[1]","['cartaz', 'imagem']","[1, 1]",1,2,3,1
1355,"['aglomeracao', 'alternativo', 'atrasar', 'epicentro', 'isolar', 'medeiro', 'ministrar', 'orientacao', 'orientacao', 'quarentenar', 'recurso', 'regiao']","[1, 1, 1, 1, 1, 1, 1, 2, 2, 1, 1, 1]","['circular', 'estranhar']","[1, 1]",12,2,14,1
1356,"['concessionario', 'especializar', 'especializar', 'especializar', 'internacao', 'regiao']","[1, 3, 3, 3, 1, 1]","[]","[]",6,0,6,1
1360,"['iniciativo', 'integro', 'ministrar', 'privar', 'privatizacao', 'privatizacao', 'privatizacao']","[1, 1, 1, 1, 3, 3, 3]","['enfim', 'ganhar']","[1, 1]",7,2,9,1
1361,"['boletim', 'justicar', 'pagamento', 'positivar', 'quarentenar']","[1, 1, 1, 1, 1]","['desmentir']","[1]",5,1,6,1
1363,"['argumentar', 'atuacao', 'comissao', 'dialogo', 'reafirmar', 'requerimento', 'rossi', 'rossi']","[1, 1, 1, 1, 1, 1, 2, 2]","[]","[]",8,0,8,1
1364,"['comparacao', 'confederacao', 'consumidor', 'economia', 'habito', 'impactar', 'impacto', 'patamar', 'periodo', 'periodo', 'periodo', 'reducao', 'tendencia']","[1, 1, 1, 1, 1, 1, 1, 1, 3, 3, 3, 1, 1]","['ganhar']","[1]",13,1,14,1
1366,"['agravamento', 'integro', 'previsto', 'temporario']","[1, 1, 1, 1]","[]","[]",4,0,4,1
1369,"['aliquota', 'congresso', 'consumidor', 'contribuicao', 'economia', 'etapa', 'etapa', 'gued', 'negativa', 'proposta', 'proposta']","[1, 1, 1, 1, 1, 2, 2, 1, 1, 2, 2]","[]","[]",11,0,11,1
1370,"['domingo', 'exministro', 'justificativo', 'punicao', 'reforcar', 'regrar', 'saudar']","[1, 1, 1, 1, 1, 1, 1]","['cuspir']","[1]",7,1,8,1
1371,"['colunista', 'complicacao', 'comprometido', 'internar', 'oliveira']","[1, 1, 1, 1, 1]","[]","[]",5,0,5,1
1372,"['ambientar', 'ambientar', 'ambientar', 'atuacao', 'cenario', 'chefiar', 'escalar', 'etapa', 'ministrar', 'processo', 'proporcao', 'reducao', 'ricardo', 'ricardo', 'sall', 'sall', 'tcu', 'tcu']","[3, 3, 3, 1, 1, 1, 1, 1, 1, 1, 1, 1, 2, 2, 2, 2, 2, 2]","['auditoria']","[1]",18,1,19,1
1373,"['advocaciager', 'araujo', 'articulacao', 'azevedo', 'azevedo', 'ernesto', 'flavia', 'itamarati', 'justicar', 'ministrar', 'mudanca', 'republico', 'substituto']","[1, 1, 1, 2, 2, 1, 1, 1, 1, 1, 1, 1, 1]","[]","[]",13,0,13,1
1376,"['circulacao', 'deslocamento', 'epidemia', 'epidemia', 'primeiroministro', 'propagacao', 'sabado']","[1, 1, 2, 2, 1, 1, 1]","[]","[]",7,0,7,1
1379,"['alcolumbr', 'alcolumbr', 'alcolumbr', 'barroso', 'barroso', 'barroso', 'converso', 'decisao', 'decisao', 'demap', 'fornecimento', 'integro', 'levantamento', 'liderar', 'ministrar', 'realizacao', 'regiao', 'sessao']","[3, 3, 3, 3, 3, 3, 1, 2, 2, 1, 1, 1, 1, 1, 1, 1, 1, 1]","[]","[]",18,0,18,1
1380,"['ambientar', 'aurelio', 'corpu', 'decisao', 'edson', 'excecao', 'expressar', 'fachin', 'fux', 'habea', 'julgamento', 'lewandowski', 'processo', 'ricardo', 'supremo', 'turma', 'turma', 'varar']","[1, 1, 1, 1, 1, 1, 1, 1, 1, 1, 1, 1, 1, 1, 1, 2, 2, 1]","['realment']","[1]",18,1,19,1
1381,"['desafiar', 'sabado']","[1, 1]","['fraudar']","[1]",2,1,3,1
1382,"['aumento', 'epicentro', 'surtir', 'temporada', 'temporada', 'treinar']","[1, 1, 1, 2, 2, 1]","[]","[]",6,0,6,1
1385,"['consumidor', 'discussao', 'discussao', 'necessidad', 'precisao', 'prever', 'reducao', 'salao', 'urbano']","[1, 2, 2, 1, 1, 1, 1, 1, 1]","[]","[]",9,0,9,1
1386,"['adotada', 'apurar', 'comissao', 'constituicao', 'constituicao', 'converso', 'crise', 'emendar', 'emendar', 'federar', 'federar', 'federar', 'federar', 'federar', 'federativo', 'flavio', 'gripezinha', 'gued', 'interferencia', 'internar', 'internar', 'investigacao', 'investigacao', 'investigacao', 'irregularidad', 'jorg', 'ministrar', 'ministrar', 'motivacao', 'queiroga', 'recurso', 'recurso', 'recurso', 'recurso', 'requerimento', 'saudar', 'saudar', 'supremo', 'supremo', 'supremo']","[1, 1, 1, 2, 2, 1, 1, 2, 2, 5, 5, 5, 5, 5, 1, 1, 1, 1, 1, 2, 2, 3, 3, 3, 1, 1, 2, 2, 1, 1, 4, 4, 4, 4, 1, 2, 2, 3, 3, 3]","['gravacao', 'gravacao', 'gravacao', 'pego', 'pego']","[3, 3, 3, 2, 2]",40,5,45,1
1391,"['atrasar', 'bastidor', 'decisao', 'entendimento', 'justicar', 'notificar', 'pagamento', 'pagamento', 'pagamento', 'possibilidad', 'proposto', 'proposto', 'reducao', 'salao', 'varar']","[1, 1, 1, 1, 1, 1, 3, 3, 3, 1, 2, 2, 1, 1, 1]","['camisa', 'fraudar', 'imagem']","[1, 1, 1]",15,3,18,1
1394,"['apurar', 'conjuntar', 'consorcio', 'consorcio', 'levantamento', 'levantamento', 'monitoramento', 'saudar', 'saudar']","[1, 1, 2, 2, 2, 2, 1, 2, 2]","[]","[]",9,0,9,1
1395,"['alternativo', 'atuacao', 'bastidor', 'colunista', 'enfrentamento', 'prescricao', 'projecao', 'saudar', 'saudar', 'servidor', 'souza']","[1, 1, 1, 1, 1, 1, 1, 2, 2, 1, 1]","['ganhar', 'ganhar', 'versao', 'versao']","[2, 2, 2, 2]",11,4,15,1
1401,"['antonio', 'cepa', 'circulacao', 'descumprir', 'domingo', 'domingo', 'habitant', 'habitant', 'inicialment', 'instituto', 'letalidad', 'machadar', 'necessario', 'oliveira', 'passageiro', 'previsto', 'reforcar', 'renata', 'sabado', 'sabado', 'suspenso', 'taxar']","[1, 1, 1, 1, 2, 2, 2, 2, 1, 1, 1, 1, 1, 1, 1, 1, 1, 1, 2, 2, 1, 1]","['gasolina']","[1]",22,1,23,1
1402,"['agravar', 'argumentar', 'augusto', 'cnj', 'concedido', 'contencao', 'decisao', 'edson', 'fachin', 'julgamento', 'justicar', 'ministrar', 'previsto', 'recurso', 'republico', 'risco', 'supremo', 'supremo']","[1, 1, 1, 1, 1, 1, 1, 1, 1, 1, 1, 1, 1, 1, 1, 1, 2, 2]","['soltura']","[1]",18,1,19,1
1403,"[]","[]","['parir']","[1]",0,1,1,1
1405,"['alternativo', 'antecipar', 'circulacao', 'circulacao', 'coletivo', 'coletivo', 'coletivo', 'comunitario', 'contabil', 'decisao', 'diariament', 'disseminacao', 'equipamento', 'excecao', 'funcionamento', 'goncalo', 'goncalo', 'importancia', 'marinhar', 'necessario', 'periodo', 'situacao', 'suspenso', 'suspenso', 'transmissao', 'transmissao', 'velocidad']","[1, 1, 2, 2, 3, 3, 3, 1, 1, 1, 1, 1, 1, 1, 1, 2, 2, 1, 1, 1, 1, 1, 2, 2, 2, 2, 1]","['circular', 'usuario']","[1, 1]",27,2,29,1
1406,"['disseminacao', 'epidemiar', 'impulsionar', 'obtido', 'possibilidad', 'possibilidad', 'saudar', 'suspeito']","[1, 1, 1, 1, 2, 2, 1, 1]","['espalhar']","[1]",8,1,9,1
1408,"['amplo', 'assistencia', 'assistencia', 'comprometido', 'decisao', 'demandar', 'destacar', 'escassez', 'fornecimento', 'fornecimento', 'funcionamento', 'justicar', 'necessario', 'necessario', 'prazo', 'prazo', 'realizacao']","[1, 2, 2, 1, 1, 1, 1, 1, 2, 2, 1, 1, 2, 2, 2, 2, 1]","['atribuir']","[1]",17,1,18,1
1409,"['companhia', 'especifico', 'federar', 'infectar', 'interrupcao', 'positivar', 'quarentenar', 'quarentenar', 'surtir']","[1, 1, 1, 1, 1, 1, 2, 2, 1]","[]","[]",9,0,9,1
1410,"['observacao', 'positivar', 'positivar', 'regiao', 'regiao', 'saudar', 'saudar', 'viagem']","[1, 2, 2, 2, 2, 2, 2, 1]","[]","[]",8,0,8,1
1411,"['aglomeracao', 'autoridad', 'autoridad', 'avancar', 'comissao', 'consequencia', 'desafiar', 'integrant', 'integrant', 'ministrar', 'renata', 'renata', 'rocha', 'saudar', 'saudar', 'saudar', 'saudar', 'submetido']","[1, 2, 2, 1, 1, 1, 1, 2, 2, 1, 2, 2, 1, 4, 4, 4, 4, 1]","[]","[]",18,0,18,1
1414,"['regrar', 'sabado']","[1, 1]","[]","[]",2,0,2,1
1418,"[]","[]","['acidentar']","[1]",0,1,1,1
1420,"['internar', 'internar', 'internar', 'recuperacao', 'transferir', 'transferir']","[3, 3, 3, 1, 2, 2]","[]","[]",6,0,6,1
1422,"['agravamento', 'anticorpo', 'anticorpo', 'anticorpo', 'comorbidad', 'comparacao', 'condicao', 'desenvolvimento', 'dosar', 'dosar', 'dosar', 'dosar', 'estrategia', 'hipertensao', 'instituto', 'necessario', 'obesidad', 'obesidad', 'obesidad', 'obesidad', 'obesidad', 'obesidad', 'obesidad', 'obesidad', 'opcao', 'particularment', 'pulmonar', 'reforcar', 'respostar', 'respostar', 'respostar', 'revisar', 'saudar', 'saudar']","[1, 3, 3, 3, 1, 1, 1, 1, 4, 4, 4, 4, 1, 1, 1, 1, 8, 8, 8, 8, 8, 8, 8, 8, 1, 1, 1, 1, 3, 3, 3, 1, 2, 2]","['parir']","[1]",34,1,35,1
1423,"['adulto', 'adulto', 'comorbidad', 'excecao', 'gestant', 'hospitalizacao', 'imunizacao', 'imunizacao', 'instituto', 'observar', 'quedo']","[2, 2, 1, 1, 1, 1, 2, 2, 1, 1, 1]","[]","[]",11,0,11,1
1424,"['adotada', 'adotada', 'circulacao', 'determinacao', 'domingo', 'domingo', 'domingo', 'fase', 'funcionamento', 'funcionamento', 'periodo', 'planar', 'regrar', 'restritivo', 'ritmar', 'sabado', 'sabado', 'sabado']","[2, 2, 1, 1, 3, 3, 3, 1, 2, 2, 1, 1, 1, 1, 1, 3, 3, 3]","[]","[]",18,0,18,1
1426,"['autoridad', 'avancar', 'bbc', 'disseminacao', 'habitant', 'infectar', 'internacao', 'isolar', 'necessario', 'periodo', 'risco', 'saudar', 'saudar', 'saudar']","[1, 1, 1, 1, 1, 1, 1, 1, 1, 1, 1, 3, 3, 3]","['compartilhar']","[1]",14,1,15,1
1428,"['antonio', 'argumentar', 'decisao', 'delacao', 'depoimento', 'edson', 'exministro', 'fachin', 'instituto', 'ministrar', 'pagamento', 'plenario', 'supremo', 'turma', 'turma']","[1, 1, 1, 1, 1, 1, 1, 1, 1, 1, 1, 1, 1, 2, 2]","[]","[]",15,0,15,1
1430,"['condicao', 'desenvolvido', 'dificuldad', 'expansao', 'instituto', 'necessidad', 'parceria', 'recurso', 'saudar', 'saudar']","[1, 1, 1, 1, 1, 1, 1, 1, 2, 2]","[]","[]",10,0,10,1
1431,"['decisao', 'desafio', 'especifico', 'orientacao', 'parceria', 'proposto', 'reabertura', 'reabertura', 'renata', 'ribeiro', 'sabatino', 'sabatino', 'vigilancia']","[1, 1, 1, 1, 1, 1, 2, 2, 1, 1, 2, 2, 1]","[]","[]",13,0,13,1
1432,"['contabilizar']","[1]","['imagem', 'visualizacao']","[1, 1]",1,2,3,1
1433,"['aglomeracao', 'autoridad', 'capitar', 'capitar', 'cenario', 'disseminacao', 'domingo', 'domingo', 'domingo', 'orientacao', 'realizacao', 'saudar', 'saudar', 'saudar']","[1, 1, 2, 2, 1, 1, 3, 3, 3, 1, 1, 3, 3, 3]","['compartilhar']","[1]",14,1,15,1
1434,"['academico', 'ampliacao', 'avancar', 'campino', 'crise', 'demandar', 'desempenhar', 'epidemiar', 'epidemiologico', 'esforco', 'estrategia', 'forcatarefa', 'iniciativo', 'instituto', 'instituto', 'molecular', 'necessidad', 'reforcar', 'saudar', 'suspeito', 'testagem', 'vigilancia']","[1, 1, 1, 1, 1, 1, 1, 1, 1, 1, 1, 1, 1, 2, 2, 1, 1, 1, 1, 1, 1, 1]","[]","[]",22,0,22,1
1435,"['colaboracao', 'consorcio', 'enfrentamento', 'epidemiar', 'equipamento', 'equipamento', 'necessidad', 'possibilidad', 'possibilidad', 'projeco', 'regiao', 'republico', 'respirador']","[1, 1, 1, 1, 2, 2, 1, 2, 2, 1, 1, 1, 1]","[]","[]",13,0,13,1
1437,"['afastamento', 'ambientar', 'ambientar', 'chefiar', 'depoimento', 'depoimento', 'diminuicao', 'equipamento', 'instituto', 'justicar', 'ministrar', 'ministrar', 'mudanca', 'orcamentaria', 'pastar', 'recurso', 'reducao', 'republico', 'ricardo', 'sall', 'servidor', 'servidor']","[1, 2, 2, 1, 2, 2, 1, 1, 1, 1, 2, 2, 1, 1, 1, 1, 1, 1, 1, 1, 2, 2]","[]","[]",22,0,22,1
1442,"['cnj', 'cnmp', 'contrato', 'contrato', 'instituto', 'justicar', 'periodo', 'prorrogacao', 'prorrogacao', 'provisorio']","[1, 1, 2, 2, 1, 1, 1, 2, 2, 1]","[]","[]",10,0,10,1
1443,"['ambito', 'avancar', 'avancar', 'crise', 'domingo', 'economia', 'ministrar', 'ministrar', 'saudar', 'saudar', 'subir']","[1, 2, 2, 1, 1, 1, 2, 2, 2, 2, 1]","[]","[]",11,0,11,1
1446,"['domingo', 'folhar', 'integro', 'justicar', 'mendonca', 'ministrar', 'pastar', 'saudar']","[1, 1, 1, 1, 1, 1, 1, 1]","[]","[]",8,0,8,1
1447,"['avancar', 'biliao', 'biliao', 'companhia', 'comparacao', 'comparacao', 'crescimento', 'crescimento', 'demandar', 'impactar', 'passageiro', 'periodo', 'quedo', 'trimestr', 'trimestr']","[1, 2, 2, 1, 2, 2, 2, 2, 1, 1, 1, 1, 1, 2, 2]","['quinzena']","[1]",15,1,16,1
1449,"['anvisa', 'excecao', 'extensao', 'permanencia', 'prorrogar', 'realizacao', 'realizacao', 'reuniao', 'temporario', 'vigilancia']","[1, 1, 1, 1, 1, 2, 2, 1, 1, 1]","[]","[]",10,0,10,1
1452,"['anvisa', 'anvisa', 'anvisa', 'avancar', 'avancar', 'desenvolvido', 'estagio', 'etapa', 'instituto', 'instituto', 'instituto', 'reuter', 'testagem', 'testagem', 'vigilancia']","[3, 3, 3, 2, 2, 1, 1, 1, 3, 3, 3, 1, 2, 2, 1]","[]","[]",15,0,15,1
1455,"['apurar', 'arthur', 'emendar', 'emendar', 'gabinet', 'integro', 'lira', 'lira', 'ministrar', 'palacio', 'planalto', 'reuniao', 'reuniao']","[1, 1, 2, 2, 1, 1, 2, 2, 1, 1, 1, 2, 2]","['preencher']","[1]",13,1,14,1
1456,"['araujo', 'carla', 'colunista', 'exministro', 'exministro', 'iniciativo', 'saudar', 'souza']","[1, 1, 1, 2, 2, 1, 1, 1]","[]","[]",8,0,8,1
1457,"['comissao', 'economia', 'inedito', 'pratico', 'videoconferencia']","[1, 1, 1, 1, 1]","['abusar']","[1]",5,1,6,1
1461,"['bolsonarista', 'bolsonarista', 'bolsonarista', 'concorrent', 'inquerito', 'inquerito', 'supremo']","[3, 3, 3, 1, 2, 2, 1]","['ganhar', 'huawei', 'huawei', 'pego']","[1, 2, 2, 1]",7,4,11,1
1465,"['alerj', 'converso', 'esquema', 'fabricio', 'flavio', 'fundamentar', 'investigacao', 'investigacao', 'queiroz', 'queiroz', 'rachadinha', 'renata', 'renata', 'renata', 'rocha', 'totalizar']","[1, 1, 1, 1, 1, 1, 2, 2, 2, 2, 1, 3, 3, 3, 1, 1]","['amigar']","[1]",16,1,17,1
1469,"['condicao', 'reducao', 'sabado']","[1, 1, 1]","['gasolina', 'greve']","[1, 1]",3,2,5,1
1470,"['colegiado', 'comissao', 'comissao', 'comissao', 'comissao', 'comissao', 'comissao', 'comissao', 'conformar', 'consequencia', 'elaborar', 'integrant', 'justicar', 'justicar', 'mendonca', 'ministrar', 'servidor']","[1, 7, 7, 7, 7, 7, 7, 7, 1, 1, 1, 1, 2, 2, 1, 1, 1]","[]","[]",17,0,17,1
1475,"['avancar', 'goncalv', 'possibilidad']","[1, 1, 1]","[]","[]",3,0,3,1
1476,"['arrecadacao', 'aspecto', 'emendar', 'presenca', 'realizacao', 'realizacao', 'recurso', 'sentenca']","[1, 1, 1, 1, 2, 2, 1, 1]","['assinalar']","[1]",8,1,9,1
1477,"['amplo', 'boletim', 'contabilizar', 'decorrencia', 'decorrencia', 'espanha', 'espanha', 'infectar', 'levantamento', 'saudar', 'superar', 'testagem']","[1, 1, 1, 2, 2, 2, 2, 1, 1, 1, 1, 1]","[]","[]",12,0,12,1
1479,"['argumentar', 'avancar', 'avancar', 'fase', 'fase', 'flexibilizacao', 'flexibilizacao', 'necessidad', 'planar', 'planar', 'presenca', 'quarentenar']","[1, 2, 2, 2, 2, 2, 2, 1, 2, 2, 1, 1]","[]","[]",12,0,12,1
1480,"['adhanom', 'conjunta', 'embora', 'mandatario', 'medida', 'risco', 'tedro']","[1, 1, 1, 1, 1, 1, 1]","[]","[]",7,0,7,1
1483,"['anvisa', 'broadcast', 'comportament', 'consumidor', 'fase', 'fase', 'infraestrutura', 'ministrar', 'ministrar', 'passageiro', 'passageiro', 'passageiro', 'recuperacao', 'velocidad', 'viagem', 'viagem', 'vigilancia']","[1, 1, 1, 1, 2, 2, 1, 2, 2, 3, 3, 3, 1, 1, 2, 2, 1]","[]","[]",17,0,17,1
1484,"['almeida', 'antecipar', 'calamidad', 'conformar', 'convencao', 'feriar', 'marilia', 'periodo', 'regrar', 'sindicato', 'taxar']","[1, 1, 1, 1, 1, 1, 1, 1, 1, 1, 1]","[]","[]",11,0,11,1
1488,"['converso', 'decisao', 'espirito', 'instituto', 'machadar', 'presidir', 'sigla']","[1, 1, 1, 1, 1, 1, 1]","[]","[]",7,0,7,1
1489,"['anticorpo', 'epidemia', 'molecular', 'porqu', 'presenca', 'presenca', 'processo', 'proposta', 'reabertura', 'reabertura']","[1, 1, 1, 1, 2, 2, 1, 1, 2, 2]","[]","[]",10,0,10,1
1491,"['complicacao', 'decorrencia', 'diagnosticar', 'diagnosticar', 'intervalar', 'visitant']","[1, 1, 2, 2, 1, 1]","[]","[]",6,0,6,1
1492,"['converso', 'decisao', 'decisao', 'decisao', 'nogueira', 'oliveira', 'precedent', 'precedent', 'pslsp', 'subordinar']","[1, 3, 3, 3, 1, 1, 2, 2, 1, 1]","[]","[]",10,0,10,1
1493,"['alternativo', 'anvisa', 'anvisa', 'biliao', 'biliao', 'consorcio', 'consorcio', 'desenvolvimento', 'dificuldad', 'fundacao', 'instituto', 'oswaldo', 'possibilidad', 'possibilidad', 'possibilidad', 'prever', 'provisorio', 'recurso', 'recurso', 'saudar', 'saudar', 'vigilancia']","[1, 2, 2, 2, 2, 2, 2, 1, 1, 1, 1, 1, 3, 3, 3, 1, 1, 2, 2, 2, 2, 1]","['ganhar']","[1]",22,1,23,1
1494,"['adhanom', 'condicao', 'contabilizar', 'necessario', 'particularment', 'precaucao', 'propagacao', 'saudar', 'saudar', 'tedro', 'vulneravel']","[1, 1, 1, 1, 1, 1, 1, 2, 2, 1, 1]","[]","[]",11,0,11,1
1495,"['aglomeracao', 'agravamento', 'cardiologista', 'chefiar', 'congresso', 'crise', 'divergencia', 'enfrentamento', 'especialment', 'imunizacao', 'minimizar', 'ministrar', 'pastar', 'pratico', 'relativo', 'saudar', 'saudar', 'surto']","[1, 1, 1, 1, 1, 1, 1, 1, 1, 1, 1, 1, 1, 1, 1, 2, 2, 1]","[]","[]",18,0,18,1
1496,"['apurar', 'atuacao', 'atuacao', 'atuacao', 'constituicao', 'demmg', 'discussao', 'exjuiz', 'iniciativo', 'iniciativo', 'investigacao', 'justicar', 'pacheco', 'pacheco', 'sabado']","[1, 3, 3, 3, 1, 1, 1, 1, 2, 2, 1, 1, 2, 2, 1]","[]","[]",15,0,15,1
1501,"['apreensao', 'circulacao', 'concedido', 'decisao', 'facilitar', 'globonew', 'humanitario', 'intubacao', 'preocupacao', 'reuniao', 'reuniao', 'saudar', 'secretariager', 'transmissao']","[1, 1, 1, 1, 1, 1, 1, 1, 1, 2, 2, 1, 1, 1]","[]","[]",14,0,14,1
1503,"['associacao', 'epidemiar', 'henriqu', 'incerteza', 'ministrar', 'mudanca', 'nelson', 'nomeacao', 'pastar', 'possibilidad', 'recebido', 'saudar', 'saudar', 'teich', 'teich', 'teich', 'teich', 'teich', 'teich']","[1, 1, 1, 1, 1, 1, 1, 1, 1, 1, 1, 2, 2, 6, 6, 6, 6, 6, 6]","[]","[]",19,0,19,1
1504,"['ambientar', 'infeccioso', 'journal']","[1, 1, 1]","[]","[]",3,0,3,1
1509,"['epidemiologico', 'esquema', 'expectativa', 'necessidad', 'respiratorio', 'saudar', 'testagem', 'vigilancia']","[1, 1, 1, 1, 1, 1, 1, 1]","[]","[]",8,0,8,1
1512,"['medida', 'necessario', 'periodo', 'proximo', 'reducao', 'suspenso', 'suspenso', 'suspenso', 'tambem']","[1, 1, 1, 1, 1, 3, 3, 3, 1]","[]","[]",9,0,9,1
1513,"['administrativo', 'alteracao', 'decisao', 'decisao', 'dosar', 'improbidad', 'imunizacao', 'independentement', 'mantido', 'planar', 'prioritario', 'saudar']","[1, 1, 2, 2, 1, 1, 1, 1, 1, 1, 1, 1]","[]","[]",12,0,12,1
1514,"['autorizacao', 'diagnosticar', 'estagio', 'negativar']","[1, 1, 1, 1]","[]","[]",4,0,4,1
1516,"['afastamento', 'concreto', 'desvio', 'dificuldad', 'enfrentamento', 'especialment', 'investigacao', 'investigacao', 'justicar', 'recurso', 'republico', 'requerimento', 'wilson', 'witzel']","[1, 1, 1, 1, 1, 1, 2, 2, 1, 1, 1, 1, 1, 1]","[]","[]",14,0,14,1
1518,"['crise', 'europeu', 'exministro', 'justicar', 'nomeacao', 'ricardo', 'souza']","[1, 1, 1, 1, 1, 1, 1]","[]","[]",7,0,7,1
1520,"['atuacao', 'colaborar', 'depoimento', 'integro', 'palacio', 'planalto', 'saudar']","[1, 1, 1, 1, 1, 1, 1]","[]","[]",7,0,7,1
1521,"['hospitalizar', 'intensivo', 'provisorio', 'quedo', 'saudar', 'tendencia']","[1, 1, 1, 1, 1, 1]","[]","[]",6,0,6,1
1522,"['manutencao', 'ministrar', 'ministrar', 'presenciar', 'reuniao', 'situacao', 'suspensao', 'videoconferencia']","[1, 2, 2, 1, 1, 1, 1, 1]","[]","[]",8,0,8,1
1524,"['anuncio', 'apurar', 'congresso', 'converso', 'fundeb', 'percepcao', 'proposto', 'quedo', 'reuniao', 'ricardo', 'tributario']","[1, 1, 1, 1, 1, 1, 1, 1, 1, 1, 1]","[]","[]",11,0,11,1
1526,"['contribuicao', 'duqu', 'duqu', 'extraordinario', 'periodo', 'propagacao']","[1, 2, 2, 1, 1, 1]","['fotografia', 'imagem', 'imagem']","[1, 2, 2]",6,3,9,1
1528,"['acordo', 'colaboracao', 'consequencia', 'coreia', 'economia', 'exemplo', 'gued', 'gued', 'porqu', 'processo', 'transicao']","[1, 1, 1, 1, 1, 1, 2, 2, 1, 1, 1]","[]","[]",11,0,11,1
1529,"['autoridad', 'cerimonia', 'prazo', 'previsto', 'prioridad', 'toquio', 'toquio']","[1, 1, 1, 1, 1, 2, 2]","[]","[]",7,0,7,1
1530,"['abordagem', 'amplo', 'crescimento', 'crescimento', 'estrategia', 'estrategia', 'juro', 'monetario', 'periodo', 'prazo', 'reuter']","[1, 1, 2, 2, 2, 2, 1, 1, 1, 1, 1]","[]","[]",11,0,11,1
1533,"['comparacao', 'fase', 'patamar', 'periodo', 'quedo', 'recordar', 'subir']","[1, 1, 1, 1, 1, 1, 1]","[]","[]",7,0,7,1
1535,"['fundacao', 'inglaterra', 'instituto', 'jorg', 'liderar', 'perspectivo', 'sigla']","[1, 1, 1, 1, 1, 1, 1]","[]","[]",7,0,7,1
1536,"['adotada', 'assistencia', 'conjuntar', 'decisao', 'estrategico', 'eventualment', 'lancamento', 'lorenzoni', 'ministrar', 'oliveira', 'onyx', 'possibilidad']","[1, 1, 1, 1, 1, 1, 1, 1, 1, 1, 1, 1]","[]","[]",12,0,12,1
1537,"['anvisa', 'anvisa', 'anvisa', 'elaborar', 'entregu', 'especifico', 'instituto', 'investigacao', 'justificativo', 'oficio', 'oficio', 'previsto', 'queixar', 'reducao', 'saudar', 'vigilancia', 'volumar', 'volumar', 'volumar']","[3, 3, 3, 1, 1, 1, 1, 1, 1, 2, 2, 1, 1, 1, 1, 1, 3, 3, 3]","[]","[]",19,0,19,1
1539,"['afp', 'aliviar', 'constatar', 'desembarcar', 'negativar', 'passageiro', 'passageiro', 'quarentenar', 'quarentenar', 'saudar']","[1, 1, 1, 1, 1, 2, 2, 2, 2, 1]","[]","[]",10,0,10,1
1540,"['anticorpo', 'anticorpo', 'anticorpo', 'autoridad', 'dosar', 'fase', 'liderar']","[3, 3, 3, 1, 1, 1, 1]","[]","[]",7,0,7,1
1541,"['autoridad', 'integrant', 'mandatario', 'republico', 'reuniao', 'treinamento', 'treino', 'treino']","[1, 1, 1, 1, 1, 1, 2, 2]","['compartilhar']","[1]",8,1,9,1
1543,"['destinar', 'equipamento', 'proferir', 'sabado', 'saudar']","[1, 1, 1, 1, 1]","['agredir', 'agredir']","[2, 2]",5,2,7,1
1544,"['californio', 'esperancar', 'organizador', 'organizador', 'situacao']","[1, 1, 2, 2, 1]","[]","[]",5,0,5,1
1545,"['afp', 'contagioso', 'estatistico', 'infectar', 'inglaterra', 'sabado']","[1, 1, 1, 1, 1, 1]","[]","[]",6,0,6,1
1547,"['acordo', 'aglomeracao', 'atrair', 'cenario', 'informaco', 'sociai']","[1, 1, 1, 1, 1, 1]","[]","[]",6,0,6,1
1549,"['balancar', 'comparacao', 'consolidar', 'consorcio', 'crescimento', 'curvo', 'decorrent', 'estabilidad', 'estabilidad', 'levantamento', 'quedo', 'ritmar', 'ritmar', 'saudar', 'situacao', 'tendencia', 'totalizar', 'variacao']","[1, 1, 1, 1, 1, 1, 1, 2, 2, 1, 1, 2, 2, 1, 1, 1, 1, 1]","[]","[]",18,0,18,1
1551,"['afp', 'ministrar', 'periodo', 'quarentenar', 'quarentenar', 'quarentenar', 'reuniao', 'santiago', 'santiago', 'santiago', 'temporario', 'transferir', 'viagem']","[1, 1, 1, 3, 3, 3, 1, 3, 3, 3, 1, 1, 1]","[]","[]",13,0,13,1
1552,"['coordenar', 'logistico', 'planar', 'regiao', 'saudar']","[1, 1, 1, 1, 1]","[]","[]",5,0,5,1
1556,"['adulto', 'aglomeracao', 'amplo', 'comportamento', 'desafiar', 'destacar', 'minimizar', 'precedent', 'saudar', 'saudar', 'treinar', 'vulneravel']","[1, 1, 1, 1, 1, 1, 1, 1, 2, 2, 1, 1]","[]","[]",12,0,12,1
1560,"['aglomeracao', 'autoridad', 'conformar', 'saudar', 'situacao']","[1, 1, 1, 1, 1]","['circular', 'ganhar', 'ilustrar']","[1, 1, 1]",5,3,8,1
1564,"['adotada', 'aglomeracao', 'habitant', 'quilometro']","[1, 1, 1, 1]","['padrar', 'padrar']","[2, 2]",4,2,6,1
1565,"['henriqu', 'previsao']","[1, 1]","['gleisi']","[1]",2,1,3,1
1568,"['alteracao', 'aprovacao', 'crise', 'emprestimo', 'fase', 'medida', 'pedido', 'proposta', 'proposto', 'proprio', 'pslsp', 'recurso', 'recurso', 'sancao', 'serao', 'tambem']","[1, 1, 1, 1, 1, 1, 1, 1, 1, 1, 1, 2, 2, 1, 1, 1]","[]","[]",16,0,16,1
1575,"['condicao', 'crise', 'demandar', 'estrategia', 'fundacao', 'fundacao', 'fundacao', 'manutencao', 'mudanca', 'mudanca', 'mudanca', 'necessidad', 'presidir', 'prever', 'previsao', 'servidor']","[1, 1, 1, 1, 3, 3, 3, 1, 3, 3, 3, 1, 1, 1, 1, 1]","['escravo', 'fotografia', 'maldiz']","[1, 1, 1]",16,3,19,1
1576,"['complicacao', 'infeccioso', 'journal', 'periodo']","[1, 1, 1, 1]","[]","[]",4,0,4,1
1580,"['demandar', 'distrito', 'situacao', 'suspeito']","[1, 1, 1, 1]","['facada', 'parir']","[1, 1]",4,2,6,1
1584,"['sabado', 'superar']","[1, 1]","[]","[]",2,0,2,1
1587,"['assintomatico', 'destacar', 'epidemiologico', 'estrategia', 'estrategia', 'importancia', 'instituto', 'isolar', 'observar', 'observar', 'recuperacao', 'saudar', 'situacao', 'surtir', 'vigilancia']","[1, 1, 1, 2, 2, 1, 1, 1, 2, 2, 1, 1, 1, 1, 1]","[]","[]",15,0,15,1
1588,"['calamidad', 'cronica', 'enfrentamento', 'entendimento', 'nelson', 'planar', 'posturar', 'situacao']","[1, 1, 1, 1, 1, 1, 1, 1]","['ideologia', 'misturar']","[1, 1]",8,2,10,1
1593,"['aglomeracao', 'circulacao', 'determinacao', 'fase', 'funcionamento']","[1, 1, 1, 1, 1]","[]","[]",5,0,5,1
1598,"['boletim', 'boletim', 'boletim', 'calculo', 'consorcio', 'consorcio', 'diariament', 'domingo', 'domingo', 'domingo', 'dosar', 'dosar', 'enxergar', 'equivalent', 'escassez', 'estabilidad', 'estatistico', 'folhar', 'iniciativo', 'levantamento', 'observar', 'periodo', 'plantao', 'quedo', 'recurso', 'saudar', 'spaulo', 'tendencia', 'tendencia']","[3, 3, 3, 1, 2, 2, 1, 3, 3, 3, 2, 2, 1, 1, 1, 1, 1, 1, 1, 1, 1, 1, 1, 1, 1, 1, 1, 2, 2]","[]","[]",29,0,29,1
1599,"['alternativo', 'escassez', 'imunizacao', 'instituto', 'ministrar', 'ministrar', 'obesidad', 'queiroga', 'queiroga', 'reforcar', 'saudar', 'videoconferencia']","[1, 1, 1, 1, 2, 2, 1, 2, 2, 1, 1, 1]","['espalhar']","[1]",12,1,13,1
1608,"['associacao', 'comparacao', 'indicador', 'intensivo', 'intensivo', 'intensivo', 'intensivo', 'internar', 'levantamento', 'periodo', 'privar', 'privar', 'privar', 'taxar', 'taxar']","[1, 1, 1, 4, 4, 4, 4, 1, 1, 1, 3, 3, 3, 2, 2]","[]","[]",15,0,15,1
1613,"['atuam', 'destinar', 'distrito', 'entregu', 'fundacao', 'igualitario', 'instituto', 'materiaprima', 'oswaldo', 'saudar', 'saudar', 'saudar', 'saudar', 'vigilancia']","[1, 1, 1, 1, 1, 1, 1, 1, 1, 4, 4, 4, 4, 1]","[]","[]",14,0,14,1
1614,"['consecutivo', 'consecutivo', 'consorcio', 'notificar', 'saudar', 'tendencia']","[2, 2, 1, 1, 1, 1]","[]","[]",6,0,6,1
1615,"['biliao', 'biliao', 'consequencia', 'reabrir', 'republico', 'significativo']","[2, 2, 1, 1, 1, 1]","[]","[]",6,0,6,1
1616,"['adotada', 'anteriorment', 'autonomia', 'autonomia', 'calamidad', 'calendario', 'decisao', 'inclusao', 'passageiro', 'prazo', 'prazo', 'revogar', 'suspenso', 'temporariament', 'transferencia']","[1, 1, 2, 2, 1, 1, 1, 1, 1, 2, 2, 1, 1, 1, 1]","[]","[]",15,0,15,1
1619,"['folhar', 'gabinet', 'integro', 'palacio', 'planalto', 'servidor']","[1, 1, 1, 1, 1, 1]","[]","[]",6,0,6,1
1621,"['ambientar', 'saudar']","[1, 1]","[]","[]",2,0,2,1
1623,"[]","[]","[]","[]",0,0,0,1
1627,"['acordo', 'arrecadacao', 'arrecadacao', 'aumento', 'congresso', 'despesa', 'distrito', 'enfrentamento', 'medida', 'medida', 'medida', 'medida', 'proposta', 'recurso', 'sancao']","[1, 2, 2, 1, 1, 1, 1, 1, 4, 4, 4, 4, 1, 1, 1]","[]","[]",15,0,15,1
1628,"['folhar', 'sabatino']","[1, 1]","[]","[]",2,0,2,1
1632,"['infectar', 'intensivo', 'internar', 'internar', 'internar', 'saudar', 'suspeito', 'totalizar']","[1, 1, 3, 3, 3, 1, 1, 1]","[]","[]",8,0,8,1
1633,"[]","[]","[]","[]",0,0,0,1
1634,"['afetado', 'cronica', 'destacar', 'destacar', 'especialment', 'impactar', 'oposto', 'panamericana', 'saneamento', 'saudar', 'saudar', 'situacao', 'vulnerabilidad']","[1, 1, 2, 2, 1, 1, 1, 1, 1, 2, 2, 1, 1]","[]","[]",13,0,13,1
1635,"['adotada', 'associacao', 'associacao', 'azevedo', 'boletim', 'boletim', 'colunista', 'concorrent', 'consorcio', 'consorcio', 'crescimento', 'crise', 'decisao', 'diariament', 'distrito', 'dosar', 'dosar', 'estatistico', 'folhar', 'funcao', 'imunizacao', 'inconsistencia', 'infectar', 'iniciativo', 'instituto', 'internar', 'ministrar', 'necessidad', 'periodo', 'prazo', 'recordar', 'recurso', 'reflexo', 'republico', 'respirador', 'respostar', 'restritivo', 'saudar', 'saudar', 'saudar', 'saudar', 'saudar', 'saudar', 'situacao', 'spaulo', 'taxar', 'vespera']","[1, 2, 2, 1, 2, 2, 1, 1, 2, 2, 1, 1, 1, 1, 1, 2, 2, 1, 1, 1, 1, 1, 1, 1, 1, 1, 1, 1, 1, 1, 1, 1, 1, 1, 1, 1, 1, 6, 6, 6, 6, 6, 6, 1, 1, 1, 1]","['sequer']","[1]",47,1,48,1
1637,"['ambientar', 'araujo', 'araujo', 'araujo', 'augusto', 'ernesto', 'gabinet', 'heleno', 'itamarati', 'ministrar', 'palacio', 'presenca', 'ricardo', 'sall', 'viagem']","[1, 3, 3, 3, 1, 1, 1, 1, 1, 1, 1, 1, 1, 1, 1]","[]","[]",15,0,15,1
1638,"['apreensao', 'biliao', 'deflagrar', 'diretoria', 'fase', 'investigacao', 'logistico', 'suspeito', 'suspeito', 'suspeito']","[1, 1, 1, 1, 1, 1, 1, 3, 3, 3]","[]","[]",10,0,10,1
1639,"['atrasar', 'atuacao', 'condicao', 'conjuntar', 'consumidor', 'crise', 'crise', 'curvo', 'decisao', 'desenvolvimento', 'economia', 'especializar', 'fase', 'flexibilizar', 'infraestrutura', 'mprj', 'necessario', 'planar', 'planar', 'planar', 'planar', 'planar', 'prever', 'respirador', 'respostar', 'saudar', 'saudar', 'saudar', 'suspeito', 'wilson', 'wilson', 'witzel', 'witzel']","[1, 1, 1, 1, 1, 2, 2, 1, 1, 1, 1, 1, 1, 1, 1, 1, 1, 5, 5, 5, 5, 5, 1, 1, 1, 3, 3, 3, 1, 2, 2, 2, 2]","['bandeiro', 'fraudar']","[1, 1]",33,2,35,1
1640,"['acompanhamento', 'acompanhamento', 'acumular', 'diagnosticar', 'sabado', 'sabado', 'saudar']","[2, 2, 1, 1, 2, 2, 1]","[]","[]",7,0,7,1
1642,"['exprefeito', 'folhar', 'gabinet', 'integro', 'lorenzoni', 'ministrar', 'ministrar', 'onyx', 'pastar', 'secretariager']","[1, 1, 1, 1, 1, 2, 2, 1, 1, 1]","['amigar']","[1]",10,1,11,1
1644,"['chefiar', 'implementacao', 'implementacao', 'ministrar', 'observar', 'parceiro', 'planar']","[1, 2, 2, 1, 1, 1, 1]","['sequer']","[1]",7,1,8,1
1645,"['ambientar', 'concreto', 'congresso', 'ministrar', 'positivar', 'pratico', 'presenca', 'regrar', 'republico', 'varar']","[1, 1, 1, 1, 1, 1, 1, 1, 1, 1]","[]","[]",10,0,10,1
1648,"['administrativo', 'colaboracao', 'regiao', 'regiao', 'restritivo', 'saudar']","[1, 1, 2, 2, 1, 1]","[]","[]",6,0,6,1
1650,"['afetado', 'recordar']","[1, 1]","[]","[]",2,0,2,1
1657,"['aplicacao', 'dosar', 'dosar', 'estimular', 'importancia', 'imunizacao', 'prtb']","[1, 2, 2, 1, 1, 1, 1]","[]","[]",7,0,7,1
1661,"['barroso', 'barroso', 'barroso', 'enfatizar', 'necessidad', 'plenario', 'reforcar', 'sessao']","[3, 3, 3, 1, 1, 1, 1, 1]","[]","[]",8,0,8,1
1662,"['exprefeito', 'folhar', 'folhar', 'integro', 'republico']","[1, 2, 2, 1, 1]","['supostament']","[1]",5,1,6,1
1666,"['academiar', 'converso', 'crise', 'desmatamento', 'inclusao', 'instituto', 'parceria', 'respostar', 'ricardo']","[1, 1, 1, 1, 1, 1, 1, 1, 1]","['manipulacao']","[1]",9,1,10,1
1667,"['fronteiro', 'regiao', 'saudar', 'transferir']","[1, 1, 1, 1]","[]","[]",4,0,4,1
1668,"['exercicio', 'gabinet', 'isolar', 'negativar', 'portavoz', 'positivar', 'reuniao', 'saudar']","[1, 1, 1, 1, 1, 1, 1, 1]","[]","[]",8,0,8,1
1669,"['adulto', 'adulto', 'adulto', 'assistencia', 'assistencia', 'assistencia', 'ausencia', 'benjamin', 'calamidad', 'carla', 'carla', 'carla', 'carla', 'complicacao', 'decorrencia', 'decorrencia', 'destacar', 'diagnosticar', 'diagnosticar', 'dificuldad', 'enfermagem', 'especifico', 'flavio', 'gestant', 'gestant', 'gestant', 'gestant', 'gestant', 'imunizacao', 'infectar', 'internacao', 'journal', 'lesao', 'levantamento', 'marinhar', 'painel', 'pereira', 'respiratorio', 'rotina', 'saudad', 'saudar', 'saudar', 'saudar', 'saudar', 'sigla', 'taxar', 'vulnerabilidad', 'vulneravel', 'vulneravel']","[3, 3, 3, 3, 3, 3, 1, 1, 1, 4, 4, 4, 4, 1, 2, 2, 1, 2, 2, 1, 1, 1, 1, 5, 5, 5, 5, 5, 1, 1, 1, 1, 1, 1, 1, 1, 1, 1, 1, 1, 4, 4, 4, 4, 1, 1, 1, 2, 2]","['parir', 'pelar']","[1, 1]",49,2,51,1
1670,"['ausencia', 'desenvolvimento', 'prazo', 'saudar', 'saudar']","[1, 1, 1, 2, 2]","[]","[]",5,0,5,1
1671,"['feriar', 'monitoramento', 'periodo', 'proporcao', 'taxar']","[1, 1, 1, 1, 1]","[]","[]",5,0,5,1
1672,"['bolsonarista', 'decisao', 'estrategico', 'exministro', 'nomeacao', 'palacio', 'planalto', 'punicao', 'saudar', 'secretariager', 'subir']","[1, 1, 1, 1, 1, 1, 1, 1, 1, 1, 1]","[]","[]",11,0,11,1
1674,"['acompanhamento', 'acompanhamento', 'acumular', 'diagnosticar', 'domingo', 'saudar']","[2, 2, 1, 1, 1, 1]","[]","[]",6,0,6,1
1678,"['consultoria', 'empatar', 'levantamento', 'margem', 'periodo', 'precandidato', 'republico', 'subir']","[1, 1, 1, 1, 1, 1, 1, 1]","['numericament']","[1]",8,1,9,1
1679,"['carla', 'carla', 'deteccao', 'necessario', 'oficio', 'proposto', 'proposto', 'pslsp', 'pslsp', 'rigoroso', 'submetido', 'testagem', 'tramitar', 'zambelli', 'zambelli', 'zambelli']","[2, 2, 1, 1, 1, 2, 2, 2, 2, 1, 1, 1, 1, 3, 3, 3]","[]","[]",16,0,16,1
1681,"['ambientar', 'recuperacao']","[1, 1]","[]","[]",2,0,2,1
1683,"['economia', 'gued', 'gued', 'gued', 'ministrar', 'parcelar', 'parcelar', 'parcelar', 'parcelar', 'respectivament', 'sabado', 'sabado', 'sabado', 'sabado', 'transmissao']","[1, 3, 3, 3, 1, 4, 4, 4, 4, 1, 4, 4, 4, 4, 1]","[]","[]",15,0,15,1
1686,"['consolidar', 'distrito', 'espirito', 'liderar', 'regiao', 'roraima', 'sabado', 'saudar', 'saudar', 'subir']","[1, 1, 1, 1, 1, 1, 1, 2, 2, 1]","[]","[]",10,0,10,1
1687,"['academiar', 'academiar', 'autoridad', 'concessionario', 'equipamento', 'estabilidad', 'fase', 'fase', 'fase', 'integrant', 'intervalar', 'periodo', 'planar', 'quarentenar', 'quarentenar', 'reabertura', 'reabrir', 'salao', 'superar']","[2, 2, 1, 1, 1, 1, 3, 3, 3, 1, 1, 1, 1, 2, 2, 1, 1, 1, 1]","[]","[]",19,0,19,1
1688,"['consumidor', 'especializar', 'fluxo', 'infectar', 'isolar', 'piorar', 'preocupacao', 'suprimento']","[1, 1, 1, 1, 1, 1, 1, 1]","['vazio']","[1]",8,1,9,1
1691,"['ambito', 'argumentar', 'arrecadacao', 'economia', 'espirito', 'federar', 'ministrar', 'ministrar', 'prazo', 'recurso', 'reflexo', 'supremo', 'supremo', 'suspenso']","[1, 1, 1, 1, 1, 1, 2, 2, 1, 1, 1, 2, 2, 1]","[]","[]",14,0,14,1
1693,"['decisao', 'decisao', 'individuar', 'lira', 'magistrado', 'ppal', 'pslrj', 'reuter', 'silveiro', 'silveiro', 'supremo', 'supremo']","[2, 2, 1, 1, 1, 1, 1, 1, 2, 2, 2, 2]","[]","[]",12,0,12,1
1696,"['dificuldad', 'domingo', 'domingo', 'domingo', 'domingo', 'fundacao', 'internar', 'internar', 'obesidad', 'respiratorio', 'saudar', 'saudar', 'vigilancia']","[1, 4, 4, 4, 4, 1, 2, 2, 1, 1, 2, 2, 1]","[]","[]",13,0,13,1
1698,"['antonio', 'anvisa', 'anvisa', 'anvisa', 'anvisa', 'anvisa', 'aplicacao', 'autorizacao', 'condicao', 'consultoria', 'definitivo', 'definitivo', 'definitivo', 'demmg', 'domingo', 'entendimento', 'especifico', 'exigencia', 'exigencia', 'exigencia', 'expectativa', 'iniciativo', 'instituto', 'insuficient', 'internar', 'legislativo', 'limitacao', 'limitacao', 'ministrar', 'mudanca', 'oferecido', 'orientacao', 'pacheco', 'pastar', 'planalto', 'possibilidad', 'prever', 'previsao', 'privar', 'privar', 'provisorio', 'reuniao', 'reuniao', 'risco', 'risco', 'saudar', 'saudar', 'saudar', 'saudar', 'saudar', 'saudar', 'servidor', 'trimestr', 'vigilancia']","[1, 5, 5, 5, 5, 5, 1, 1, 1, 1, 3, 3, 3, 1, 1, 1, 1, 3, 3, 3, 1, 1, 1, 1, 1, 1, 2, 2, 1, 1, 1, 1, 1, 1, 1, 1, 1, 1, 2, 2, 1, 2, 2, 2, 2, 6, 6, 6, 6, 6, 6, 1, 1, 1]","['versao']","[1]",54,1,55,1
1699,"['acordo', 'administrativo', 'aglomeracao', 'apoio', 'boletim', 'carat', 'comportamento', 'domingo', 'exministro', 'exministro', 'exministro', 'inicialment', 'interlocutor', 'interlocutor', 'negativa', 'nogueira', 'oficialment', 'oliveira', 'pedido', 'pedido', 'planalto', 'planalto', 'planalto', 'possibilidad', 'prazo', 'punicao', 'queiroga', 'sancao', 'sancao', 'tambem', 'tambem', 'ultimo']","[1, 1, 1, 1, 1, 1, 1, 1, 3, 3, 3, 1, 2, 2, 1, 1, 1, 1, 2, 2, 3, 3, 3, 1, 1, 1, 1, 2, 2, 2, 2, 1]","[]","[]",32,0,32,1
1701,"['normalment', 'preparacao', 'proporcao']","[1, 1, 1]","['ganhar']","[1]",3,1,4,1
1702,"['apurar', 'apurar', 'broadcast', 'tcu', 'tcu']","[2, 2, 1, 2, 2]","[]","[]",5,0,5,1
1703,"['cenario', 'consenso', 'converso', 'converso', 'cupula', 'jorg', 'permanencia', 'situacao', 'unanimidad', 'unanimidad']","[1, 1, 2, 2, 1, 1, 1, 1, 2, 2]","['camisa', 'crer']","[1, 1]",10,2,12,1
1704,"['instituto', 'previsao']","[1, 1]","[]","[]",2,0,2,1
1708,"['companhia', 'parceiro', 'passageiro']","[1, 1, 1]","['checagem', 'cnh', 'gravacao', 'usuario', 'usuario']","[1, 1, 1, 2, 2]",3,5,8,1
1709,"['fez']","[1]","[]","[]",1,0,1,1
1713,"['augusto', 'autoridad', 'decisao', 'edson', 'fachin', 'forcatarefa', 'forcatarefa', 'forcatarefa', 'gabinet', 'investigacao', 'ministrar', 'privilegiar', 'privilegiar', 'recurso', 'rejeicao', 'republico', 'republico', 'republico', 'supremo']","[1, 1, 1, 1, 1, 3, 3, 3, 1, 1, 1, 2, 2, 1, 1, 3, 3, 3, 1]","[]","[]",19,0,19,1
1714,"['araujo', 'chefiar', 'consequencia', 'cupula', 'ernesto', 'previsao', 'regiao', 'significativo']","[1, 1, 1, 1, 1, 1, 1, 1]","[]","[]",8,0,8,1
1715,"['colunista', 'folhar', 'spaulo']","[1, 1, 1]","[]","[]",3,0,3,1
1718,"['aglomeracao', 'aglomeracao', 'algun', 'necessario', 'realizacao', 'sociai', 'tambem']","[2, 2, 1, 1, 1, 1, 1]","[]","[]",7,0,7,1
1722,"['exministro', 'exministro', 'folhar', 'henriqu', 'justicar', 'prtb', 'saudar', 'spaulo']","[2, 2, 1, 1, 1, 1, 1, 1]","[]","[]",8,0,8,1
1723,"['adversario', 'arthur', 'demrj', 'independentement', 'lira', 'lira', 'lira', 'ppal', 'rejeitar', 'rejeitar', 'rossi', 'tendencia']","[1, 1, 1, 1, 3, 3, 3, 1, 2, 2, 1, 1]","[]","[]",12,0,12,1
1726,"['atrasar', 'autoridad', 'avancar', 'estagio', 'fabricacao', 'federar', 'prioridad', 'remessar']","[1, 1, 1, 1, 1, 1, 1, 1]","['atribuir', 'humanar', 'misturar']","[1, 1, 1]",8,3,11,1
1729,"['espirito', 'espirito', 'planar', 'posicionamento', 'preocupacao', 'previsao']","[2, 2, 1, 1, 1, 1]","[]","[]",6,0,6,1
1730,"['demandar', 'distrito', 'intensivo', 'pulmonar', 'recurso', 'saudar', 'saudar', 'suportar', 'suportar', 'suspeito', 'transferencia', 'ventilatorio', 'ventilatorio']","[1, 1, 1, 1, 1, 2, 2, 2, 2, 1, 1, 2, 2]","[]","[]",13,0,13,1
1734,"['empatar', 'liderar', 'margem']","[1, 1, 1]","[]","[]",3,0,3,1
1735,"['ampliacao', 'antecipar', 'anuncio', 'biliao', 'expansao', 'impulsionar', 'inicialment', 'liderar', 'logistico', 'prazo', 'previsto', 'reuter']","[1, 1, 1, 1, 1, 1, 1, 1, 1, 1, 1, 1]","[]","[]",12,0,12,1
1737,"['decisao', 'decisao', 'definitivo', 'fluminens', 'investigacao', 'investigacao', 'justicar', 'justicar', 'mprj', 'republico', 'suspenso', 'varar']","[2, 2, 1, 1, 2, 2, 2, 2, 1, 1, 1, 1]","[]","[]",12,0,12,1
1741,"['justicar', 'justicar', 'mendonca', 'mendonca', 'ministrar', 'ministrar', 'positivar']","[2, 2, 2, 2, 2, 2, 1]","[]","[]",7,0,7,1
1743,"['anvisa', 'aprovacao', 'congresso', 'expectativa', 'jurista', 'parceria', 'vigilancia']","[1, 1, 1, 1, 1, 1, 1]","['cbn']","[1]",7,1,8,1
1746,"['adotada', 'autoridad', 'decisao', 'dengu', 'dengu', 'espirito', 'espirito', 'saudar', 'saudar', 'saudar', 'saudar', 'suspeito']","[1, 1, 1, 2, 2, 2, 2, 4, 4, 4, 4, 1]","['circular']","[1]",12,1,13,1
1750,"['desenvolvimento', 'possibilidad', 'regiao', 'saudar', 'sorocaba', 'sorocaba']","[1, 1, 1, 1, 2, 2]","['filmar']","[1]",6,1,7,1
1751,"['competicao', 'competicao', 'competicao', 'condicao', 'consequencia', 'diagnosticar', 'europeu', 'europeu', 'europeu', 'forcatarefa', 'forcatarefa', 'intenso', 'internar', 'normalment', 'paralisar', 'paralisar', 'positivar', 'presenca', 'saudar', 'suspenso', 'suspenso', 'toquio', 'tornear', 'tornear', 'tornear', 'viagem']","[3, 3, 3, 1, 1, 1, 3, 3, 3, 2, 2, 1, 1, 1, 2, 2, 1, 1, 1, 2, 2, 1, 3, 3, 3, 1]","[]","[]",26,0,26,1
1753,"['ambientar', 'conservacao', 'desmatamento', 'equivalent', 'espirito', 'liderar', 'ministrar', 'ministrar', 'ministrar', 'oficio', 'oficio', 'regiao', 'ricardo', 'sall', 'sall', 'sall']","[1, 1, 1, 1, 1, 1, 3, 3, 3, 2, 2, 1, 1, 3, 3, 3]","[]","[]",16,0,16,1
1755,"['bandeirant', 'desenvolvimento', 'oferecido', 'palacio', 'preocupacao', 'situacao', 'situacao', 'situacao', 'tucano']","[1, 1, 1, 1, 1, 3, 3, 3, 1]","['espalhar']","[1]",9,1,10,1
1756,"['consorcio', 'consorcio', 'estimativo', 'igualitario', 'imunizacao', 'iniciativo', 'pastar', 'recebido', 'sabado', 'saudar', 'saudar']","[2, 2, 1, 1, 1, 1, 1, 1, 1, 2, 2]","['ganhar', 'ganhar']","[2, 2]",11,2,13,1
1757,"['manutencao', 'proposto', 'provisorio', 'recebido', 'unanimidad']","[1, 1, 1, 1, 1]","['sacar']","[1]",5,1,6,1
1759,"['instituto', 'investigacao', 'sendo']","[1, 1, 1]","[]","[]",3,0,3,1
1762,"['fase', 'fase', 'orientacao', 'planar', 'planar', 'reducao']","[2, 2, 1, 2, 2, 1]","[]","[]",6,0,6,1
1767,"['agravar', 'antonio', 'arrecadacao', 'augusto', 'augusto', 'cnmp', 'conformar', 'crise', 'decorrencia', 'epidemiar', 'impactar', 'impacto', 'justicar', 'pagamento', 'pereira', 'pereira', 'plano', 'quedo', 'regrar', 'republico', 'saudar', 'saudar', 'servidor', 'supremo', 'surtir', 'tributario']","[1, 1, 1, 2, 2, 1, 1, 1, 1, 1, 1, 1, 1, 1, 2, 2, 1, 1, 1, 1, 2, 2, 1, 1, 1, 1]","[]","[]",26,0,26,1
1768,"['aliviar', 'demanda', 'dificuldad', 'epidemia', 'flavio', 'medida', 'medida', 'medida', 'regiao', 'regiao', 'situacao']","[1, 1, 1, 1, 1, 3, 3, 3, 2, 2, 1]","['ampla']","[1]",11,1,12,1
1769,"['adhanom', 'alternativo', 'conjunto', 'necessario', 'recurso', 'saudar', 'tedro', 'tedro']","[1, 1, 1, 1, 1, 1, 2, 2]","['realment', 'realment']","[2, 2]",8,2,10,1
1773,"['aprovacao', 'pagamento', 'subordinar', 'tendencia']","[1, 1, 1, 1]","[]","[]",4,0,4,1
1774,"['consequencia']","[1]","[]","[]",1,0,1,1
1775,"['aumento', 'exprefeito', 'folhar', 'sabatino', 'sabatino', 'spaulo']","[1, 1, 1, 2, 2, 1]","['lupa', 'verificar']","[1, 1]",6,2,8,1
1778,"['arthur', 'demrj', 'lira', 'parcelar', 'ppal', 'republico', 'rossi']","[1, 1, 1, 1, 1, 1, 1]","['legendar']","[1]",7,1,8,1
1779,"['enfermagem', 'externo', 'margem']","[1, 1, 1]","[]","[]",3,0,3,1
1781,"['claudio', 'colegiado', 'henri', 'instituto', 'instituto', 'investigacao', 'notificar', 'unanimidad']","[1, 1, 1, 2, 2, 1, 1, 1]","['autopsia', 'menino']","[1, 1]",8,2,10,1
1782,"['concorrent', 'levantamento', 'necessario', 'proximo', 'situacao']","[1, 1, 1, 1, 1]","[]","[]",5,0,5,1
1784,"['assintomatico', 'autoridad', 'calculo', 'comissao', 'comissao', 'economia', 'epicentro', 'epidemiar', 'esforco', 'habitant', 'regiao', 'ritmar', 'saudar', 'saudar', 'surtir', 'surtir', 'suspenso', 'temor']","[1, 1, 1, 2, 2, 1, 1, 1, 1, 1, 1, 1, 2, 2, 2, 2, 1, 1]","[]","[]",18,0,18,1
1785,"['associacao', 'crise', 'despesa', 'destinar', 'funcao', 'iniciativo', 'integrant', 'parceria', 'prever']","[1, 1, 1, 1, 1, 1, 1, 1, 1]","[]","[]",9,0,9,1
1788,"['biliao', 'biliao', 'congresso', 'destinar', 'emendar', 'equipamento', 'esquema', 'minoria', 'tcu']","[2, 2, 1, 1, 1, 1, 1, 1, 1]","['secreto']","[1]",9,1,10,1
1789,"['demrj', 'exministro', 'governista', 'ministrar', 'positivar', 'ricardo', 'supremo']","[1, 1, 1, 1, 1, 1, 1]","[]","[]",7,0,7,1
1793,"['infectar']","[1]","['boatar', 'circular', 'circular', 'cocaina', 'imagem', 'verdadeiro', 'versao']","[1, 2, 2, 1, 1, 1, 1]",1,7,8,1
1794,"['acumular', 'cenario', 'crise', 'economia', 'economia', 'emendar', 'expectativa', 'impulsionar', 'internar', 'quedo', 'quedo', 'reabertura', 'recordar', 'recordar', 'relaxamento', 'subir']","[1, 1, 1, 2, 2, 1, 1, 1, 1, 2, 2, 1, 2, 2, 1, 1]","[]","[]",16,0,16,1
1795,"['araujo', 'benjamin', 'benjamin', 'comparacao', 'conjuntar', 'cooperacao', 'ernesto', 'esquema', 'possibilidad', 'primeiroministro', 'prioridad', 'pslsp', 'saudar', 'viagem']","[1, 2, 2, 1, 1, 1, 1, 1, 1, 1, 1, 1, 1, 1]","['compartilhar', 'imagem']","[1, 1]",14,2,16,1
1799,"['dedicar', 'infectar', 'prazo', 'previsao', 'saudar']","[1, 1, 1, 1, 1]","['imagem']","[1]",5,1,6,1
1800,"['ambientar', 'ambientar', 'aurelio', 'calculo', 'conservacao', 'conservacao', 'conservacao', 'conservacao', 'desmatamento', 'elaborar', 'especifico', 'estrategia', 'extensao', 'federar', 'fluxo', 'impactar', 'impacto', 'jornada', 'manutencao', 'monitoramento', 'orientacao', 'prever', 'prever', 'proposto', 'quilometro', 'recurso', 'suspenso', 'taxar', 'velocidad', 'velocidad']","[2, 2, 1, 1, 4, 4, 4, 4, 1, 1, 1, 1, 1, 1, 1, 1, 1, 1, 1, 1, 1, 2, 2, 1, 1, 1, 1, 1, 2, 2]","[]","[]",30,0,30,1
1801,"['alvorar', 'alvorar', 'bandeirant', 'congresso', 'contabilizar', 'descumprir', 'descumprir', 'domingo', 'infectar', 'integrant', 'monitoramento', 'negativar', 'palacio', 'palacio', 'palacio', 'planalto', 'presenca', 'supremo']","[2, 2, 1, 1, 1, 2, 2, 1, 1, 1, 1, 1, 3, 3, 3, 1, 1, 1]","[]","[]",18,0,18,1
1805,"['diagnosticar', 'positivar', 'positivar', 'sabado', 'superar', 'superar']","[1, 2, 2, 1, 2, 2]","['amigar']","[1]",6,1,7,1
1806,"['adotada', 'biliao', 'cenario', 'crise', 'demandar', 'demmg', 'despesa', 'federar', 'importancia', 'pacheco', 'pacheco', 'pacheco', 'patamar', 'posturar', 'presenca', 'presenca', 'reuniao', 'reuniao', 'reuniao', 'reuniao', 'wellington']","[1, 1, 1, 1, 1, 1, 1, 1, 1, 3, 3, 3, 1, 1, 2, 2, 4, 4, 4, 4, 1]","[]","[]",21,0,21,1
1815,"['adesao', 'associacao', 'condicao', 'dengu', 'epidemiar', 'estimular', 'implementar', 'instituto', 'piorar', 'preventivo', 'prever', 'quedo', 'saudar', 'situacao']","[1, 1, 1, 1, 1, 1, 1, 1, 1, 1, 1, 1, 1, 1]","['espalhar']","[1]",14,1,15,1
1818,"['araujo', 'araujo', 'compilar', 'comportamento', 'conjuntar', 'depoimento', 'impactar', 'saudar']","[2, 2, 1, 1, 1, 1, 1, 1]","[]","[]",8,0,8,1
1820,"['cronica', 'cronica', 'ministrar', 'quadro', 'quadro', 'saudar']","[2, 2, 1, 2, 2, 1]","[]","[]",6,0,6,1
1823,"['adhanom', 'afp', 'afp', 'afp', 'afp', 'afp', 'afp', 'afp', 'afp', 'afp', 'afp', 'afp', 'afp', 'afp', 'afp', 'afp', 'afp', 'afp', 'afp', 'afp', 'afp', 'antonio', 'californio', 'celebrar', 'cerimonia', 'checo', 'cirurgico', 'client', 'companhia', 'companhia', 'convencao', 'convencao', 'decisao', 'decisao', 'desembarcar', 'diagnosticar', 'dificuldad', 'disseminacao', 'disseminacao', 'distrito', 'epicentro', 'epidemiar', 'epidemiar', 'epidemiar', 'epidemiar', 'epidemiar', 'epidemiar', 'espanha', 'espanha', 'externo', 'florido', 'funcao', 'funcao', 'guarulho', 'guarulho', 'guarulho', 'hubei', 'infectar', 'infectar', 'infectar', 'infectar', 'instalacao', 'integrant', 'integrant', 'internar', 'isolar', 'isolar', 'kong', 'kong', 'kong', 'kong', 'kong', 'kong', 'liderar', 'mexico', 'mexico', 'movimentacao', 'orientacao', 'palacio', 'passageiro', 'passageiro', 'passageiro', 'passageiro', 'passageiro', 'passageiro', 'passageiro', 'passageiro', 'passageiro', 'passageiro', 'passageiro', 'passageiro', 'positivar', 'positivar', 'preocupacao', 'preocupacao', 'propagacao', 'provincia', 'provincia', 'quarentenar', 'quarentenar', 'quilometro', 'regiao', 'respiratorio', 'reuter', 'reuter', 'reuter', 'reuter', 'reuter', 'reuter', 'reuter', 'reuter', 'reuter', 'reuter', 'reuter', 'reuter', 'reuter', 'reuter', 'reuter', 'reuter', 'reuter', 'reuter', 'rocha', 'saudar', 'saudar', 'surtir', 'surtir', 'surtir', 'surtir', 'suspeito', 'suspeito', 'suspensao', 'tedro', 'temporariament', 'toquio', 'toquio', 'transferir', 'transferir', 'transmissao', 'transmissao', 'transmissao', 'tripulacao', 'tripulacao', 'turista', 'turistico', 'velocidad', 'viagem', 'viagem', 'viagem', 'visitant', 'visitant', 'visitant', 'xinhua', 'xinhua', 'xinhua', 'xinhua', 'xinhua', 'xinhua', 'xinhua', 'xinhua']","[1, 20, 20, 20, 20, 20, 20, 20, 20, 20, 20, 20, 20, 20, 20, 20, 20, 20, 20, 20, 20, 1, 1, 1, 1, 1, 1, 1, 2, 2, 2, 2, 2, 2, 1, 1, 1, 2, 2, 1, 1, 6, 6, 6, 6, 6, 6, 2, 2, 1, 1, 2, 2, 3, 3, 3, 1, 4, 4, 4, 4, 1, 2, 2, 1, 2, 2, 6, 6, 6, 6, 6, 6, 1, 2, 2, 1, 1, 1, 12, 12, 12, 12, 12, 12, 12, 12, 12, 12, 12, 12, 2, 2, 2, 2, 1, 2, 2, 2, 2, 1, 1, 1, 18, 18, 18, 18, 18, 18, 18, 18, 18, 18, 18, 18, 18, 18, 18, 18, 18, 18, 1, 2, 2, 4, 4, 4, 4, 2, 2, 1, 1, 1, 2, 2, 2, 2, 3, 3, 3, 2, 2, 1, 1, 1, 3, 3, 3, 3, 3, 3, 8, 8, 8, 8, 8, 8, 8, 8]","['parir', 'parir', 'parir', 'torrar', 'usuario', 'vazio', 'vazio', 'vazio', 'verificar']","[3, 3, 3, 1, 1, 3, 3, 3, 1]",159,9,168,1
1826,"['comissao', 'conflito', 'congresso', 'contencao', 'desenvolvimento', 'despesa', 'economia', 'especialment', 'gued', 'infraestrutura', 'marinhar', 'marinhar', 'marinhar', 'marinhar', 'marinhar', 'ministrar', 'ministrar']","[1, 1, 1, 1, 1, 1, 1, 1, 1, 1, 5, 5, 5, 5, 5, 2, 2]","[]","[]",17,0,17,1
1827,"['administrativo', 'apurar', 'argumentar', 'arthur', 'articulacao', 'congresso', 'congresso', 'economia', 'flavia', 'flavia', 'flavia', 'gued', 'gued', 'gued', 'lira', 'lira', 'lira', 'ministrar', 'palacio', 'planalto', 'planalto', 'planalto', 'reuniao', 'reuniao', 'reuniao', 'sancao', 'tributario', 'vetar', 'vetar']","[1, 1, 1, 1, 1, 2, 2, 1, 3, 3, 3, 3, 3, 3, 3, 3, 3, 1, 1, 3, 3, 3, 3, 3, 3, 1, 1, 2, 2]","['rompimento', 'rosario', 'wagner']","[1, 1, 1]",29,3,32,1
1828,"['avancar', 'desafiar', 'estagio', 'expectativa', 'saudar', 'suspenso']","[1, 1, 1, 1, 1, 1]","['filmar', 'gravacao']","[1, 1]",6,2,8,1
1832,"['imunizacao', 'iniciativo', 'instituto', 'planar', 'saudar']","[1, 1, 1, 1, 1]","[]","[]",5,0,5,1
1833,"['celso', 'celso', 'consumidor', 'consumidor', 'especialment', 'esquema', 'justicar', 'justicar', 'justicar', 'pagamento', 'pratico', 'processo', 'processo', 'queiroz', 'reclamacao']","[2, 2, 2, 2, 1, 1, 3, 3, 3, 1, 1, 2, 2, 1, 1]","[]","[]",15,0,15,1
1836,"['boletim', 'boletim', 'boletim', 'contabilizar', 'habitant', 'levantamento', 'piorar', 'saudar', 'saudar']","[3, 3, 3, 1, 1, 1, 1, 2, 2]","[]","[]",9,0,9,1
1837,"['boletim', 'conformar', 'intensivo', 'internacao', 'internar', 'pulmonar', 'suportar']","[1, 1, 1, 1, 1, 1, 1]","[]","[]",7,0,7,1
1838,"['especialment']","[1]","[]","[]",1,0,1,1
1841,"['calculo', 'calculo', 'celebrar', 'cenario', 'cenario', 'condicao', 'confederacao', 'consorcio', 'consorcio', 'decorrent', 'diariament', 'dificuldad', 'distrito', 'enxergar', 'escassez', 'espirito', 'estabilidad', 'estatistico', 'flexibilizacao', 'folhar', 'imunizacao', 'iniciativo', 'instituto', 'levantamento', 'margem', 'notificar', 'oficio', 'parceria', 'parceria', 'plantao', 'presenciar', 'projecao', 'quedo', 'quedo', 'recurso', 'roraima', 'saudar', 'saudar', 'saudar', 'saudar', 'saudar', 'significativo', 'spaulo', 'tendencia', 'tendencia', 'tendencia', 'tendencia']","[2, 2, 1, 2, 2, 1, 1, 2, 2, 1, 1, 1, 1, 1, 1, 1, 1, 1, 1, 1, 1, 1, 1, 1, 1, 1, 1, 2, 2, 1, 1, 1, 2, 2, 1, 1, 5, 5, 5, 5, 5, 1, 1, 4, 4, 4, 4]","[]","[]",47,0,47,1
1843,"['anvisa', 'anvisa', 'anvisa', 'anvisa', 'anvisa', 'anvisa', 'anvisa', 'boletim', 'carat', 'conformar', 'decisao', 'destinar', 'entregu', 'especialment', 'instituto', 'insuficient', 'investigacao', 'parceria', 'possibilidad', 'precaucao', 'preservar', 'prever', 'relativo', 'respostar', 'suspensao', 'suspensao', 'suspensao', 'suspensao', 'suspensao', 'vigilancia']","[7, 7, 7, 7, 7, 7, 7, 1, 1, 1, 1, 1, 1, 1, 1, 1, 1, 1, 1, 1, 1, 1, 1, 1, 5, 5, 5, 5, 5, 1]","['patrocinador']","[1]",30,1,31,1
1844,"['apurar', 'atuacao', 'augusto', 'autoridad', 'enfrentamento', 'externo', 'federar', 'integro', 'ministrar', 'pratico', 'preliminar', 'republico', 'saudar', 'saudar', 'supremo']","[1, 1, 1, 1, 1, 1, 1, 1, 1, 1, 1, 1, 2, 2, 1]","[]","[]",15,0,15,1
1845,"['anteriorment', 'dificuldad', 'independentement', 'internacao', 'internar', 'negativar', 'normalment', 'respiratorio', 'saudar', 'saudar', 'situacao', 'transmissao', 'viagem']","[1, 1, 1, 1, 1, 1, 1, 1, 2, 2, 1, 1, 1]","[]","[]",13,0,13,1
1847,"['decisao', 'desenvolvido', 'lancamento', 'reuter']","[1, 1, 1, 1]","[]","[]",4,0,4,1
1848,"['aprovacao', 'crise', 'desempenhar', 'folhar', 'levantamento', 'margem', 'regiao', 'saudar', 'spaulo']","[1, 1, 1, 1, 1, 1, 1, 1, 1]","[]","[]",9,0,9,1
1849,"['acordo', 'plano', 'preocupacao', 'proposta', 'tambem', 'transmissao']","[1, 1, 1, 1, 1, 1]","['gravacao']","[1]",6,1,7,1
1850,"['algun', 'aumento', 'diariament', 'informaco', 'profissionai', 'resultado', 'resultado', 'tambem']","[1, 1, 1, 1, 1, 2, 2, 1]","['usuario', 'visualizar']","[1, 1]",8,2,10,1
1853,"['domingo', 'possibilidad']","[1, 1]","[]","[]",2,0,2,1
1854,"['autoridad', 'federar', 'hospitalizacao', 'ritmar']","[1, 1, 1, 1]","[]","[]",4,0,4,1
1855,"[]","[]","[]","[]",0,0,0,1
1856,"['andrew', 'saudar']","[1, 1]","[]","[]",2,0,2,1
1857,"['empatar', 'exprefeito', 'folhar', 'integro', 'margem', 'republicanosrj', 'rocha']","[1, 1, 1, 1, 1, 1, 1]","[]","[]",7,0,7,1
1858,"['expectativa', 'oferecido', 'pagamento', 'previsao']","[1, 1, 1, 1]","[]","[]",4,0,4,1
1859,"['adiamento', 'constituicao', 'epidemiar', 'governista', 'inedito', 'justicar', 'prever', 'prever', 'previsto', 'proposto']","[1, 1, 1, 1, 1, 1, 2, 2, 1, 1]","[]","[]",10,0,10,1
1861,"['apoio', 'aurelio', 'congresso', 'congresso', 'decisao', 'destacar', 'exministro', 'mello', 'processo', 'supremo']","[1, 1, 2, 2, 1, 1, 1, 1, 1, 1]","['faccao', 'soltar']","[1, 1]",10,2,12,1
1863,"['boletim', 'condicao', 'decorrencia', 'internar', 'internar', 'situacao', 'situacao']","[1, 1, 1, 2, 2, 2, 2]","[]","[]",7,0,7,1
1866,"['acumular', 'acumular', 'adotada', 'ambientar', 'ambientar', 'araujo', 'araujo', 'araujo', 'araujo', 'araujo', 'chefiar', 'conflito', 'crise', 'decisao', 'deflagrar', 'desmatamento', 'destacar', 'diplomata', 'diplomata', 'ernesto', 'ernesto', 'ernesto', 'exministro', 'exministro', 'exministro', 'externo', 'gabinet', 'gabinet', 'gabinet', 'gabinet', 'gabinet', 'ideologico', 'ideologico', 'ideologico', 'ideologico', 'integrant', 'integrant', 'integrant', 'integrant', 'interpretar', 'investigacao', 'jorg', 'julgamento', 'legislativo', 'legislativo', 'martim', 'martim', 'martim', 'martim', 'martim', 'martim', 'ministrar', 'ministrar', 'ministrar', 'ministrar', 'ministrar', 'ministrar', 'ministrar', 'ministrar', 'ministrar', 'ministrar', 'ministrar', 'mudanca', 'nomeacao', 'palacio', 'pastar', 'pastar', 'planalto', 'precandidato', 'primario', 'reuniao', 'ricardo', 'ricardo', 'ricardo', 'ricardo', 'sall', 'sall', 'sall', 'sall', 'secom', 'secom', 'secom', 'sessao', 'sessao', 'sessao', 'subordinar', 'supremo', 'transferir', 'wajngarten', 'wajngarten', 'wajngarten', 'wajngarten', 'wajngarten']","[2, 2, 1, 2, 2, 5, 5, 5, 5, 5, 1, 1, 1, 1, 1, 1, 1, 2, 2, 3, 3, 3, 3, 3, 3, 1, 5, 5, 5, 5, 5, 4, 4, 4, 4, 4, 4, 4, 4, 1, 1, 1, 1, 2, 2, 6, 6, 6, 6, 6, 6, 11, 11, 11, 11, 11, 11, 11, 11, 11, 11, 11, 1, 1, 1, 2, 2, 1, 1, 1, 1, 4, 4, 4, 4, 4, 4, 4, 4, 3, 3, 3, 3, 3, 3, 1, 1, 1, 5, 5, 5, 5, 5]","['casamentar', 'filmar', 'filmar', 'verdadeiro']","[1, 2, 2, 1]",93,4,97,1
1870,"['dialogo', 'exgovernador', 'exgovernador', 'exministro', 'integrant', 'sido']","[1, 2, 2, 1, 1, 1]","['checagem', 'lupa']","[1, 1]",6,2,8,1
1871,"['privatizacao', 'ricardo', 'sall', 'saudar']","[1, 1, 1, 1]","['soltar']","[1]",4,1,5,1
1872,"['adotada', 'destacar', 'dialogo', 'saudar', 'saudar', 'saudar', 'saudar', 'saudar']","[1, 1, 1, 5, 5, 5, 5, 5]","[]","[]",8,0,8,1
1874,"['infectar', 'infectar', 'margem', 'negativar', 'suspensao']","[2, 2, 1, 1, 1]","[]","[]",5,0,5,1
1878,"['aglomeracao', 'contencao', 'desenvolvimento', 'estagio', 'fase', 'fase', 'flexibilizacao', 'funcionamento', 'funcionamento', 'funcionamento', 'orientacao', 'periodo', 'planar', 'planar', 'pratico', 'quarentenar', 'reabertura', 'salao']","[1, 1, 1, 1, 2, 2, 1, 3, 3, 3, 1, 1, 2, 2, 1, 1, 1, 1]","[]","[]",18,0,18,1
1879,"['normalidad', 'reabertura', 'rotina', 'situacao', 'transmissao']","[1, 1, 1, 1, 1]","[]","[]",5,0,5,1
1881,"['domingo', 'vespera']","[1, 1]","['espalhar']","[1]",2,1,3,1
1882,"['decisao', 'flavio', 'folhar', 'integro', 'justicar', 'ministrar', 'saudar']","[1, 1, 1, 1, 1, 1, 1]","[]","[]",7,0,7,1
1883,"['arthur', 'aurelio', 'aurelio', 'entendimento', 'estimular', 'inicialment', 'lira', 'magistrado', 'mello', 'ministrar', 'ministrar', 'ppal', 'pslrj', 'relaxamento', 'silveiro', 'silveiro', 'silveiro', 'supremo', 'supremo', 'supremo', 'supremo']","[1, 2, 2, 1, 1, 1, 1, 1, 1, 2, 2, 1, 1, 1, 3, 3, 3, 4, 4, 4, 4]","[]","[]",21,0,21,1
1884,"['manutencao', 'plenario', 'pslrj', 'revogar', 'sessao', 'silveiro', 'silveiro', 'silveiro', 'supremo']","[1, 1, 1, 1, 1, 3, 3, 3, 1]","[]","[]",9,0,9,1
1886,"['absoluto', 'boletim', 'domingo', 'quedo', 'regiao', 'restritivo', 'saudar', 'tendencia']","[1, 1, 1, 1, 1, 1, 1, 1]","['implantar']","[1]",8,1,9,1
1887,"['acompanhamento', 'bolsonarista', 'comissao', 'desigualdad', 'dialogo', 'entregu', 'externo', 'ministrar', 'ministrar', 'ministrar', 'pastar', 'presenciar', 'reabrir', 'recebido', 'reuniao', 'ribeiro', 'ribeiro', 'sugestao']","[1, 1, 1, 1, 1, 1, 1, 3, 3, 3, 1, 1, 1, 1, 1, 2, 2, 1]","['circular']","[1]",18,1,19,1
1888,"['cerimonia', 'colombio', 'contribuicao', 'desenvolvido', 'estrategico', 'expansao', 'parceria', 'parceria']","[1, 1, 1, 1, 1, 1, 2, 2]","[]","[]",8,0,8,1
1893,"['enfatizar', 'ministrar', 'proposto', 'suspenso']","[1, 1, 1, 1]","[]","[]",4,0,4,1
1895,"['advocaciager', 'anuncio', 'anvisa', 'julgamento', 'julgamento', 'plenario', 'plenario', 'posicionamento', 'pratico', 'rejeitar', 'saudar', 'supremo', 'vigilancia']","[1, 1, 1, 2, 2, 2, 2, 1, 1, 1, 1, 1, 1]","[]","[]",13,0,13,1
1896,"['afetado', 'afp', 'autoridad', 'comportamento', 'condicao', 'domingo', 'epidemiar', 'feriar', 'normalidad', 'observar', 'paralisar', 'planar', 'primeiroministro', 'recuperacao', 'relaxamento']","[1, 1, 1, 1, 1, 1, 1, 1, 1, 1, 1, 1, 1, 1, 1]","[]","[]",15,0,15,1
1897,"['argumentar', 'consorcio', 'contemplar', 'respostar', 'wellington']","[1, 1, 1, 1, 1]","[]","[]",5,0,5,1
1898,"['autonomia', 'contrato', 'distrito', 'federar', 'mantido', 'pacheco', 'pacheco', 'respostar', 'respostar', 'vetar', 'vetar']","[1, 1, 1, 1, 1, 2, 2, 2, 2, 2, 2]","['ganhar', 'ganhar']","[2, 2]",11,2,13,1
1899,"['anvisa', 'anvisa', 'aplicacao', 'aprovacao', 'enfatizar', 'entregu', 'instituto', 'pagamento', 'pagamento', 'pastar', 'saudar', 'saudar', 'temporario']","[2, 2, 1, 1, 1, 1, 1, 2, 2, 1, 2, 2, 1]","['minutar']","[1]",13,1,14,1
1902,"['aliquota', 'cronica', 'divergencia', 'estimular', 'henriqu', 'hipertensao', 'inclusao', 'ministrar', 'nelson', 'orientacao', 'pastar', 'prescricao', 'saudar', 'saudar', 'saudar', 'saudar', 'teich']","[1, 1, 1, 1, 1, 1, 1, 1, 1, 1, 1, 1, 4, 4, 4, 4, 1]","[]","[]",17,0,17,1
1903,"['anvisa', 'anvisa', 'anvisa', 'aprovacao', 'desenvolvido', 'fase', 'instituto', 'lewandowski', 'ministrar', 'rejeitar', 'ricardo', 'sabado', 'sputnik', 'supremo', 'vigilancia']","[3, 3, 3, 1, 1, 1, 1, 1, 1, 1, 1, 1, 1, 1, 1]","[]","[]",15,0,15,1
1904,"['associacao', 'autorizacao', 'sido']","[1, 1, 1]","[]","[]",3,0,3,1
1906,"['concessionario', 'concessionario', 'decorrencia', 'domingo', 'feriar', 'fluxo', 'intenso', 'intenso', 'metropolitano', 'quilometro', 'quilometro', 'regiao', 'trafego']","[2, 2, 1, 1, 1, 1, 2, 2, 1, 2, 2, 1, 1]","[]","[]",13,0,13,1
1907,"['companhia', 'medida', 'passageiro', 'serao', 'tambem']","[1, 1, 1, 1, 1]","['checagem', 'cnh', 'gravacao', 'usuario', 'usuario']","[1, 1, 1, 2, 2]",5,5,10,1
1908,"['ambientar', 'carat', 'comorbidad', 'condicao', 'decisao', 'decisao', 'decisao', 'decisao', 'desenvolvimento', 'expansao', 'justicar', 'justicar', 'magistrado', 'obtido', 'oliveira', 'segredar', 'suportar', 'varar']","[1, 1, 1, 1, 4, 4, 4, 4, 1, 1, 2, 2, 1, 1, 1, 1, 1, 1]","[]","[]",18,0,18,1
1910,"['adiamento', 'agravamento', 'depoimento', 'especializar', 'europeu', 'fronteiro', 'funcao', 'internacao', 'internacao', 'internar', 'internar', 'internar', 'quilometro', 'quilometro', 'temporariament']","[1, 1, 1, 1, 1, 1, 1, 2, 2, 3, 3, 3, 2, 2, 1]","['abusar', 'falsar', 'fraudar', 'imagem', 'manipular']","[1, 1, 1, 1, 1]",15,5,20,1
1911,"['absoluto', 'economia', 'necessario', 'pastar', 'prioridad', 'recurso', 'reuter']","[1, 1, 1, 1, 1, 1, 1]","[]","[]",7,0,7,1
1914,"['gripezinha']","[1]","[]","[]",1,0,1,1
1916,"['augusto', 'depoimento', 'depoimento', 'depoimento', 'destacar', 'estrategia', 'exministro', 'gabinet', 'heleno', 'interferencia', 'investigacao', 'justicar', 'nomeacao', 'palacio', 'palacio', 'planalto', 'planalto', 'republico']","[1, 3, 3, 3, 1, 1, 1, 1, 1, 1, 1, 1, 1, 2, 2, 2, 2, 1]","[]","[]",18,0,18,1
1917,"['agravamento', 'consecutivo', 'crescimento', 'habitant', 'saudar', 'situacao']","[1, 1, 1, 1, 1, 1]","[]","[]",6,0,6,1
1922,"['consecutivo', 'disseminacao', 'intensivo', 'levantamento', 'metropolitano', 'patamar', 'regiao', 'saudar', 'subir']","[1, 1, 1, 1, 1, 1, 1, 1, 1]","[]","[]",9,0,9,1
1924,"['agravamento', 'assistencia', 'destacar', 'enfrentamento', 'estrategia', 'primario', 'primario', 'primario', 'reforcar', 'reforcar', 'saudar', 'saudar', 'saudar', 'saudar', 'saudar']","[1, 1, 1, 1, 1, 3, 3, 3, 2, 2, 5, 5, 5, 5, 5]","['inscricao']","[1]",15,1,16,1
1925,"['afp', 'autoridad', 'comparacao', 'consecutivo', 'diminuicao', 'epidemiar', 'indicador', 'infectar', 'portavoz', 'saudar', 'saudar']","[1, 1, 1, 1, 1, 1, 1, 1, 1, 2, 2]","[]","[]",11,0,11,1
1929,"['ambientar', 'ambientar', 'ambientar', 'ambientar', 'desenvolvimento', 'desmatamento', 'destacar', 'ministrar', 'ministrar', 'necessario', 'positivar', 'privar', 'privar', 'privar', 'privar', 'privar', 'recurso', 'regiao', 'ricardo', 'sall', 'sall']","[4, 4, 4, 4, 1, 1, 1, 2, 2, 1, 1, 5, 5, 5, 5, 5, 1, 1, 1, 2, 2]","[]","[]",21,0,21,1
1931,"['acompanhamento', 'acompanhamento', 'investigacao', 'periodo', 'saudar', 'saudar', 'saudar']","[2, 2, 1, 1, 3, 3, 3]","[]","[]",7,0,7,1
1933,"['internar', 'internar', 'intubacao']","[2, 2, 1]","[]","[]",3,0,3,1
1937,"['algun', 'aumento', 'periodo', 'quatro', 'rotina']","[1, 1, 1, 1, 1]","[]","[]",5,0,5,1
1938,"['cenario', 'constituicao', 'destacar', 'internar', 'mudanca']","[1, 1, 1, 1, 1]","[]","[]",5,0,5,1
1940,"['coordenar', 'decisao', 'iniciativo', 'mantido', 'opcao', 'opcao', 'pratico', 'saudar', 'suspensao', 'suspensao', 'taxar', 'temporario', 'vetar']","[1, 1, 1, 1, 2, 2, 1, 1, 2, 2, 1, 1, 1]","[]","[]",13,0,13,1
1943,"[]","[]","['verificar']","[1]",0,1,1,1
1944,"['conflito', 'saudar', 'sigla', 'submetido']","[1, 1, 1, 1]","[]","[]",4,0,4,1
1945,"['administrativo', 'funcao', 'gabinet', 'gabinet', 'kassio', 'mendonca', 'ministrar', 'mudanca', 'nogueira', 'servidor', 'supremo']","[1, 1, 2, 2, 1, 1, 1, 1, 1, 1, 1]","['ganhar']","[1]",11,1,12,1
1950,"['assistencia', 'permanencia', 'prever', 'proposto', 'recurso', 'recurso', 'sancao', 'situacao']","[1, 1, 1, 1, 2, 2, 1, 1]","[]","[]",8,0,8,1
1952,"['colaboracao', 'condicao', 'diagnosticar', 'epidemiologico', 'molecular', 'molecular', 'observar', 'situacao']","[1, 1, 1, 1, 2, 2, 1, 1]","[]","[]",8,0,8,1
1953,"['complicacao', 'internar', 'internar', 'medeiro', 'observacao']","[1, 2, 2, 1, 1]","[]","[]",5,0,5,1
1955,"['decisao', 'legislativo', 'necessario', 'plenario', 'plenario', 'reuniao', 'sessao']","[1, 1, 1, 2, 2, 1, 1]","[]","[]",7,0,7,1
1956,"['domingo', 'economia', 'nelson', 'pratico', 'proposto']","[1, 1, 1, 1, 1]","[]","[]",5,0,5,1
1960,"['condicao', 'recuperacao', 'saudar']","[1, 1, 1]","[]","[]",3,0,3,1
1961,"['adotada', 'afetado', 'autoridad', 'balancar', 'companhia', 'companhia', 'decisao', 'domingo', 'epidemiar', 'europeu', 'periodo', 'saudar', 'suspensao', 'voo']","[1, 1, 1, 1, 2, 2, 1, 1, 1, 1, 1, 1, 1, 1]","[]","[]",14,0,14,1
1962,"['atendido', 'companhia', 'decisao', 'decisao', 'disseminacao', 'distrito', 'distrito', 'especifico', 'etapa', 'etapa', 'flexibilizacao', 'justicar', 'observar', 'pratico', 'previsto', 'reabrir', 'reabrir', 'rocha', 'sugestao', 'varar']","[1, 1, 2, 2, 1, 2, 2, 1, 2, 2, 1, 1, 1, 1, 1, 2, 2, 1, 1, 1]","['cbn']","[1]",20,1,21,1
1963,"['planar', 'prioridad']","[1, 1]","[]","[]",2,0,2,1
1965,"['decisao', 'decisao', 'decisao', 'decisao', 'funcionamento', 'justicar', 'prtb', 'recurso', 'suspenso', 'varar']","[4, 4, 4, 4, 1, 1, 1, 1, 1, 1]","[]","[]",10,0,10,1
1967,"['celebrar', 'cenario', 'cenario', 'companhia', 'crescimento', 'crescimento', 'desigualdad', 'desigualdad', 'economia', 'economia', 'perspectivo', 'perspectivo', 'prioridad', 'reducao', 'respostar']","[1, 2, 2, 1, 2, 2, 2, 2, 2, 2, 2, 2, 1, 1, 1]","['espalhar', 'ganhar', 'imenso']","[1, 1, 1]",15,3,18,1
1968,"['conjuntar', 'extensao', 'fase', 'piorar', 'planar', 'possibilidad', 'prazo', 'proposto', 'relaxar', 'restritivo', 'saudar', 'sugestao']","[1, 1, 1, 1, 1, 1, 1, 1, 1, 1, 1, 1]","[]","[]",12,0,12,1
1969,"['alvorar', 'integro', 'palacio']","[1, 1, 1]","['amigar']","[1]",3,1,4,1
1970,"['conjuntar', 'crise', 'desenvolvido', 'destinar', 'entregu', 'equivalent', 'fabricacao', 'fabricacao', 'parceria']","[1, 1, 1, 1, 1, 1, 2, 2, 1]","[]","[]",9,0,9,1
1971,"['equipamento', 'folhar', 'funcionamento', 'gorinchteyn', 'integro', 'internacao', 'internacao', 'manutencao', 'prazo', 'prever', 'saudar', 'saudar', 'saudar', 'supremo']","[1, 1, 1, 1, 1, 2, 2, 1, 1, 1, 3, 3, 3, 1]","[]","[]",14,0,14,1
1972,"['autoridad', 'autoridad', 'autoridad', 'autoridad', 'epidemiar', 'turista', 'turista', 'turista', 'turistico']","[4, 4, 4, 4, 1, 3, 3, 3, 1]","['cristao']","[1]",9,1,10,1
1973,"['ambito', 'constituicao', 'deflagrar', 'exgovernador', 'forcatarefa', 'instaurar', 'instaurar', 'investigacao', 'justicar', 'justicar', 'lavagem', 'lavagem', 'lavagem', 'recebido', 'recebido', 'supremo', 'tramitacao', 'varar']","[1, 1, 1, 1, 1, 2, 2, 1, 2, 2, 3, 3, 3, 2, 2, 1, 1, 1]","[]","[]",18,0,18,1
1974,"['afetado', 'diagnosticar', 'diagnosticar', 'gabinet', 'gabinet', 'palacio', 'planalto', 'respostar', 'secretariager', 'secretariager', 'servidor']","[1, 2, 2, 2, 2, 1, 1, 1, 2, 2, 1]","[]","[]",11,0,11,1
1977,"[]","[]","['abencoar', 'circular', 'verdadeiro']","[1, 1, 1]",0,3,3,1
1979,"['absoluto', 'ambientar', 'argumentar', 'autonomia', 'competicao', 'constituicao', 'constituicao', 'enquadrar', 'funcionamento', 'fundamentar', 'justicar', 'organizador', 'previsto', 'proposto', 'proposto', 'regrar']","[1, 1, 1, 1, 1, 2, 2, 1, 1, 1, 1, 1, 1, 2, 2, 1]","['patrocinador']","[1]",16,1,17,1
1981,"['calendario', 'correspondent', 'oferecido', 'publicoalvo', 'rotina', 'saudar', 'situacao']","[1, 1, 1, 1, 1, 1, 1]","[]","[]",7,0,7,1
1982,"['algun', 'apoio', 'autoridad', 'autoridad', 'ideologico', 'periferia', 'reuniao']","[1, 1, 2, 2, 1, 1, 1]","[]","[]",7,0,7,1
1987,"['anvisa', 'destinar', 'escalar', 'fundacao', 'inclusao', 'integro', 'realizacao', 'saudar', 'vigilancia']","[1, 1, 1, 1, 1, 1, 1, 1, 1]","[]","[]",9,0,9,1
1991,"['celebrar', 'contrato', 'contrato', 'contrato', 'destinar', 'intubacao', 'irregularidad', 'montant', 'necessidad', 'notificar', 'processo', 'saudar', 'saudar', 'servidor']","[1, 3, 3, 3, 1, 1, 1, 1, 1, 1, 1, 2, 2, 1]","[]","[]",14,0,14,1
1993,"['absoluto', 'absoluto', 'acumular', 'especialment', 'monitoramento', 'surtir']","[2, 2, 1, 1, 1, 1]","['espalhar']","[1]",6,1,7,1
1994,"['almeida', 'almeida', 'cilindro', 'globonew', 'intubacao', 'saudar', 'saudar', 'situacao']","[2, 2, 1, 1, 1, 2, 2, 1]","[]","[]",8,0,8,1
1998,"['alvorar', 'alvorar', 'compromisso', 'decisao', 'distrito', 'domingo', 'domingo', 'palacio', 'republico']","[2, 2, 1, 1, 1, 2, 2, 1, 1]","['abencoar', 'estampar']","[1, 1]",9,2,11,1
2000,"['atuacao', 'autonomia', 'autonomia', 'autonomia', 'autonomia', 'avancar', 'defendido', 'demrj', 'importancia', 'prazo', 'presidir', 'proposto', 'tributario', 'tributario', 'tributario']","[1, 4, 4, 4, 4, 1, 1, 1, 1, 1, 1, 1, 3, 3, 3]","['bandeiro']","[1]",15,1,16,1
2001,"['anuncio', 'autoridad', 'cepa', 'colunista']","[1, 1, 1, 1]","[]","[]",4,0,4,1
2003,"['condenacao', 'converso', 'decisao', 'decisao', 'deltan', 'edson', 'exjuiz', 'fachin', 'forcatarefa', 'ministrar', 'ministrar', 'processo', 'supremo']","[1, 1, 2, 2, 1, 1, 1, 1, 1, 2, 2, 1, 1]","['crer', 'narrativo']","[1, 1]",13,2,15,1
2004,"['atendido', 'esquema', 'estrategia', 'instituto', 'observar', 'orientacao', 'prioritario', 'reuniao', 'revisar', 'saudar', 'saudar', 'vigilancia']","[1, 1, 1, 1, 1, 1, 1, 1, 1, 2, 2, 1]","[]","[]",12,0,12,1
2006,"['adversario', 'alternativo', 'associacao', 'ausencia', 'bastidor', 'cenario', 'cenario', 'cenario', 'crise', 'magistrado', 'magistrado', 'magistrado', 'perspectivo', 'possibilidad', 'possibilidad', 'prever', 'processo', 'prorrogar', 'prorrogar', 'renata']","[1, 1, 1, 1, 1, 3, 3, 3, 1, 3, 3, 3, 1, 2, 2, 1, 1, 2, 2, 1]","[]","[]",20,0,20,1
2007,"['cenario', 'cenario', 'consolidar', 'impactar', 'internar', 'necessidad', 'normalment', 'planar', 'possibilidad', 'superar']","[2, 2, 1, 1, 1, 1, 1, 1, 1, 1]","[]","[]",10,0,10,1
2008,"['agravamento', 'anuncio', 'assintomatico', 'bandeirant', 'concedido', 'diagnosticar', 'palacio', 'periodo', 'recebido', 'situacao', 'testagem', 'videoconferencia']","[1, 1, 1, 1, 1, 1, 1, 1, 1, 1, 1, 1]","[]","[]",12,0,12,1
2009,"['adicionar', 'comissao', 'conjuntar', 'domingo', 'europeu', 'europeu', 'possibilidad', 'previsto', 'taxar']","[1, 1, 1, 1, 2, 2, 1, 1, 1]","['espalhar']","[1]",9,1,10,1
2012,"['ambientar', 'atuacao']","[1, 1]","[]","[]",2,0,2,1
2014,"['biliao', 'consequencia', 'crise', 'economia', 'epidemiar', 'equivalent', 'ministrar', 'ministrar', 'oferecido', 'pagamento', 'previsto', 'primeiroministro', 'provisorio', 'recuperacao', 'turistico']","[1, 1, 1, 1, 1, 1, 2, 2, 1, 1, 1, 1, 1, 1, 1]","[]","[]",15,0,15,1
2015,"['folhar', 'integro', 'proposto']","[1, 1, 1]","[]","[]",3,0,3,1
2019,"['boletim', 'dificuldad', 'elaborar', 'enfrentamento', 'negativar', 'positivar', 'positivar', 'positivar', 'positivar', 'possibilidad', 'quarentenar', 'recuperacao', 'renata', 'rotina', 'saudar', 'saudar', 'saudar', 'saudar', 'sugestao']","[1, 1, 1, 1, 1, 4, 4, 4, 4, 1, 1, 1, 1, 1, 4, 4, 4, 4, 1]","[]","[]",19,0,19,1
2020,"['circulacao', 'companhia', 'possibilidad', 'sociai', 'tambem', 'transmissao', 'voo']","[1, 1, 1, 1, 1, 1, 1]","[]","[]",7,0,7,1
2021,"['competicao', 'competicao', 'decisao', 'decorrencia', 'etapa', 'etapa', 'interrupcao', 'situacao', 'vetar']","[2, 2, 1, 1, 2, 2, 1, 1, 1]","[]","[]",9,0,9,1
2023,"['biliao', 'conjuntar', 'folhar', 'primario', 'sabatino', 'sabatino', 'spaulo']","[1, 1, 1, 1, 2, 2, 1]","['checar', 'lupa', 'rompimento']","[1, 1, 1]",7,3,10,1
2030,"['afetado', 'autoridad', 'confirmado', 'contabiliza', 'deslocamento', 'domingo', 'epidemia', 'medida', 'prazo', 'primeiroministro', 'propagacao', 'sabado', 'serao', 'tambem', 'viajant']","[1, 1, 1, 1, 1, 1, 1, 1, 1, 1, 1, 1, 1, 1, 1]","['verificar']","[1]",15,1,16,1
2031,"['crise', 'decorrencia', 'infectar', 'levantamento', 'transmissao']","[1, 1, 1, 1, 1]","['compartilhar']","[1]",5,1,6,1
2033,"['associacao', 'associacao', 'autorizacao', 'concorrent', 'constituicao', 'crise', 'decisao', 'decisao', 'decisao', 'definitivo', 'exercicio', 'folhar', 'funcionamento', 'fux', 'fux', 'fux', 'fux', 'julgamento', 'jurista', 'kassio', 'kassio', 'kassio', 'lewandowski', 'lewandowski', 'ministrar', 'ministrar', 'realizacao', 'ricardo', 'supremo', 'supremo', 'supremo', 'supremo', 'unanimidad']","[2, 2, 1, 1, 1, 1, 3, 3, 3, 1, 1, 1, 1, 4, 4, 4, 4, 1, 1, 3, 3, 3, 2, 2, 2, 2, 1, 1, 4, 4, 4, 4, 1]","[]","[]",33,0,33,1
2035,"['externo']","[1]","[]","[]",1,0,1,1
2039,"['biliao', 'decisao', 'decisao', 'decisao', 'destinar', 'funcionamento', 'interferencia', 'justicar', 'justicar', 'recurso', 'recurso', 'regiao']","[1, 3, 3, 3, 1, 1, 1, 2, 2, 2, 2, 1]","[]","[]",12,0,12,1
2041,"['agravamento', 'calheiro', 'calheiro', 'calheiro', 'condicao', 'corpu', 'depoimento', 'depoimento', 'depoimento', 'exministro', 'habea', 'investigacao', 'mdbal', 'respostar', 'respostar', 'respostar', 'saudar']","[1, 3, 3, 3, 1, 1, 3, 3, 3, 1, 1, 1, 1, 3, 3, 3, 1]","[]","[]",17,0,17,1
2042,"['avancar', 'avancar', 'esforco', 'impactar', 'letalidad', 'minimizar', 'minimizar', 'necessario', 'saudar', 'taxar', 'taxar', 'taxar', 'transmissao', 'transmissao']","[2, 2, 1, 1, 1, 2, 2, 1, 1, 3, 3, 3, 2, 2]","[]","[]",14,0,14,1
2049,"['diagnosticar', 'excecao', 'infraestrutura', 'machadar', 'machadar', 'ministrar', 'positivar', 'transmissao', 'transmissao']","[1, 1, 1, 2, 2, 1, 1, 2, 2]","[]","[]",9,0,9,1
2050,"['intubacao', 'ministrar', 'ministrar', 'pastar', 'saudar', 'saudar']","[1, 2, 2, 1, 2, 2]","[]","[]",6,0,6,1
2051,"['goncalv', 'impactar', 'mudanca', 'mudanca', 'temporada']","[1, 1, 2, 2, 1]","[]","[]",5,0,5,1
2052,"['adesao', 'adesao', 'ambientar', 'ambito', 'comportamento', 'desenvolvido', 'desenvolvimento', 'fundamentar', 'monitoramento', 'obesidad', 'prazo', 'primario', 'prorrogar', 'recurso', 'reforcar', 'saudar', 'saudar', 'saudar', 'saudar', 'saudar', 'saudar', 'saudar', 'situacao']","[2, 2, 1, 1, 1, 1, 1, 1, 1, 1, 1, 1, 1, 1, 1, 7, 7, 7, 7, 7, 7, 7, 1]","[]","[]",23,0,23,1
2053,"['aprovacao', 'articulacao', 'crise', 'demrj', 'enfrentamento', 'legislativo', 'prioritario', 'proposto', 'proposto', 'recuperacao']","[1, 1, 1, 1, 1, 1, 1, 2, 2, 1]","[]","[]",10,0,10,1
2054,"['atrair', 'pratico', 'republico']","[1, 1, 1]","[]","[]",3,0,3,1
2060,"['arrecadar', 'converso', 'delacao', 'despesa', 'esquema', 'interlocutor', 'justicar', 'mprj', 'mprj', 'obtido', 'precandidato', 'recurso']","[1, 1, 1, 1, 1, 1, 1, 2, 2, 1, 1, 1]","[]","[]",12,0,12,1
2061,"['ansiedad', 'exportacao', 'fabricacao', 'ministrar', 'reuter', 'reuter']","[1, 1, 1, 1, 2, 2]","[]","[]",6,0,6,1
2062,"['consolidar', 'consorcio', 'curvo', 'estabilidad', 'levantamento', 'quedo', 'quedo', 'saudar', 'situacao', 'tendencia', 'variacao', 'variacao']","[1, 1, 1, 1, 1, 2, 2, 1, 1, 1, 2, 2]","[]","[]",12,0,12,1
2064,"['ambito', 'condenacao', 'decisao', 'edson', 'esperancar', 'esperancar', 'fachin', 'ministrar', 'plenario', 'supremo', 'varar']","[1, 1, 1, 1, 2, 2, 1, 1, 1, 1, 1]","[]","[]",11,0,11,1
2065,"['atuam', 'colegiado', 'colegiado', 'elaborar', 'oficio', 'palacio', 'planalto', 'planar', 'planar', 'presidir', 'proposto', 'servidor', 'servidor', 'situacao']","[1, 2, 2, 1, 1, 1, 1, 2, 2, 1, 1, 2, 2, 1]","[]","[]",14,0,14,1
2066,"['acordo', 'algun', 'apoio', 'atuacao', 'congresso', 'conselho', 'cooperacao', 'embora', 'entregu', 'forcatarefa', 'forcatarefa', 'lavagem', 'parceria', 'presenca', 'tambem']","[1, 1, 1, 1, 1, 1, 1, 1, 1, 2, 2, 1, 1, 1, 1]","['realment']","[1]",15,1,16,1
2070,"['contagioso', 'economia', 'economia', 'economia', 'florido', 'pagamento', 'propagacao', 'reabrir', 'reabrir', 'sabado', 'taxar', 'viagem']","[1, 3, 3, 3, 1, 1, 1, 2, 2, 1, 1, 1]","[]","[]",12,0,12,1
2071,"['argumentar', 'argumentar', 'decisao', 'disseminacao', 'edson', 'edson', 'escalar', 'fachin', 'fachin', 'fachin', 'fachin', 'inquerito', 'inquerito', 'inquerito', 'inquerito', 'instaurar', 'instaurar', 'investigacao', 'investigacao', 'investigacao', 'julgamento', 'julgamento', 'mandatario', 'manutencao', 'ministrar', 'ministrar', 'ministrar', 'oficio', 'plenario', 'republico', 'servidor', 'supremo', 'supremo', 'suspeito', 'suspenso', 'sustentabilidad']","[2, 2, 1, 1, 2, 2, 1, 4, 4, 4, 4, 4, 4, 4, 4, 2, 2, 3, 3, 3, 2, 2, 1, 1, 3, 3, 3, 1, 1, 1, 1, 2, 2, 1, 1, 1]","['falsar']","[1]",36,1,37,1
2078,"['edson', 'edson', 'funcao', 'henriqu', 'interino', 'ministrar', 'nelson', 'pastar', 'saudar', 'saudar', 'saudar', 'teich']","[2, 2, 1, 1, 1, 1, 1, 1, 3, 3, 3, 1]","[]","[]",12,0,12,1
2080,"['comparacao', 'consolidar', 'consorcio', 'levantamento', 'saudar', 'situacao', 'tendencia', 'tendencia', 'variacao', 'variacao']","[1, 1, 1, 1, 1, 1, 2, 2, 2, 2]","[]","[]",10,0,10,1
2086,"['acompanhamento', 'capitar', 'contrato', 'desempenhar', 'emergenciai', 'emergenciai', 'individuar', 'inedito', 'integro', 'levantamento', 'roraima']","[1, 1, 1, 1, 2, 2, 1, 1, 1, 1, 1]","['espalhar']","[1]",11,1,12,1
2087,"['contagioso', 'crise', 'diagnosticar', 'domingo', 'dosar', 'epicentro', 'estimular', 'regiao', 'saudar']","[1, 1, 1, 1, 1, 1, 1, 1, 1]","['filmar']","[1]",9,1,10,1
2088,"['colegiado', 'colegiado', 'decisao', 'gabinet', 'integro', 'legislativo', 'periodo', 'plenario', 'plenario', 'punicao', 'punicao', 'souza', 'sugestao', 'suspensao', 'wellington']","[2, 2, 1, 1, 1, 1, 1, 2, 2, 2, 2, 1, 1, 1, 1]","[]","[]",15,0,15,1
2092,"['araujo', 'araujo', 'concreto', 'depoimento', 'dificuldad', 'enfrentamento', 'justificativo', 'ministrar', 'queiroga', 'saudar']","[2, 2, 1, 1, 1, 1, 1, 1, 1, 1]","['desligar']","[1]",10,1,11,1
2096,"['alvorar', 'apurar', 'arthur', 'atuacao', 'atuacao', 'atuacao', 'comissao', 'constituicao', 'demmg', 'distrito', 'domingo', 'domingo', 'epidemiar', 'epidemiar', 'inquerito', 'instituto', 'lira', 'margem', 'pacheco', 'palacio', 'ppal', 'quedo', 'rejeitar', 'supremo']","[1, 1, 1, 3, 3, 3, 1, 1, 1, 1, 2, 2, 2, 2, 1, 1, 1, 1, 1, 1, 1, 1, 1, 1]","['enganar', 'insinuar', 'mencao']","[1, 1, 1]",24,3,27,1
2097,"['boletim', 'conjuntar', 'domingo', 'equipamento', 'monitoramento', 'saudar', 'saudar', 'saudar']","[1, 1, 1, 1, 1, 3, 3, 3]","['assaltar', 'invadir']","[1, 1]",8,2,10,1
2098,"['afetado', 'decorrencia', 'infectar', 'intervalar', 'subir']","[1, 1, 1, 1, 1]","[]","[]",5,0,5,1
2099,"['autoridad', 'epicentro', 'hubei', 'infectar', 'infectar', 'provincia', 'regiao', 'surtir', 'transmissao', 'transmissao', 'viajant']","[1, 1, 1, 2, 2, 1, 1, 1, 2, 2, 1]","['motorista']","[1]",11,1,12,1
2100,"['adicionar', 'amplo', 'atendido', 'congresso', 'congresso', 'economia', 'economia', 'negativar', 'pagamento', 'pagamento', 'pagamento', 'parcelar', 'parcelar', 'parcelar', 'parcelar', 'parcelar', 'prorrogacao']","[1, 1, 1, 2, 2, 2, 2, 1, 3, 3, 3, 5, 5, 5, 5, 5, 1]","[]","[]",17,0,17,1
2104,"['aprovacao', 'atuacao', 'decisao', 'desenvolvimento', 'desgastar', 'desgastar', 'legislativo', 'legislativo', 'reajustar', 'suspeito']","[1, 1, 1, 1, 2, 2, 2, 2, 1, 1]","[]","[]",10,0,10,1
2107,"['atuacao', 'crise', 'economia', 'economia', 'economia', 'gued', 'gued', 'ministrar', 'ministrar', 'ministrar', 'ministrar', 'piorar', 'piorar', 'situacao', 'situacao']","[1, 1, 3, 3, 3, 2, 2, 4, 4, 4, 4, 2, 2, 2, 2]","[]","[]",15,0,15,1
2110,"['alteracao', 'contabilizar', 'distrito', 'distrito', 'estatistico', 'ministrar', 'mudanca', 'periodo', 'supremo']","[1, 1, 2, 2, 1, 1, 1, 1, 1]","[]","[]",9,0,9,1
2111,"['atuam', 'autoridad', 'comissao', 'conflito', 'curvo', 'desenvolvimento', 'destinar', 'escalar', 'estimativo', 'estrategia', 'exministro', 'extraordinario', 'federar', 'henriqu', 'henriqu', 'henriqu', 'impactar', 'impulsionar', 'integrant', 'integrant', 'integrant', 'julgamento', 'milho', 'ministrar', 'oliveira', 'oliveira', 'oliveira', 'oliveira', 'paralisar', 'periodo', 'periodo', 'preservar', 'preservar', 'preservar', 'processo', 'punicao', 'punicao', 'quedo', 'recebido', 'recuar', 'recurso', 'regiao', 'sabado', 'sentenca', 'sentenca', 'situacao', 'sudest']","[1, 1, 1, 1, 1, 1, 1, 1, 1, 1, 1, 1, 1, 3, 3, 3, 1, 1, 3, 3, 3, 1, 1, 1, 4, 4, 4, 4, 1, 2, 2, 3, 3, 3, 1, 2, 2, 1, 1, 1, 1, 1, 1, 2, 2, 1, 1]","['anoso', 'atirar', 'atirar', 'atirar', 'bandeiro', 'ideologia', 'pego', 'reivindicar', 'reivindicar', 'vagabundar']","[1, 3, 3, 3, 1, 1, 1, 2, 2, 1]",47,10,57,1
2112,"['ampliacao', 'aprovacao', 'biliao', 'biliao', 'congresso', 'demrj', 'desenvolvimento', 'dificultar', 'economia', 'federar', 'fundeb', 'fundeb', 'impactar', 'impactar', 'manutencao', 'recurso', 'recurso', 'vetar', 'vetar']","[1, 1, 2, 2, 1, 1, 1, 1, 1, 1, 2, 2, 2, 2, 1, 2, 2, 2, 2]","[]","[]",19,0,19,1
2114,"['algun', 'domingo', 'fase', 'instituto', 'levantamento', 'margem', 'resultado', 'risco', 'risco']","[1, 1, 1, 1, 1, 1, 1, 2, 2]","[]","[]",9,0,9,1
2117,"['aglomeracao', 'cenario', 'cenario', 'movimentacao', 'sabado', 'saudad', 'transmissao']","[1, 2, 2, 1, 1, 1, 1]","['gravacao']","[1]",7,1,8,1
2118,"['crise', 'crise', 'domingo', 'emendar', 'henriqu', 'insuficient']","[2, 2, 1, 1, 1, 1]","['intitular']","[1]",6,1,7,1
2120,"['aumento', 'conflito', 'enfrentamento', 'liderar', 'tambem']","[1, 1, 1, 1, 1]","[]","[]",5,0,5,1
2121,"['anvisa', 'anvisa', 'anvisa', 'decisao', 'desembarcar', 'domingo', 'guarulho', 'instituto', 'vigilancia']","[3, 3, 3, 1, 1, 1, 1, 1, 1]","[]","[]",9,0,9,1
2123,"['bancada', 'comissao', 'decisao', 'expressivo', 'integrant', 'ministrar', 'ministrar', 'nomeacao', 'privar', 'ribeiro', 'ribeiro']","[1, 1, 1, 1, 1, 2, 2, 1, 1, 2, 2]","[]","[]",11,0,11,1
2124,"['conduta', 'diariament', 'flavia', 'flavia', 'posicionamento', 'prescricao', 'saudar', 'sorocaba']","[1, 1, 2, 2, 1, 1, 1, 1]","[]","[]",8,0,8,1
2125,"['autoridad', 'comissao', 'europeu', 'europeu', 'investigacao', 'pratico', 'preliminar', 'requerimento']","[1, 1, 2, 2, 1, 1, 1, 1]","['abusar']","[1]",8,1,9,1
2132,"['adesao', 'almeida', 'antecipar', 'domingo', 'folhar', 'impactar', 'integro', 'sindicato']","[1, 1, 1, 1, 1, 1, 1, 1]","['gasolina', 'gasolina']","[2, 2]",8,2,10,1
2133,"['consistencia', 'desafio', 'economia', 'incerteza', 'indicador', 'primeiroministro', 'reuter']","[1, 1, 1, 1, 1, 1, 1]","[]","[]",7,0,7,1
2136,"['antonio', 'entendimento', 'gued', 'julgamento', 'lavagem', 'oliveira', 'processo', 'respectivament', 'sentenca', 'sentenca', 'sido', 'supremo']","[1, 1, 1, 1, 1, 1, 1, 1, 2, 2, 1, 1]","[]","[]",12,0,12,1
2137,"['atrasar', 'biliao', 'biliao', 'biliao', 'desenvolvimento', 'economia', 'economia', 'expectativa', 'possibilidad', 'recurso']","[1, 3, 3, 3, 1, 2, 2, 1, 1, 1]","[]","[]",10,0,10,1
2138,"['aplicacao', 'atuam', 'destinar', 'destinar', 'distrito', 'dosar', 'federativo', 'fundacao', 'igualitario', 'instituto', 'materiaprima', 'oswaldo', 'parcelar', 'recebido', 'remessar', 'saudar', 'saudar', 'saudar', 'vigilancia']","[1, 1, 2, 2, 1, 1, 1, 1, 1, 1, 1, 1, 1, 1, 1, 3, 3, 3, 1]","[]","[]",19,0,19,1
2140,"['alerj', 'anuncio', 'caxia', 'caxia', 'comissao', 'conjunto', 'curvo', 'decisao', 'definitivo', 'duqu', 'epidemiar', 'extraordinario', 'goncalo', 'goncalo', 'legislativo', 'necessidad', 'regiao', 'saudar', 'saudar', 'saudar', 'saudar', 'tendencia']","[1, 1, 2, 2, 1, 1, 1, 1, 1, 1, 1, 1, 2, 2, 1, 1, 1, 4, 4, 4, 4, 1]","[]","[]",22,0,22,1
2143,"['barroso', 'bastidor', 'decisao', 'decisao', 'fase', 'investigacao', 'julgamento', 'possibilidad', 'prazo', 'reabertura', 'reabertura', 'rejeitar', 'republico']","[1, 1, 2, 2, 1, 1, 1, 1, 1, 2, 2, 1, 1]","[]","[]",13,0,13,1
2147,"['autorizacao', 'carat', 'distrito', 'distrito', 'especializar', 'intensivo', 'pulmonar', 'reforcar', 'saudar', 'suportar', 'suportar', 'suspeito', 'temporario', 'trimestr', 'ventilatorio']","[1, 1, 2, 2, 1, 1, 1, 1, 1, 2, 2, 1, 1, 1, 1]","[]","[]",15,0,15,1
2148,"['converso', 'especializar', 'impactar', 'inovacao', 'presenciar', 'reuniao', 'reuniao', 'videoconferencia']","[1, 1, 1, 1, 1, 2, 2, 1]","[]","[]",8,0,8,1
2151,"['alergia', 'aplicacao', 'autoridad', 'congresso', 'conjunto', 'desenvolvimento', 'discussao', 'esforco', 'instituto', 'porqu', 'tambem']","[1, 1, 1, 1, 1, 1, 1, 1, 1, 1, 1]","[]","[]",11,0,11,1
2153,"['antonio', 'decisao', 'decisao', 'delacao', 'delacao', 'delacao', 'edson', 'exministro', 'fachin', 'instituto', 'lewandowski', 'ministrar', 'ricardo', 'supremo', 'turma', 'turma', 'varar']","[1, 2, 2, 3, 3, 3, 1, 1, 1, 1, 1, 1, 1, 1, 2, 2, 1]","[]","[]",17,0,17,1
2154,"['anuncio', 'anuncio', 'anvisa', 'anvisa', 'aplicacao', 'autorizacao', 'planar', 'vigilancia']","[2, 2, 2, 2, 1, 1, 1, 1]","[]","[]",8,0,8,1
2155,"['calculo', 'condicao', 'consorcio', 'despesa', 'jurista', 'montant', 'prever', 'revogar']","[1, 1, 1, 1, 1, 1, 1, 1]","[]","[]",8,0,8,1
2157,"['destacar', 'exportacao', 'exportacao', 'internar']","[1, 2, 2, 1]","[]","[]",4,0,4,1
2158,"[]","[]","[]","[]",0,0,0,1
2159,"['decisao', 'plano', 'prever', 'propagacao', 'regrar', 'surtir', 'viagem']","[1, 1, 1, 1, 1, 1, 1]","['imagem', 'pego']","[1, 1]",7,2,9,1
2163,"['alternativo', 'ambientar', 'cardiologista', 'cirurgico', 'crise', 'henriqu', 'ministrar', 'ministrar', 'presenca', 'preservar', 'propagacao', 'propagacao', 'quarentenar', 'saudar', 'saudar', 'saudar', 'sugestao', 'surto', 'transicao']","[1, 1, 1, 1, 1, 1, 2, 2, 1, 1, 2, 2, 1, 3, 3, 3, 1, 1, 1]","[]","[]",19,0,19,1
2165,"['adulto', 'hospitalizacao', 'impactar', 'instituto', 'preliminar', 'quedo']","[1, 1, 1, 1, 1, 1]","[]","[]",6,0,6,1
2166,"['dificuldad', 'importancia', 'recuperacao']","[1, 1, 1]","[]","[]",3,0,3,1
2167,"['disseminacao', 'inicialment', 'necessidad', 'paralisar', 'reuniao', 'suspensao', 'suspenso']","[1, 1, 1, 1, 1, 1, 1]","[]","[]",7,0,7,1
2169,"['adulto', 'autonomia', 'autorizacao', 'cenario', 'conformar', 'decorrencia', 'demandar', 'distrito', 'enfrentamento', 'necessario', 'pastar', 'recurso', 'reforcar', 'saudar', 'saudar', 'saudar']","[1, 1, 1, 1, 1, 1, 1, 1, 1, 1, 1, 1, 1, 3, 3, 3]","[]","[]",16,0,16,1
2170,"['discussao', 'governista', 'lancamento', 'saudar', 'saudar', 'saudar', 'saudar']","[1, 1, 1, 4, 4, 4, 4]","['cobaia']","[1]",7,1,8,1
2171,"['adulto', 'biliao', 'necessario', 'orientacao', 'parcelar', 'pastar', 'planar', 'prorrogacao', 'prorrogacao', 'prorrogar', 'prorrogar', 'prorrogar', 'saudar', 'saudar', 'saudar', 'saudar', 'taxar']","[1, 1, 1, 1, 1, 1, 1, 2, 2, 3, 3, 3, 4, 4, 4, 4, 1]","[]","[]",17,0,17,1
2174,"['colegiado', 'comissao', 'enfrentamento', 'importancia', 'instalacao', 'motivacao', 'mudanca', 'posturar', 'privar', 'randolf', 'randolf', 'saudar', 'sobretudo']","[1, 1, 1, 1, 1, 1, 1, 1, 1, 2, 2, 1, 1]","[]","[]",13,0,13,1
2176,"['afetado', 'assistencia', 'assistencia', 'balancar', 'boletim', 'cenario', 'comunitario', 'efetividad', 'enfermagem', 'enfermagem', 'epidemiologico', 'internacao', 'saudar', 'saudar', 'saudar', 'saudar', 'saudar', 'saudar']","[1, 2, 2, 1, 1, 1, 1, 1, 2, 2, 1, 1, 6, 6, 6, 6, 6, 6]","[]","[]",18,0,18,1
2177,"['andrew', 'converso', 'implementacao', 'infectar', 'infectar', 'plano', 'plano', 'quarentenar', 'rastreamento', 'rastreamento', 'servidor', 'transmissao']","[1, 1, 1, 2, 2, 2, 2, 1, 2, 2, 1, 1]","[]","[]",12,0,12,1
2180,"['mudanca']","[1]","[]","[]",1,0,1,1
2182,"['milho', 'milho', 'sudest', 'tambem']","[2, 2, 1, 1]","['arvor']","[1]",4,1,5,1
2184,"['anticorpo', 'bbc', 'colleg', 'colleg', 'portavoz']","[1, 1, 2, 2, 1]","['espalhar']","[1]",5,1,6,1
2187,"['inclusao', 'inquerito', 'intensivo', 'investigacao', 'saudar', 'transferir']","[1, 1, 1, 1, 1, 1]","[]","[]",6,0,6,1
2189,"['agravamento', 'decisao', 'domingo', 'kassio', 'ministrar', 'ministrar', 'presenciar', 'realizacao', 'sentenca', 'supremo']","[1, 1, 1, 1, 2, 2, 1, 1, 1, 1]","['enganir', 'padrar']","[1, 1]",10,2,12,1
2190,"['apostar', 'capitar', 'gripezinha', 'rotina']","[1, 1, 1, 1]","['usuario']","[1]",4,1,5,1
2191,"['adhanom', 'autoridad', 'colaboracao', 'crise', 'expressar', 'expressar', 'preocupacao', 'preocupacao', 'prever', 'sabado', 'saudar', 'saudar', 'tedro', 'tedro']","[1, 1, 1, 1, 2, 2, 2, 2, 1, 1, 2, 2, 2, 2]","[]","[]",14,0,14,1
2192,"['constituicao', 'constituicao', 'crise', 'crise', 'demrj', 'ministrar', 'ministrar', 'prazo']","[2, 2, 2, 2, 1, 2, 2, 1]","[]","[]",8,0,8,1
2193,"['arrecadacao', 'atrair', 'domingo', 'folhar', 'integro', 'motivacao', 'oferecido', 'proposto', 'recurso', 'recurso']","[1, 1, 1, 1, 1, 1, 1, 1, 2, 2]","[]","[]",10,0,10,1
2196,"['agravar', 'contabilizar', 'crise', 'escalar', 'fase', 'gripezinha', 'mergulhar', 'planalto', 'planar', 'republico']","[1, 1, 1, 1, 1, 1, 1, 1, 1, 1]","['fingir']","[1]",10,1,11,1
2197,"['academiar', 'ambito', 'condenacao', 'decisao', 'domingo', 'edson', 'exercicio', 'fachin', 'fachin', 'humberto', 'justicar', 'ministrar', 'supremo']","[1, 1, 1, 1, 1, 1, 1, 2, 2, 1, 1, 1, 1]","['legendar']","[1]",13,1,14,1
2203,"['anteontem', 'compromisso', 'epidemiar', 'flexibilizar', 'gorinchteyn', 'gorinchteyn', 'gorinchteyn', 'prever', 'prever', 'saudar']","[1, 1, 1, 1, 3, 3, 3, 2, 2, 1]","['realment']","[1]",10,1,11,1
2204,"['boletim', 'contabilizar', 'crise', 'decorrencia', 'domingo', 'espanha', 'espanha', 'infectar', 'intensivo', 'internacao', 'internar', 'margem', 'preocupacao', 'saudar', 'saudar', 'situacao', 'subir', 'surtir']","[1, 1, 1, 1, 1, 2, 2, 1, 1, 1, 1, 1, 1, 2, 2, 1, 1, 1]","[]","[]",18,0,18,1
2207,"['administrativo', 'afastamento', 'ambientar', 'ambientar', 'ambientar', 'defendido', 'desgastar', 'economia', 'improbidad', 'integrant', 'justicar', 'ministrar', 'ministrar', 'mudanca', 'pastar', 'republico', 'ricardo', 'sall', 'sall', 'situacao', 'substituicao']","[1, 1, 3, 3, 3, 1, 1, 1, 1, 1, 1, 2, 2, 1, 1, 1, 1, 2, 2, 1, 1]","[]","[]",21,0,21,1
2209,"['concedido', 'depoimento', 'depoimento', 'fundacao', 'proprio', 'recebido', 'varga']","[1, 2, 2, 1, 1, 1, 1]","[]","[]",7,0,7,1
2211,"['benjamin', 'conjuntar', 'facilitar', 'primeiroministro', 'quarentenar', 'turista', 'viagem']","[1, 1, 1, 1, 1, 1, 1]","[]","[]",7,0,7,1
2212,"['demandar', 'fundacao', 'lancamento', 'ministrar', 'moderno', 'oswaldo', 'saudar', 'saudar', 'saudar']","[1, 1, 1, 1, 1, 1, 3, 3, 3]","[]","[]",9,0,9,1
2214,"['azevedo', 'conjuntar', 'conjuntar', 'jantar', 'jantar', 'plano', 'plano', 'plano']","[1, 2, 2, 2, 2, 3, 3, 3]","['casamentar']","[1]",8,1,9,1
2215,"['apoio', 'exemplo', 'habitant', 'levantamento', 'quatro', 'sigla']","[1, 1, 1, 1, 1, 1]","['legenda', 'legenda']","[2, 2]",6,2,8,1
2224,"['consenso', 'decisao', 'decisao', 'destinar', 'distrito', 'distrito', 'edson', 'exjuiz', 'fachin', 'guaruja', 'julgamento', 'ministrar', 'plenario', 'plenario', 'processo', 'processo', 'supremo', 'supremo', 'suspeicao', 'triplex', 'turma', 'varar']","[1, 2, 2, 1, 2, 2, 1, 1, 1, 1, 1, 1, 2, 2, 2, 2, 2, 2, 1, 1, 1, 1]","[]","[]",22,0,22,1
2225,"['agravar', 'caxia', 'destinar', 'duqu', 'intensivo', 'internar', 'pastar', 'redondo', 'redondo', 'saudar', 'saudar']","[1, 1, 1, 1, 1, 1, 1, 2, 2, 2, 2]","[]","[]",11,0,11,1
2226,"['aliviar', 'avancar', 'crise', 'esforco', 'estrategia', 'fluxo', 'importancia', 'infraestrutura', 'ministrar', 'ministrar', 'primario', 'reforcar', 'reuniao', 'saudar', 'saudar', 'transferencia', 'viagem', 'voo', 'voo']","[1, 1, 1, 1, 1, 1, 1, 1, 2, 2, 1, 1, 1, 2, 2, 1, 1, 2, 2]","[]","[]",19,0,19,1
2227,"['comissao', 'comissao', 'condicao', 'defendido', 'destacar', 'governista', 'sessao', 'vieira', 'vieira', 'vieira']","[2, 2, 1, 1, 1, 1, 1, 3, 3, 3]","[]","[]",10,0,10,1
2228,"['campino', 'determinacao', 'fase', 'fase', 'fase', 'fase', 'funcionamento', 'planar', 'prever', 'regiao', 'restritivo', 'restritivo']","[1, 1, 4, 4, 4, 4, 1, 1, 1, 1, 2, 2]","[]","[]",12,0,12,1
2232,"['domingo', 'fase', 'fase', 'imunizacao', 'instituto', 'necessario', 'previsto', 'respostar', 'sputnik']","[1, 2, 2, 1, 1, 1, 1, 1, 1]","[]","[]",9,0,9,1
2233,"['adversario', 'afp', 'benjamin', 'definitivo', 'disseminacao', 'legislativo', 'primeiroministro', 'primeiroministro', 'quarentenar', 'saudar']","[1, 1, 1, 1, 1, 1, 2, 2, 1, 1]","[]","[]",10,0,10,1
2236,"['aprovacao', 'diretoria', 'regiao', 'revisar']","[1, 1, 1, 1]","['galaxi']","[1]",4,1,5,1
2238,"['afp', 'aliviar', 'autoridad', 'balancar', 'domingo', 'infectar']","[1, 1, 1, 1, 1, 1]","[]","[]",6,0,6,1
2239,"['afetado', 'confirmado', 'confirmado', 'domingo', 'domingo', 'levantamento', 'medida', 'milho', 'primeiroministro', 'propagacao', 'quatro', 'sabado', 'sabado', 'serao', 'tambem', 'ultimo']","[1, 2, 2, 2, 2, 1, 1, 1, 1, 1, 1, 2, 2, 1, 1, 1]","[]","[]",16,0,16,1
2240,"['azevedo', 'epicentro', 'epicentro', 'epidemiar', 'hubei', 'kong', 'ministrar', 'provincia', 'quarentenar', 'regiao', 'sabado', 'subir', 'surtir', 'surtir']","[1, 2, 2, 1, 1, 1, 1, 1, 1, 1, 1, 1, 2, 2]","[]","[]",14,0,14,1
2241,"['balancar', 'crescimento', 'epicentro', 'epidemiar', 'portavoz', 'possibilidad', 'reuter', 'saudar']","[1, 1, 1, 1, 1, 1, 1, 1]","[]","[]",8,0,8,1
2242,"['ministrar', 'recordar', 'regrar']","[1, 1, 1]","[]","[]",3,0,3,1
2244,"['bancada', 'domingo', 'domingo', 'recebido', 'recuperacao', 'recuperacao']","[1, 2, 2, 1, 2, 2]","[]","[]",6,0,6,1
2245,"['adversario', 'folhar', 'parceria', 'sabatino', 'spaulo', 'transmissao']","[1, 1, 1, 1, 1, 1]","[]","[]",6,0,6,1
2247,"['alcolumbr', 'cenario', 'consenso', 'demap', 'demrj', 'favorito', 'insuficient', 'julgamento', 'possibilidad', 'quadro', 'republico', 'supremo', 'taxar']","[1, 1, 1, 1, 1, 1, 1, 1, 1, 1, 1, 1, 1]","[]","[]",13,0,13,1
2249,"['aliviar', 'intensivo', 'primeiroministro', 'prorrogar', 'reabrir', 'restritivo', 'reuter']","[1, 1, 1, 1, 1, 1, 1]","['parir']","[1]",7,1,8,1
2250,"['conduta', 'folhar', 'integro', 'investigacao', 'investigacao', 'investigacao', 'processo', 'proferir', 'republico', 'universitario']","[1, 1, 1, 3, 3, 3, 1, 1, 1, 1]","[]","[]",10,0,10,1
2251,"['decisao', 'decisao', 'decisao', 'domicilio', 'periodo', 'plenario', 'prazo', 'prazo', 'prever', 'rejeitar', 'rejeitar', 'sessao', 'supremo', 'unanimidad']","[3, 3, 3, 1, 1, 1, 2, 2, 1, 2, 2, 1, 1, 1]","[]","[]",14,0,14,1
2252,"['aprovacao', 'determinacao', 'medida', 'pagamento', 'proposta', 'reforca', 'risco']","[1, 1, 1, 1, 1, 1, 1]","[]","[]",7,0,7,1
2255,"['afetado', 'infectar', 'infectar', 'levantamento', 'mexico', 'superar']","[1, 2, 2, 1, 1, 1]","[]","[]",6,0,6,1
2257,"['condicao', 'conduta', 'funcao', 'pulmonar', 'realizacao', 'recuperacao', 'respiratorio', 'saudar']","[1, 1, 1, 1, 1, 1, 1, 1]","[]","[]",8,0,8,1
2260,"['autorizacao', 'competicao', 'treinamento', 'treinamento', 'treinar']","[1, 1, 2, 2, 1]","[]","[]",5,0,5,1
2262,"['desenvolvido', 'esperancar', 'molecular', 'reportar']","[1, 1, 1, 1]","[]","[]",4,0,4,1
2266,"['crise', 'economia', 'economia', 'estimular', 'estimular', 'infraestrutura', 'liderar', 'planar', 'recuperacao', 'videoconferencia']","[1, 2, 2, 2, 2, 1, 1, 1, 1, 1]","[]","[]",10,0,10,1
2268,"['adulto', 'anticorpo', 'autorizacao', 'conformar', 'decisao', 'desenvolvido', 'europeu', 'europeu', 'preliminar', 'saudar', 'sigla', 'submetido']","[1, 1, 1, 1, 1, 1, 2, 2, 1, 1, 1, 1]","[]","[]",12,0,12,1
2270,"['equipamento', 'fase', 'fase', 'instituto', 'journal', 'obtido', 'presenca', 'profissionai', 'respirador', 'resultado']","[1, 2, 2, 1, 1, 1, 1, 1, 1, 1]","[]","[]",10,0,10,1
2271,"['bandeirant', 'bandeirant', 'desenvolvimento', 'flavio', 'infectar', 'instituto', 'palacio', 'palacio', 'positivar', 'positivar', 'prazo', 'previsao', 'reuniao', 'rossi', 'servidor', 'submetido']","[2, 2, 1, 1, 1, 1, 2, 2, 2, 2, 1, 1, 1, 1, 1, 1]","[]","[]",16,0,16,1
2272,"['administrativo', 'arthur', 'arthur', 'cupula', 'espirito', 'improbidad', 'improbidad', 'improbidad', 'integrant', 'justicar', 'justicar', 'lira', 'lira', 'lira', 'lira', 'lira', 'lira', 'ministrar', 'nogueira', 'presidir', 'presidir', 'processo', 'segredar', 'supremo', 'supremo', 'supremo', 'supremo', 'suspenso', 'tramitar', 'turma']","[1, 2, 2, 1, 1, 3, 3, 3, 1, 2, 2, 6, 6, 6, 6, 6, 6, 1, 1, 2, 2, 1, 1, 4, 4, 4, 4, 1, 1, 1]","['arquivar', 'arquivar', 'supostament']","[2, 2, 1]",30,3,33,1
2275,"['alunar', 'colegio', 'fase', 'suspeito']","[1, 1, 1, 1]","[]","[]",4,0,4,1
2277,"['autoridad', 'instituto', 'instituto', 'recordar', 'saudar', 'sigla', 'vigilancia']","[1, 2, 2, 1, 1, 1, 1]","[]","[]",7,0,7,1
2278,"['almeida', 'apoio', 'bolsonarista', 'conduta', 'fez', 'investigacao', 'lancamento', 'levantamento', 'levantamento', 'porqu', 'prazo']","[1, 1, 1, 1, 1, 1, 1, 2, 2, 1, 1]","[]","[]",11,0,11,1
2279,"['alcolumbr', 'bandeirant', 'congresso', 'demap', 'integro', 'possibilidad', 'republico']","[1, 1, 1, 1, 1, 1, 1]","[]","[]",7,0,7,1
2280,"['globonew', 'internar', 'piorar', 'transferir', 'ventilacao']","[1, 1, 1, 1, 1]","[]","[]",5,0,5,1
2281,"['comportamento', 'fundacao', 'internar', 'materiaprima', 'reconhecimento']","[1, 1, 1, 1, 1]","['circular']","[1]",5,1,6,1
2282,"['quadro']","[1]","['gravacao']","[1]",1,1,2,1
2283,"['administrativo', 'autoridad', 'autoridad', 'cenario', 'desmatamento', 'destacar', 'dialogo', 'legislativo', 'levantamento', 'preocupacao']","[1, 2, 2, 1, 1, 1, 1, 1, 1, 1]","['incendio']","[1]",10,1,11,1
2285,"['acompanhamento', 'diagnosticar', 'fase', 'internar', 'internar', 'significativo', 'significativo']","[1, 1, 1, 2, 2, 2, 2]","['compartilhar', 'estomago']","[1, 1]",7,2,9,1
2287,"['comparacao', 'fase', 'imunizacao', 'instituto', 'minoria', 'montant', 'pagamento', 'plano', 'reforcar', 'saudar']","[1, 1, 1, 1, 1, 1, 1, 1, 1, 1]","['ideologia', 'invadir']","[1, 1]",10,2,12,1
2288,"['desenvolvido', 'fase', 'fundacao', 'imunizacao', 'mantido', 'oferecido', 'oswaldo', 'perspectivo', 'previsao', 'previsto', 'reforcar', 'saudar', 'saudar', 'secretarioexecutivo']","[1, 1, 1, 1, 1, 1, 1, 1, 1, 1, 1, 2, 2, 1]","[]","[]",14,0,14,1
2290,"['airlin', 'anteriorment', 'companhia', 'companhia', 'crise', 'passageiro', 'voo', 'voo', 'voo']","[1, 1, 2, 2, 1, 1, 3, 3, 3]","[]","[]",9,0,9,1
2292,"['companhia', 'conformar', 'contrato', 'contrato', 'decisao', 'fase', 'forcatarefa', 'machadar', 'magistrado', 'magistrado', 'mantido', 'pagamento', 'pratico', 'preventivo', 'processo', 'recurso', 'suspeito', 'varar']","[1, 1, 2, 2, 1, 1, 1, 1, 2, 2, 1, 1, 1, 1, 1, 1, 1, 1]","['fraudar']","[1]",18,1,19,1
2293,"['anuncio', 'circulacao', 'coletivo', 'flavio', 'funcionamento', 'periodo', 'periodo', 'presenciar', 'situacao', 'suspenso']","[1, 1, 1, 1, 1, 2, 2, 1, 1, 1]","[]","[]",10,0,10,1
2296,"['atuacao', 'comissao', 'decisao', 'depoimento', 'discussao', 'extensao', 'inquerito', 'integrant', 'integrant', 'martim', 'palacio', 'paralelo', 'paralelo', 'planalto', 'republicanosrj', 'republico', 'requerimento', 'requerimento', 'reuniao', 'reuniao', 'saudar', 'saudar', 'vieira', 'vieira', 'vieira', 'wajngarten']","[1, 1, 1, 1, 1, 1, 1, 2, 2, 1, 1, 2, 2, 1, 1, 1, 2, 2, 2, 2, 2, 2, 3, 3, 3, 1]","['amplament']","[1]",26,1,27,1
2297,"['atrair', 'crescimento', 'disseminacao', 'palacio', 'proliferacao', 'propagacao', 'surtir', 'toquio', 'toquio', 'toquio']","[1, 1, 1, 1, 1, 1, 1, 3, 3, 3]","[]","[]",10,0,10,1
2298,"['atuam', 'gorinchteyn', 'gorinchteyn', 'gorinchteyn', 'intensivo', 'necessidad', 'prioridad', 'saudar', 'saudar', 'saudar', 'saudar']","[1, 3, 3, 3, 1, 1, 1, 4, 4, 4, 4]","[]","[]",11,0,11,1
2299,"['disseminacao', 'funcionamento', 'funcionamento', 'infectar', 'mergulhar', 'preocupacao']","[1, 2, 2, 1, 1, 1]","['compartilhar', 'interaco', 'usuario']","[1, 1, 1]",6,3,9,1
2301,"['adulto', 'assistencia', 'dificuldad', 'dificuldad', 'distrito', 'distrito', 'enfermagem', 'enfrentamento', 'fronteiro', 'integrant', 'logistico', 'monitoramento', 'periodo', 'quilometro', 'regiao', 'regiao', 'relativo', 'roraima', 'saudar', 'saudar', 'saudar', 'saudar', 'saudar', 'situacao']","[1, 1, 2, 2, 2, 2, 1, 1, 1, 1, 1, 1, 1, 1, 2, 2, 1, 1, 5, 5, 5, 5, 5, 1]","['verificar']","[1]",24,1,25,1
2303,"['bancada', 'bancada', 'bancada', 'exprefeito', 'exprefeito', 'folhar', 'precandidato', 'precandidato', 'precandidato', 'sabado', 'spaulo', 'tatto', 'tatto', 'tatto', 'tatto', 'tatto']","[3, 3, 3, 2, 2, 1, 3, 3, 3, 1, 1, 5, 5, 5, 5, 5]","['atribuir', 'ganhar', 'imagem']","[1, 1, 1]",16,3,19,1
2304,"['anteriorment', 'anticorpo', 'anticorpo', 'anticorpo', 'assintomatico', 'assintomatico', 'assintomatico', 'cepa', 'desenvolvido', 'infeccioso', 'infectar', 'infectar', 'infectar', 'infectar', 'instituto', 'instituto', 'lancamento', 'moderno', 'moderno', 'moderno', 'mutacao', 'mutacao', 'mutacao', 'necessario', 'observar', 'parceria', 'parceria', 'pfizerbiontech', 'pfizerbiontech', 'pfizerbiontech', 'pfizerbiontech', 'pfizerbiontech', 'positivar', 'positivar', 'positivar', 'positivar', 'positivar', 'quadro', 'quadro', 'quadro', 'reducao', 'regiao', 'respostar', 'respostar', 'respostar', 'revisar', 'saudar', 'transmissao', 'transmissao', 'transmissao', 'transmissao']","[1, 3, 3, 3, 3, 3, 3, 1, 1, 1, 4, 4, 4, 4, 2, 2, 1, 3, 3, 3, 3, 3, 3, 1, 1, 2, 2, 5, 5, 5, 5, 5, 5, 5, 5, 5, 5, 3, 3, 3, 1, 1, 3, 3, 3, 1, 1, 4, 4, 4, 4]","['parir', 'realment', 'replicar', 'verificar', 'versao']","[1, 1, 1, 1, 1]",51,5,56,1
2306,"['decisao', 'parceiro', 'queiroz', 'queiroz', 'respostar']","[1, 1, 2, 2, 1]","[]","[]",5,0,5,1
2310,"['agravamento', 'capitar', 'capitar', 'capitar', 'cenario', 'folhar', 'folhar', 'integro', 'intensivo', 'levantamento']","[1, 3, 3, 3, 1, 2, 2, 1, 1, 1]","[]","[]",10,0,10,1
2311,"['aplicacao', 'aplicacao', 'constatar', 'instituto', 'instituto', 'instituto', 'instituto', 'pratico', 'pratico', 'processo', 'recebido', 'reforcar', 'reuniao', 'saudar']","[2, 2, 1, 4, 4, 4, 4, 2, 2, 1, 1, 1, 1, 1]","[]","[]",14,0,14,1
2312,"['amplo', 'ausencia', 'desafiar', 'orientacao', 'patamar', 'piorar', 'presenca', 'regrar', 'risco', 'saudar', 'saudar', 'situacao']","[1, 1, 1, 1, 1, 1, 1, 1, 1, 2, 2, 1]","[]","[]",12,0,12,1
2315,"['alternativo', 'bruto', 'companhia', 'consumidor', 'desenvolvimento', 'estrategia', 'estrategia', 'expansao', 'externo', 'necessidad', 'quarentenar', 'recuperacao', 'recurso', 'unanimidad']","[1, 1, 1, 1, 1, 2, 2, 1, 1, 1, 1, 1, 1, 1]","[]","[]",14,0,14,1
2318,"['algun', 'sido', 'temor', 'temor', 'ultimo']","[1, 1, 2, 2, 1]","['manchet']","[1]",5,1,6,1
2320,"['afp', 'belgica', 'decisao', 'domingo', 'inglaterra', 'primeiroministro', 'primeiroministro', 'sudest', 'suspensao']","[1, 1, 1, 1, 1, 2, 2, 1, 1]","[]","[]",9,0,9,1
2321,"['anvisa', 'anvisa', 'aprovacao', 'converso', 'desenvolvido', 'dificuldad', 'domingo', 'ministrar', 'regulamentar', 'respostar', 'reuter', 'saudar', 'vigilancia']","[2, 2, 1, 1, 1, 1, 1, 1, 1, 1, 1, 1, 1]","[]","[]",13,0,13,1
2322,"['atrasar', 'converso', 'destacar', 'dosar', 'dosar', 'esquema', 'esquema', 'imunizacao', 'imunizacao', 'imunizacao', 'imunizacao', 'intervalar', 'levantamento', 'orientacao', 'prazo', 'prazo', 'prever', 'previsto', 'reuter', 'saudar']","[1, 1, 1, 2, 2, 2, 2, 4, 4, 4, 4, 1, 1, 1, 2, 2, 1, 1, 1, 1]","[]","[]",20,0,20,1
2327,"['calamidad', 'calamidad', 'client', 'client', 'client', 'equipamento', 'equipamento', 'funcionamento', 'orientacao', 'periodo', 'permanencia', 'reabrir', 'realizacao', 'reuniao', 'revogar', 'risco', 'rocha', 'significativo', 'surtir']","[2, 2, 3, 3, 3, 2, 2, 1, 1, 1, 1, 1, 1, 1, 1, 1, 1, 1, 1]","[]","[]",19,0,19,1
2328,"['ampliacao', 'congresso', 'congresso', 'crise', 'crise', 'demrj', 'despesa', 'economia', 'exportacao', 'gued', 'ministrar', 'proposto', 'respirador', 'servidor', 'suspensao', 'viagem']","[1, 2, 2, 2, 2, 1, 1, 1, 1, 1, 1, 1, 1, 1, 1, 1]","['cartaz']","[1]",16,1,17,1
2331,"['autoridad', 'europeu', 'europeu', 'europeu', 'intensivo', 'presidir']","[1, 3, 3, 3, 1, 1]","['protestar', 'quinzena']","[1, 1]",6,2,8,1
2333,"['circulacao', 'conformar', 'consolidar', 'desafiar', 'especialment', 'estatistico', 'estatistico', 'geografia', 'ibg', 'instituto', 'metropolitano', 'prever', 'prever', 'projeco', 'recebido', 'superar', 'suspeito']","[1, 1, 1, 1, 1, 2, 2, 1, 1, 1, 1, 2, 2, 1, 1, 1, 1]","[]","[]",17,0,17,1
2335,"['compilar', 'decorrencia', 'intervalar', 'levantamento', 'mexico', 'oficialment', 'periodo', 'recebido', 'saudar', 'subir', 'taxar']","[1, 1, 1, 1, 1, 1, 1, 1, 1, 1, 1]","[]","[]",11,0,11,1
2337,"['conselho', 'embora', 'esquema', 'recebido', 'recurso']","[1, 1, 1, 1, 1]","[]","[]",5,0,5,1
2339,"['anuncio', 'apoio', 'boletim', 'client', 'client', 'consumidor', 'contabiliza', 'depoimento', 'investigacao', 'respirador', 'suspeito', 'ultimo']","[1, 1, 1, 2, 2, 1, 1, 1, 1, 1, 1, 1]","[]","[]",12,0,12,1
2341,"['acompanhamento', 'acompanhamento', 'confirmado', 'informaco', 'informaco', 'milho', 'milho', 'relacao', 'sendo']","[2, 2, 1, 2, 2, 2, 2, 1, 1]","[]","[]",9,0,9,1
2343,"['acompanhamento', 'balancar', 'balancar', 'contabilizar', 'infectar', 'investigacao', 'montant', 'saudar', 'saudar', 'superar']","[1, 2, 2, 1, 1, 1, 1, 2, 2, 1]","[]","[]",10,0,10,1
2345,"['anvisa', 'calculo', 'campino', 'consorcio', 'diariament', 'enxergar', 'escassez', 'estabilidad', 'estatistico', 'exprefeito', 'folhar', 'inconsistencia', 'infectar', 'iniciativo', 'logistico', 'ministrar', 'notificar', 'notificar', 'plantao', 'quedo', 'recordar', 'recurso', 'saudar', 'saudar', 'spaulo', 'tendencia', 'tendencia', 'totalizar', 'vigilancia']","[1, 1, 1, 1, 1, 1, 1, 1, 1, 1, 1, 1, 1, 1, 1, 1, 2, 2, 1, 1, 1, 1, 2, 2, 1, 2, 2, 1, 1]","[]","[]",29,0,29,1
2346,"['adversario', 'batalhar', 'coletivo', 'decisao', 'domingo', 'elaborar', 'esforco', 'fluminens', 'fluminens', 'infectar', 'intervalar', 'minimizar', 'posicionamento', 'positivar', 'preparacao', 'preservar', 'previo', 'quedo', 'redondo', 'redondo', 'redondo', 'redondo', 'respostar', 'situacao', 'treinar', 'videoconferencia']","[1, 1, 1, 1, 1, 1, 1, 2, 2, 1, 1, 1, 1, 1, 1, 1, 1, 1, 4, 4, 4, 4, 1, 1, 1, 1]","['crer']","[1]",26,1,27,1
2348,"['saudar']","[1]","[]","[]",1,0,1,1
2350,"['crise', 'crise', 'esperancar', 'merkel', 'merkel']","[2, 2, 1, 2, 2]","[]","[]",5,0,5,1
2352,"['assistencia', 'conformar', 'desembarcar', 'dificuldad', 'enfrentamento', 'equipamento', 'equipamento', 'equipamento', 'estrategico', 'infectar', 'pulmonar', 'pulmonar', 'pulmonar', 'pulmonar', 'reforcar', 'respiratorio', 'saudar', 'saudar', 'saudar', 'saudar', 'saudar', 'saudar', 'suportar', 'transmissao', 'velocidad', 'ventilador', 'ventilador', 'ventilador', 'ventilador', 'ventilador', 'ventilador', 'ventilatorio']","[1, 1, 1, 1, 1, 3, 3, 3, 1, 1, 4, 4, 4, 4, 1, 1, 6, 6, 6, 6, 6, 6, 1, 1, 1, 6, 6, 6, 6, 6, 6, 1]","['ganhar']","[1]",32,1,33,1
2353,"['atuam', 'contemplar', 'destinar', 'distrito', 'dosar', 'dosar', 'esquema', 'esquema', 'esquema', 'esquema', 'federativo', 'instituto', 'materiaprima', 'operacionalizacao', 'pastar', 'planar', 'previsao', 'prioritario', 'saudar', 'saudar', 'saudar', 'vigilancia']","[1, 1, 1, 1, 2, 2, 4, 4, 4, 4, 1, 1, 1, 1, 1, 1, 1, 1, 3, 3, 3, 1]","[]","[]",22,0,22,1
2355,"['acompanhamento', 'balancar', 'balancar', 'investigacao', 'saudar', 'saudar']","[1, 2, 2, 1, 2, 2]","[]","[]",6,0,6,1
2356,"['decisao', 'depoimento', 'enquadrar', 'fronteiro', 'investigacao', 'investigacao', 'justicar', 'presenca', 'recurso', 'republico', 'republico', 'respostar', 'suspenso']","[1, 1, 1, 1, 2, 2, 1, 1, 1, 2, 2, 1, 1]","['atribuir', 'curioso']","[1, 1]",13,2,15,1
2364,"['autoridad', 'balancar', 'destacar', 'europeu', 'infectar', 'intensivo', 'saudar', 'saudar', 'saudar', 'situacao', 'taxar']","[1, 1, 1, 1, 1, 1, 3, 3, 3, 1, 1]","[]","[]",11,0,11,1
2366,"['absoluto', 'assintomatico', 'importancia', 'infectar', 'negativar']","[1, 1, 1, 1, 1]","[]","[]",5,0,5,1
2367,"['afetado', 'aplicacao', 'contagioso', 'desenvolvido', 'desenvolvimento', 'inglaterra', 'mutacao', 'mutacao', 'saudar', 'situacao']","[1, 1, 1, 1, 1, 1, 2, 2, 1, 1]","['humanar']","[1]",10,1,11,1
2368,"['alternativo', 'comportamento', 'consumidor', 'presenca', 'remessar', 'volumar']","[1, 1, 1, 1, 1, 1]","['imagem']","[1]",6,1,7,1
2369,"['acompanhamento', 'boletim', 'edson', 'estabilidad', 'intensivo', 'saudar', 'situacao', 'situacao', 'taxar', 'taxar', 'variacao', 'vespera']","[1, 1, 1, 1, 1, 1, 2, 2, 2, 2, 1, 1]","[]","[]",12,0,12,1
2371,"['araujo', 'disseminacao', 'habito', 'moderno', 'moderno', 'periodo', 'quarentenar', 'quarentenar', 'suportar']","[1, 1, 1, 2, 2, 1, 2, 2, 1]","[]","[]",9,0,9,1
2372,"['colunista', 'colunista', 'consorcio', 'domingo', 'especialment', 'etapa', 'fase', 'folhar', 'importancia', 'importancia']","[2, 2, 1, 1, 1, 1, 1, 1, 2, 2]","[]","[]",10,0,10,1
2373,"['aplicacao', 'expectativa', 'gestant', 'publicoalvo', 'saudar']","[1, 1, 1, 1, 1]","[]","[]",5,0,5,1
2374,"['acompanhamento', 'adesao', 'administrativo', 'comissao', 'comissao', 'estrategia', 'etapa', 'facilitar', 'mudanca', 'pagamento', 'parceiro', 'pastar', 'processo', 'saudar', 'saudar', 'saudar']","[1, 1, 1, 2, 2, 1, 1, 1, 1, 1, 1, 1, 1, 3, 3, 3]","['usuario', 'versao', 'versao']","[1, 2, 2]",16,3,19,1
2380,"['comissao', 'congresso', 'desenvolvimento', 'domingo', 'gabinet', 'none', 'none', 'none', 'none', 'proximo', 'rotina', 'sessao']","[1, 1, 1, 1, 1, 4, 4, 4, 4, 1, 1, 1]","[]","[]",12,0,12,1
2381,"['atrasar', 'comissao', 'contrato', 'iniciativo', 'pastar', 'realizacao', 'saudar', 'temporario', 'wajngarten', 'wajngarten', 'wajngarten']","[1, 1, 1, 1, 1, 1, 1, 1, 3, 3, 3]","[]","[]",11,0,11,1
2385,"['regiao', 'ribeiro', 'ribeiro']","[1, 2, 2]","['fotografia']","[1]",3,1,4,1
2386,"['desenvolvido', 'equipamento', 'instituto', 'instituto', 'propagacao', 'proprio', 'sendo']","[1, 1, 2, 2, 1, 1, 1]","['circula', 'misericordia', 'sapato']","[1, 1, 1]",7,3,10,1
2392,"['ambito', 'colegio', 'comissao']","[1, 1, 1]","['sortir']","[1]",3,1,4,1
2393,"['compilar', 'desigualdad', 'deslocamento', 'distrito', 'distrito', 'habitant', 'periferia', 'proporcao', 'regiao', 'suspeito']","[1, 1, 1, 2, 2, 1, 1, 1, 1, 1]","[]","[]",10,0,10,1
2397,"['dosar', 'dosar', 'dosar', 'instituto', 'parceria']","[3, 3, 3, 1, 1]","['catolico']","[1]",5,1,6,1
2400,"['destacar', 'especializar', 'estrategia', 'estrategia', 'expectativa', 'fluxo', 'intensivo', 'permanencia', 'saudar', 'saudar', 'saudar', 'taxar', 'videoconferencia']","[1, 1, 2, 2, 1, 1, 1, 1, 3, 3, 3, 1, 1]","['disseminar']","[1]",13,1,14,1
2401,"['afetado', 'avancar', 'boletim', 'conformar', 'domingo', 'infectar', 'levantamento', 'saudar']","[1, 1, 1, 1, 1, 1, 1, 1]","[]","[]",8,0,8,1
2402,"['avancar', 'decorrencia', 'necessidad', 'recordar', 'recordar', 'restritivo', 'restritivo', 'wellington']","[1, 1, 1, 2, 2, 2, 2, 1]","[]","[]",8,0,8,1
2407,"['colunista', 'domingo', 'ultimo']","[1, 1, 1]","[]","[]",3,0,3,1
2409,"['bruno', 'consorcio', 'consorcio', 'emenda', 'milho', 'possibilidad', 'reunia', 'sancao', 'tambem']","[1, 2, 2, 1, 1, 1, 1, 1, 1]","[]","[]",9,0,9,1
2410,"['administrativo', 'amplo', 'apreensao', 'condicao', 'decisao', 'decisao', 'exjuiz', 'improbidad', 'individuar', 'justicar', 'legislativo', 'republico', 'saudar', 'situacao', 'unanimidad', 'wilson', 'witzel', 'witzel']","[1, 1, 1, 1, 2, 2, 1, 1, 1, 1, 1, 1, 1, 1, 1, 1, 2, 2]","['atribuir']","[1]",18,1,19,1
2411,"['depoimento', 'lesao', 'sabado']","[1, 1, 1]","['agredir', 'captar', 'espancar', 'imagem', 'imagem']","[1, 1, 1, 2, 2]",3,5,8,1
2413,"['conjuntar', 'coordenar', 'especialment', 'especifico', 'funcao', 'infectar', 'infectar', 'instituto', 'mutacao', 'oficialment', 'respostar']","[1, 1, 1, 1, 1, 2, 2, 1, 1, 1, 1]","['circular', 'espalhar']","[1, 1]",11,2,13,1
2418,"['curso', 'curso', 'curso', 'ministrar', 'prorrogar', 'saudar', 'saudar', 'saudar', 'saudar', 'saudar']","[3, 3, 3, 1, 1, 5, 5, 5, 5, 5]","['inscricao', 'inscricao', 'inscricao']","[3, 3, 3]",10,3,13,1
2421,"['afetado', 'afp', 'balancar', 'contabilizar', 'diagnosticar', 'elaborar', 'espanha', 'europeu', 'respectivament']","[1, 1, 1, 1, 1, 1, 1, 1, 1]","[]","[]",9,0,9,1
2423,"['decisao', 'integro', 'revogar']","[1, 1, 1]","[]","[]",3,0,3,1
2424,"['adotada', 'decorrencia', 'possibilidad', 'respirador', 'tucano']","[1, 1, 1, 1, 1]","['cbn', 'quinzena']","[1, 1]",5,2,7,1
2427,"['destinar', 'dificultar', 'domingo', 'facilitar', 'pratico', 'rastreamento']","[1, 1, 1, 1, 1, 1]","['soltar']","[1]",6,1,7,1
2428,"['anuncio', 'bandeirant', 'decisao', 'destac', 'globonew', 'palacio', 'reabertura', 'tucano']","[1, 1, 1, 1, 1, 1, 1, 1]","[]","[]",8,0,8,1
2430,"['absoluto', 'demandar', 'internar', 'portavoz', 'prioridad', 'sputnik', 'superar']","[1, 1, 1, 1, 1, 1, 1]","['realment']","[1]",7,1,8,1
2431,"['aglomeracao', 'autoridad', 'desembarcar', 'escalar', 'justificativo', 'oficialment', 'periodo', 'periodo', 'possibilidad', 'possibilidad', 'propagacao', 'reuter']","[1, 1, 1, 1, 1, 1, 2, 2, 2, 2, 1, 1]","[]","[]",12,0,12,1
2432,"['apurar', 'domingo', 'integro', 'marilia', 'marilia']","[1, 1, 1, 2, 2]","[]","[]",5,0,5,1
2436,"['andrew', 'andrew', 'andrew', 'anuncio', 'autoridad', 'decisao', 'habitant', 'habitant', 'primeiroministro', 'propagacao']","[3, 3, 3, 1, 1, 1, 2, 2, 1, 1]","['fingir']","[1]",10,1,11,1
2437,"['anvisa', 'aurelio', 'aurelio', 'congresso', 'conjuntar', 'mello', 'mello', 'ministrar', 'ministrar', 'ministrar', 'provisorio', 'rejeitar', 'supremo', 'suspenso', 'sustentabilidad', 'vespera', 'vigilancia']","[1, 2, 2, 1, 1, 2, 2, 3, 3, 3, 1, 1, 1, 1, 1, 1, 1]","[]","[]",17,0,17,1
2441,"['anteontem', 'decisao', 'manutencao', 'ministrar', 'pslrj', 'silveiro', 'supremo', 'supremo']","[1, 1, 1, 1, 1, 1, 2, 2]","[]","[]",8,0,8,1
2442,"['decorrencia', 'intensivo', 'internar', 'pastar', 'respiratorio', 'saudar', 'saudar', 'suspeito']","[1, 1, 1, 1, 1, 2, 2, 1]","['menino']","[1]",8,1,9,1
2444,"['apurar', 'assistenci', 'biliao', 'biliao', 'broadcast', 'calculo', 'despesa', 'economia', 'economia', 'economia', 'integrant', 'previsto', 'proposto', 'recurso', 'reducao', 'temporario']","[1, 1, 2, 2, 1, 1, 1, 3, 3, 3, 1, 1, 1, 1, 1, 1]","['abortar', 'circular', 'manchet']","[1, 1, 1]",16,3,19,1
2445,"['boletim', 'motivacao', 'preliminar', 'renata', 'renata', 'renata', 'saudar']","[1, 1, 1, 3, 3, 3, 1]","[]","[]",7,0,7,1
2446,"['batalhar', 'californio', 'circulacao', 'complicacao', 'incerteza', 'internar', 'internar', 'negativar', 'piorar']","[1, 1, 1, 1, 1, 2, 2, 1, 1]","[]","[]",9,0,9,1
2448,"['autoridad', 'epicentro', 'supremo', 'surtir', 'surtir']","[1, 1, 1, 2, 2]","[]","[]",5,0,5,1
2449,"['contabilizar', 'recordar']","[1, 1]","[]","[]",2,0,2,1
2452,"['apostar', 'benjamin']","[1, 1]","[]","[]",2,0,2,1
2453,"['autoridad', 'desmatamento', 'desmatamento', 'economia', 'economia', 'economia', 'fornecimento', 'gued', 'ministrar', 'regiao']","[1, 2, 2, 3, 3, 3, 1, 1, 1, 1]","[]","[]",10,0,10,1
2455,"['destacar', 'destacar', 'fundacao', 'instituto', 'ministrar', 'ministrar', 'ministrar', 'ministrar', 'oswaldo', 'prever', 'queiroga', 'reforcar', 'saudar', 'trimestr']","[2, 2, 1, 1, 4, 4, 4, 4, 1, 1, 1, 1, 1, 1]","[]","[]",14,0,14,1
2456,"['condenacao', 'cooperacao', 'interlocutor', 'pedido', 'pedido', 'pedido', 'processo', 'recuperacao', 'suspeito']","[1, 1, 1, 3, 3, 3, 1, 1, 1]","[]","[]",9,0,9,1
2457,"['aprovacao', 'aprovacao', 'articulacao', 'cnmp', 'cnmp', 'conformar', 'decisao', 'emendar', 'pratico', 'previsto', 'queixar', 'republico', 'sancao', 'suspensao']","[2, 2, 1, 2, 2, 1, 1, 1, 1, 1, 1, 1, 1, 1]","['imagem', 'insinuar']","[1, 1]",14,2,16,1
2459,"['afetado', 'comissao', 'conformar', 'decisao', 'disseminacao', 'domingo', 'especifico', 'ministrar', 'periodo', 'treinamento', 'treino']","[1, 1, 1, 1, 1, 1, 1, 1, 1, 1, 1]","[]","[]",11,0,11,1
2460,"['acordo', 'araujo', 'araujo', 'comissao', 'comprometido', 'comprometido', 'decisao', 'ernesto', 'ernesto', 'ernesto', 'externo', 'itamarati', 'ministrar', 'mudanca', 'nomeacao']","[1, 2, 2, 1, 2, 2, 1, 3, 3, 3, 1, 1, 1, 1, 1]","[]","[]",15,0,15,1
2463,"['fez', 'fez', 'porqu', 'porqu', 'resultado', 'resultado']","[2, 2, 2, 2, 2, 2]","['imagem']","[1]",6,1,7,1
2465,"['anuncio', 'cronica', 'infectar', 'jorg', 'necessidad', 'reuniao', 'saudar', 'souza', 'suspenso']","[1, 1, 1, 1, 1, 1, 1, 1, 1]","[]","[]",9,0,9,1
2467,"['congresso', 'congresso', 'prazo', 'prever', 'provisorio', 'vetar']","[2, 2, 1, 1, 1, 1]","[]","[]",6,0,6,1
2468,"['assintomatico', 'bruno', 'estrategia', 'impacto', 'instituto', 'positivar', 'rastreamento', 'saudar', 'saudar', 'saudar', 'testagem', 'transmissao']","[1, 1, 1, 1, 1, 1, 1, 3, 3, 3, 1, 1]","['circular']","[1]",12,1,13,1
2469,"['diagnosticar', 'fase', 'saudar', 'saudar', 'saudar']","[1, 1, 3, 3, 3]","[]","[]",5,0,5,1
2470,"['atuacao', 'concedido', 'consequencia', 'dificuldad', 'impactar', 'incerteza', 'incerteza', 'situacao', 'treinar']","[1, 1, 1, 1, 1, 2, 2, 1, 1]","['camisa']","[1]",9,1,10,1
2472,"['avancar', 'crise', 'deslocamento', 'escalar', 'prever', 'regrar', 'saudar']","[1, 1, 1, 1, 1, 1, 1]","[]","[]",7,0,7,1
2474,"['enfrentamento', 'gabbardo', 'gabbardo', 'henriqu', 'ministrar', 'ministrar', 'ministrar', 'pastar', 'saudar', 'saudar', 'saudar', 'secretarioexecutivo', 'secretarioexecutivo']","[1, 2, 2, 1, 3, 3, 3, 1, 3, 3, 3, 2, 2]","['circular', 'falsar', 'imagem', 'verdadeiro']","[1, 1, 1, 1]",13,4,17,1
2476,"['anuncio', 'bandeirant', 'escalar', 'escalar', 'instituto', 'palacio', 'tucano']","[1, 1, 2, 2, 1, 1, 1]","[]","[]",7,0,7,1
2477,"['anuncio', 'autoridad', 'converso', 'deslocamento', 'europeu', 'propagacao', 'reabertura', 'regiao', 'regiao', 'turista']","[1, 1, 1, 1, 1, 1, 1, 2, 2, 1]","['solina']","[1]",10,1,11,1
2479,"['destinar', 'saudar']","[1, 1]","['motorista', 'sobrar']","[1, 1]",2,2,4,1
2480,"['anvisa', 'aprovacao', 'biliao', 'congresso', 'despesa', 'destinar', 'estrategia', 'extraordinario', 'extraordinario', 'fase', 'instituto', 'logistico', 'orcamentaria', 'planar', 'planar', 'provisorio', 'recurso', 'republico', 'saudar', 'vigilancia']","[1, 1, 1, 1, 1, 1, 1, 2, 2, 1, 1, 1, 1, 2, 2, 1, 1, 1, 1, 1]","[]","[]",20,0,20,1
2482,"['aglomeracao', 'condicao', 'determinacao', 'estimativo', 'presenciar', 'previo', 'rossi', 'vulneravel', 'vulneravel']","[1, 1, 1, 1, 1, 1, 1, 2, 2]","[]","[]",9,0,9,1
2483,"['converso', 'gued', 'quadro', 'reuniao', 'videoconferencia']","[1, 1, 1, 1, 1]","['desligar']","[1]",5,1,6,1
2484,"['comparacao', 'levantamento', 'quedo', 'quedo', 'recuar', 'taxar', 'taxar', 'taxar', 'taxar', 'tendencia']","[1, 1, 2, 2, 1, 4, 4, 4, 4, 1]","[]","[]",10,0,10,1
2485,"['administrativo', 'administrativo', 'federar', 'federar', 'investigacao', 'oficio', 'oficio', 'republico']","[2, 2, 2, 2, 1, 2, 2, 1]","[]","[]",8,0,8,1
2487,"['consequencia', 'economia', 'economia', 'enfrentamento', 'exministro', 'flexibilizacao', 'funcao', 'gued', 'henriqu', 'ministrar', 'nelson', 'perspectivo', 'saudar', 'teich', 'teich']","[1, 2, 2, 1, 1, 1, 1, 1, 1, 1, 1, 1, 1, 2, 2]","[]","[]",15,0,15,1
2488,"['avancar', 'decorrencia', 'florido', 'florido', 'florido', 'intensivo', 'periodo', 'recordar', 'recordar', 'saudar', 'saudar', 'situacao']","[1, 1, 3, 3, 3, 1, 1, 2, 2, 2, 2, 1]","[]","[]",12,0,12,1
2491,"['complicacao', 'decorrencia', 'dificuldad', 'internar', 'piorar', 'respiratorio', 'saudar', 'saudar', 'suspeito']","[1, 1, 1, 1, 1, 1, 2, 2, 1]","['desgracar']","[1]",9,1,10,1
2492,"['araujo', 'congresso', 'congresso', 'cupula', 'diplomata', 'ernesto', 'ernesto', 'folhar', 'henriqu', 'integro', 'proferir']","[1, 2, 2, 1, 1, 2, 2, 1, 1, 1, 1]","[]","[]",11,0,11,1
2493,"['afetado', 'cenario', 'contabilizar', 'crescimento', 'crise', 'curvo', 'decorrencia', 'decorrencia', 'economia', 'equipamento', 'escassez', 'etapa', 'fase', 'fase', 'henriqu', 'impacto', 'incerteza', 'ministrar', 'orientacao', 'permanencia', 'preocupacao', 'prever', 'prever', 'projecao', 'saudar', 'saudar', 'saudar', 'saudar', 'saudar']","[1, 1, 1, 1, 1, 1, 2, 2, 1, 1, 1, 1, 2, 2, 1, 1, 1, 1, 1, 1, 1, 2, 2, 1, 5, 5, 5, 5, 5]","[]","[]",29,0,29,1
2495,"['consecutivo', 'epidemiologico', 'epidemiologico', 'indicador', 'internacao', 'periodo', 'quedo', 'quedo', 'quedo']","[1, 2, 2, 1, 1, 1, 3, 3, 3]","[]","[]",9,0,9,1
2497,"['estimativo', 'habitant', 'normalment', 'preliminar', 'quarentenar']","[1, 1, 1, 1, 1]","['assinalar', 'idioma']","[1, 1]",5,2,7,1
2498,"['circulacao', 'client', 'consumidor', 'crescimento', 'crise', 'levantamento']","[1, 1, 1, 1, 1, 1]","['ganhar']","[1]",6,1,7,1
2501,"['condicao', 'depoimento', 'europeu', 'justicar']","[1, 1, 1, 1]","['abusar']","[1]",4,1,5,1
2503,"['associacao', 'atuacao', 'desenvolvimento', 'distrito', 'enfermagem', 'enfermagem', 'implementacao', 'processo', 'profissionai', 'profissionai', 'profissionai', 'quatro', 'saneamento', 'saneamento', 'sendo', 'serao', 'serao', 'tambem']","[1, 1, 1, 1, 2, 2, 1, 1, 3, 3, 3, 1, 2, 2, 1, 2, 2, 1]","['inscricao']","[1]",18,1,19,1
2505,"['anticorpo', 'infeccioso', 'instituto', 'portavoz', 'propagacao']","[1, 1, 1, 1, 1]","[]","[]",5,0,5,1
2506,"['cerimonia', 'fundamentar', 'obtido', 'oficio', 'palacio', 'pib', 'planalto', 'possibilidad', 'ramagem', 'ramagem', 'republico', 'requerimento', 'requerimento']","[1, 1, 1, 1, 1, 1, 1, 1, 2, 2, 1, 2, 2]","['humanar']","[1]",13,1,14,1
2507,"['crise', 'crise', 'deflagrar', 'emprestimo', 'estimativo', 'situacao']","[2, 2, 1, 1, 1, 1]","[]","[]",6,0,6,1
2510,"['alteracao', 'circulacao', 'circulacao', 'conformar', 'conjuntar', 'deslocamento', 'divergencia', 'especialment', 'especialment', 'eventualment', 'justicar', 'justicar', 'marilia', 'marilia', 'mudanca', 'possibilidad', 'pratico', 'reflexo', 'regrar', 'saudar', 'situacao', 'varar']","[1, 2, 2, 1, 1, 1, 1, 2, 2, 1, 2, 2, 2, 2, 1, 1, 1, 1, 1, 1, 1, 1]","['compartilhar']","[1]",22,1,23,1
2513,"['adicionar', 'ampliacao', 'autorizacao', 'carat', 'cenario', 'companhia', 'crise', 'decisao', 'deslocamento', 'diretoria', 'enfrentamento', 'individuar', 'iniciativo', 'passageiro', 'passageiro', 'passageiro', 'passageiro', 'preservar', 'previo', 'previsto', 'regrar', 'regulamentar', 'reuniao', 'voo', 'voo', 'voo']","[1, 1, 1, 1, 1, 1, 1, 1, 1, 1, 1, 1, 1, 4, 4, 4, 4, 1, 1, 1, 1, 1, 1, 3, 3, 3]","[]","[]",26,0,26,1
2517,"['associacao', 'avancar', 'barroso', 'barroso', 'desenvolvimento', 'desmatamento', 'desmatamento', 'implementacao', 'iniciativo', 'irregularidad', 'julgamento', 'ministrar', 'parceria', 'periodo', 'privar', 'regiao', 'reuniao', 'supremo']","[1, 1, 2, 2, 1, 2, 2, 1, 1, 1, 1, 1, 1, 1, 1, 1, 1, 1]","['imagem', 'imagem']","[2, 2]",18,2,20,1
2526,"['administrativo', 'cnj', 'cnj', 'fux', 'iniciativo', 'justicar', 'justicar', 'supremo']","[1, 2, 2, 1, 1, 2, 2, 1]","[]","[]",8,0,8,1
2527,"['amplo', 'apurar', 'crise', 'expectativa', 'funcao', 'ideologico', 'itamarati', 'mandatario']","[1, 1, 1, 1, 1, 1, 1, 1]","[]","[]",8,0,8,1
2528,"['californio', 'californio', 'constituicao', 'desafiar', 'domingo', 'emendar', 'instalacao', 'presenciar', 'realizacao']","[2, 2, 1, 1, 1, 1, 1, 1, 1]","[]","[]",9,0,9,1
2529,"['adiamento', 'calendario', 'competicao', 'paralisar', 'paralisar', 'periodo', 'previsto', 'respectivament', 'reuniao', 'temporada']","[1, 1, 1, 2, 2, 1, 1, 1, 1, 1]","[]","[]",10,0,10,1
2531,"[]","[]","[]","[]",0,0,0,1
2532,"['anticorpo', 'autoridad', 'contabilizar', 'contabilizar', 'crise', 'disseminacao', 'disseminacao', 'expressar', 'infectar', 'legislativo', 'levantamento', 'mutacao', 'mutacao', 'particularment', 'preocupacao', 'preocupacao', 'provincia', 'regiao', 'regiao', 'regiao', 'situacao', 'taxar', 'treinar', 'viagem']","[1, 1, 2, 2, 1, 2, 2, 1, 1, 1, 1, 2, 2, 1, 2, 2, 1, 3, 3, 3, 1, 1, 1, 1]","[]","[]",24,0,24,1
2533,"['cenario', 'crise', 'funcionamento', 'henriqu', 'opcao', 'quilometro', 'ricardo', 'tambem']","[1, 1, 1, 1, 1, 1, 1, 1]","['imagem']","[1]",8,1,9,1
2534,"['crise', 'epidemiar', 'notificar', 'saudar', 'saudar', 'suspeito', 'suspeito']","[1, 1, 1, 2, 2, 2, 2]","[]","[]",7,0,7,1
2535,"['confederacao', 'propagacao', 'supremo', 'supremo', 'suspensao']","[1, 1, 2, 2, 1]","[]","[]",5,0,5,1
2538,"['boletim', 'boletim', 'decorrencia', 'espanha', 'mudanca', 'saudar', 'saudar']","[2, 2, 1, 1, 1, 2, 2]","[]","[]",7,0,7,1
2539,"['desenvolvimento', 'economia', 'economia', 'gued', 'gued', 'marinhar', 'marinhar', 'ministrar', 'ministrar', 'negativar', 'presenciar', 'reuniao']","[1, 2, 2, 2, 2, 2, 2, 2, 2, 1, 1, 1]","[]","[]",12,0,12,1
2540,"['adhanom', 'afetado', 'boletim', 'epidemiar', 'perspectivo', 'saudar', 'tedro', 'transmissao']","[1, 1, 1, 1, 1, 1, 1, 1]","['espalhar']","[1]",8,1,9,1
2541,"['calamidad', 'congresso', 'constituicao', 'constituicao', 'demrj', 'despesa', 'economia', 'emendar', 'emendar', 'emergenciai', 'emergenciai', 'enfrentamento', 'gued', 'iniciativo', 'legislativo', 'ministrar', 'paralelo', 'plenario', 'proposto', 'proposto', 'submetido', 'tramitar']","[1, 1, 2, 2, 1, 1, 1, 2, 2, 2, 2, 1, 1, 1, 1, 1, 1, 1, 2, 2, 1, 1]","['minutar']","[1]",22,1,23,1
2542,"['biliao', 'biliao', 'biliao', 'destacar', 'destinar', 'economia', 'paralisar']","[3, 3, 3, 1, 1, 1, 1]","[]","[]",7,0,7,1
2546,"['californio', 'desenvolvido', 'especializar', 'genoma', 'positivar', 'quarentenar', 'transmissao', 'vulnerabilidad']","[1, 1, 1, 1, 1, 1, 1, 1]","['compartilhar']","[1]",8,1,9,1
2547,"['academiar', 'autoridad', 'domingo', 'dosar', 'escalar', 'estagio', 'etapa', 'fase', 'fase', 'fase', 'instituto', 'necessario', 'necessario']","[1, 1, 1, 1, 1, 1, 1, 3, 3, 3, 1, 2, 2]","[]","[]",13,0,13,1
2551,"['aprovacao', 'avancar', 'colaborar', 'comissao', 'concorrent', 'decisao', 'estagio', 'iniciativo', 'levantamento', 'parceria', 'parceria', 'privar', 'privatizacao', 'proposto', 'proposto', 'recurso', 'suspenso', 'suspenso', 'tucano']","[1, 1, 1, 1, 1, 1, 1, 1, 1, 2, 2, 1, 1, 2, 2, 1, 2, 2, 1]","['bandeiro']","[1]",19,1,20,1
2552,"['pastar', 'positivar', 'respiratorio', 'saudar']","[1, 1, 1, 1]","[]","[]",4,0,4,1
2553,"['ambito', 'biliao', 'biliao', 'biliao', 'congresso', 'congresso', 'crise', 'despesa', 'distrito', 'economia', 'montant', 'primario', 'suspenso', 'transferencia']","[1, 3, 3, 3, 2, 2, 1, 1, 1, 1, 1, 1, 1, 1]","[]","[]",14,0,14,1
2554,"['augusto', 'ministrar', 'saudar', 'saudar']","[1, 1, 2, 2]","['inocentar', 'verdadeiro']","[1, 1]",4,2,6,1
2555,"['alteracao', 'atuam', 'comunitario', 'consumidor', 'emendar', 'equipamento', 'fornecimento', 'prioridad', 'prioridad', 'psicologo', 'realizacao', 'risco', 'saudar', 'significativo', 'sobretudo', 'suspeito']","[1, 1, 1, 1, 1, 1, 1, 2, 2, 1, 1, 1, 1, 1, 1, 1]","['inscricao']","[1]",16,1,17,1
2556,"['competicao', 'normalment', 'paralisar', 'proliferacao', 'treinar']","[1, 1, 1, 1, 1]","[]","[]",5,0,5,1
2558,"[]","[]","['adelio', 'adelio', 'adelio', 'adelio', 'assassinar', 'basto', 'bispar', 'bispar', 'circular', 'imagem', 'imagem', 'tampouco', 'verdadeiro']","[4, 4, 4, 4, 1, 1, 2, 2, 1, 2, 2, 1, 1]",0,13,13,1
2561,"['adotada', 'avancar', 'avancar', 'crise', 'crise', 'economia', 'economia', 'emergenciai', 'emergenciai', 'portavoz', 'positivar', 'positivar', 'precedent', 'precedent', 'reabrir', 'reabrir', 'relaxar', 'respostar']","[1, 2, 2, 2, 2, 2, 2, 2, 2, 1, 2, 2, 2, 2, 2, 2, 1, 1]","[]","[]",18,0,18,1
2562,"['calheiro', 'colegiado', 'colegiado', 'comissao', 'comissao', 'comissao', 'conformar', 'entendimento', 'exgovernador', 'exgovernador', 'exministro', 'inquerito', 'integrant', 'integrant', 'mdbal', 'minoria', 'presidir', 'randolf', 'saudar']","[1, 2, 2, 3, 3, 3, 1, 1, 2, 2, 1, 1, 2, 2, 1, 1, 1, 1, 1]","[]","[]",19,0,19,1
2570,"['agravamento', 'apurar', 'associacao', 'decisao', 'decisao', 'jurista', 'kassio', 'magistrado', 'ministrar', 'plenario', 'presenciar', 'supremo']","[1, 1, 1, 2, 2, 1, 1, 1, 1, 1, 1, 1]","[]","[]",12,0,12,1
2572,"['enfatizar', 'ministrar', 'ministrar', 'ministrar', 'ministrar', 'movimentacao', 'plano', 'prioridad', 'saudar', 'saudar', 'situacao', 'treinar']","[1, 4, 4, 4, 4, 1, 1, 1, 2, 2, 1, 1]","[]","[]",12,0,12,1
2576,"['calendario', 'espirito', 'fase', 'flexibilizacao', 'mantido', 'plano', 'reabertura', 'rossi', 'sociai', 'tambem']","[1, 1, 1, 1, 1, 1, 1, 1, 1, 1]","[]","[]",10,0,10,1
2578,"[]","[]","[]","[]",0,0,0,1
2580,"['companhia', 'decisao', 'risco']","[1, 1, 1]","['cartaz', 'espalhar']","[1, 1]",3,2,5,1
2584,"['acumular', 'afp', 'afp', 'antonio', 'balancar', 'esperancar', 'inglaterra']","[1, 2, 2, 1, 1, 1, 1]","[]","[]",7,0,7,1
2585,"['aplicacao', 'coordenar', 'distrito', 'domingo', 'dosar', 'esquema', 'estrategia', 'facilitar', 'fase', 'fundacao', 'igualitario', 'instituto', 'intervalar', 'operacionalizacao', 'oswaldo', 'pastar', 'planar', 'prazo', 'publicoalvo', 'remessar', 'sabado', 'saudar', 'saudar', 'saudar', 'vigilancia']","[1, 1, 1, 1, 1, 1, 1, 1, 1, 1, 1, 1, 1, 1, 1, 1, 1, 1, 1, 1, 1, 3, 3, 3, 1]","[]","[]",25,0,25,1
2587,"['algun', 'medida', 'mudanca', 'periodo']","[1, 1, 1, 1]","[]","[]",4,0,4,1
2588,"['aglomeracao', 'alvorar', 'alvorar', 'domingo', 'palacio', 'planar', 'regiao']","[1, 2, 2, 1, 1, 1, 1]","[]","[]",7,0,7,1
2589,"['comissao', 'comissao', 'comissao', 'comissao', 'henriqu', 'iniciativo', 'inquerito', 'interferencia', 'ministrar', 'ministrar', 'ministrar', 'ministrar', 'notificar', 'posicionamento', 'republico', 'respostar', 'reuniao', 'reuniao', 'supremo']","[4, 4, 4, 4, 1, 1, 1, 1, 4, 4, 4, 4, 1, 1, 1, 1, 2, 2, 1]","[]","[]",19,0,19,1
2590,"['adotada', 'enxerg', 'fluminens', 'imunizacao', 'medida', 'plano', 'porqu', 'prioridad', 'proximo', 'proximo', 'velocidad']","[1, 1, 1, 1, 1, 1, 1, 1, 2, 2, 1]","[]","[]",11,0,11,1
2591,"['absoluto', 'adulto', 'atrasar', 'comissao', 'cooperacao', 'discussao', 'ministrar', 'ministrar', 'ministrar', 'mudanca', 'opcao', 'pastar', 'preconceito', 'presenca', 'reforcar', 'ribeiro', 'supremo']","[1, 1, 1, 1, 1, 1, 3, 3, 3, 1, 1, 1, 1, 1, 1, 1, 1]","['atribuir']","[1]",17,1,18,1
2595,"['apurar', 'biliao', 'companhia', 'congresso', 'contrato', 'desenvolvimento', 'desenvolvimento', 'emendar', 'emendar', 'esquema', 'federar', 'integro', 'investigacao', 'privar', 'republico', 'tcu', 'tcu']","[1, 1, 1, 1, 1, 2, 2, 2, 2, 1, 1, 1, 1, 1, 1, 2, 2]","['secreto']","[1]",17,1,18,1
2597,"['autoridad', 'autoridad', 'bastidor', 'condicao', 'constituicao', 'constituicao', 'constituicao', 'constituicao', 'corpu', 'corpu', 'domingo', 'edson', 'fachin', 'fachin', 'fachin', 'habea', 'habea', 'iniciativo', 'julgamento', 'julgamento', 'ministrar', 'ministrar', 'ministrar', 'ministrar', 'necessidad', 'posturar', 'preservacao', 'republico', 'respostar', 'situacao', 'supremo', 'supremo', 'supremo', 'vespera']","[2, 2, 1, 1, 4, 4, 4, 4, 2, 2, 1, 1, 3, 3, 3, 2, 2, 1, 2, 2, 4, 4, 4, 4, 1, 1, 1, 1, 1, 1, 3, 3, 3, 1]","['atribuir', 'realment']","[1, 1]",34,2,36,1
2600,"['compilar', 'quedo', 'recordar', 'regiao', 'regiao', 'regiao']","[1, 1, 1, 3, 3, 3]","['atribuir', 'incendio']","[1, 1]",6,2,8,1
2601,"['amplo', 'assintomatico', 'ausencia', 'cirurgico', 'consenso', 'contagioso', 'cooperacao', 'coreia', 'desafiar', 'desigualdad', 'despesa', 'enfrentamento', 'epidemiar', 'epidemiar', 'equipamento', 'espanha', 'expressar', 'extensao', 'inedito', 'letalidad', 'periodo', 'precedent', 'prioridad', 'prioridad', 'proporcao', 'reducao', 'respirador', 'saudar', 'saudar', 'suprimento', 'tributario']","[1, 1, 1, 1, 1, 1, 1, 1, 1, 1, 1, 1, 2, 2, 1, 1, 1, 1, 1, 1, 1, 1, 2, 2, 1, 1, 1, 2, 2, 1, 1]","[]","[]",31,0,31,1
2603,"['consecutivo', 'portavoz', 'portavoz', 'positivar', 'saudar']","[1, 2, 2, 1, 1]","[]","[]",5,0,5,1
2606,"['arrecadacao', 'bruto', 'comissao', 'crise', 'desenvolvimento', 'desenvolvimento', 'destacar', 'estabilidad', 'externo', 'inovacao', 'internar', 'ministrar', 'ministrar', 'ministrar', 'necessario', 'necessidad', 'pib', 'recurso', 'recurso', 'recurso', 'recurso']","[1, 1, 1, 1, 2, 2, 1, 1, 1, 1, 1, 3, 3, 3, 1, 1, 1, 4, 4, 4, 4]","[]","[]",21,0,21,1
2609,"['alteracao', 'decisao', 'sido', 'tambem']","[1, 1, 1, 1]","[]","[]",4,0,4,1
2610,"['arrecadacao', 'arrecadacao', 'biliao', 'comparacao', 'crescimento', 'folhar', 'integro', 'recordar']","[2, 2, 1, 1, 1, 1, 1, 1]","[]","[]",8,0,8,1
2612,"['anvisa', 'anvisa', 'anvisa', 'aprovacao', 'autorizacao', 'autorizacao', 'decisao', 'desenvolvido', 'desenvolvimento', 'exigencia', 'facilitar', 'facilitar', 'fase', 'fase', 'inclusao', 'instituto', 'mudanca', 'mudanca', 'mudanca', 'privar', 'regrar', 'sputnik', 'vigilancia']","[3, 3, 3, 1, 2, 2, 1, 1, 1, 1, 2, 2, 2, 2, 1, 1, 3, 3, 3, 1, 1, 1, 1]","[]","[]",23,0,23,1
2614,"['agravamento', 'competicao', 'confederacao', 'confederacao']","[1, 1, 2, 2]","[]","[]",4,0,4,1
2615,"['agravamento', 'consumidor', 'crise', 'epidemiar', 'fluxo', 'infraestrutura', 'infraestrutura', 'ministrar', 'palacio', 'passageiro', 'planalto', 'prazo', 'prazo', 'viagem']","[1, 1, 1, 1, 1, 2, 2, 1, 1, 1, 1, 2, 2, 1]","[]","[]",14,0,14,1
2616,"['quarentenar', 'regiao', 'rotina', 'sessao']","[1, 1, 1, 1]","['compartilhar', 'filmar', 'menino', 'suco']","[1, 1, 1, 1]",4,4,8,1
2617,"['campino', 'cerimonia', 'decorrencia', 'diagnosticar', 'internar', 'periodo', 'presenca']","[1, 1, 1, 1, 1, 1, 1]","[]","[]",7,0,7,1
2618,"['autoridad', 'autoridad', 'autoridad', 'cenario', 'cenario', 'condicao', 'dinamarca', 'epidemiar', 'epidemiar', 'epidemiar', 'fase', 'infeccioso', 'levantamento', 'mantido', 'prazo', 'prazo', 'prever', 'reabertura', 'reabrir', 'realizacao', 'saudar']","[3, 3, 3, 2, 2, 1, 1, 3, 3, 3, 1, 1, 1, 1, 2, 2, 1, 1, 1, 1, 1]","[]","[]",21,0,21,1
2622,"['almeida', 'anvisa', 'ausencia', 'decisao', 'deteccao', 'deteccao', 'distrito', 'especifico', 'exigencia', 'exigencia', 'instituto', 'justicar', 'prever', 'realizacao', 'restritivo', 'revogar', 'saudar', 'saudar', 'varar', 'vigilancia']","[1, 1, 1, 1, 2, 2, 1, 1, 2, 2, 1, 1, 1, 1, 1, 1, 2, 2, 1, 1]","[]","[]",20,0,20,1
2625,"['arthur', 'autonomia', 'autonomia', 'discussao', 'lira', 'ppal', 'prioridad', 'prioridad', 'prioritario', 'reuniao', 'reuniao']","[1, 2, 2, 1, 1, 1, 2, 2, 1, 2, 2]","[]","[]",11,0,11,1
2627,"['capitar', 'dedicar', 'domingo']","[1, 1, 1]","[]","[]",3,0,3,1
2633,"['florido', 'forcatarefa', 'higienizacao', 'inicialment', 'reabertura', 'reabrir', 'regrar', 'rotina', 'visitant']","[1, 1, 1, 1, 1, 1, 1, 1, 1]","[]","[]",9,0,9,1
2634,"['articulacao', 'definitivo', 'discussao', 'distrito', 'enxergar', 'flavia', 'flavia', 'flavia', 'opcao', 'rocha']","[1, 1, 1, 1, 1, 3, 3, 3, 1, 1]","[]","[]",10,0,10,1
2637,"['aplicacao', 'comissao', 'conformar', 'infectar', 'oficio', 'pratico', 'prazo', 'saudar', 'saudar', 'submetido']","[1, 1, 1, 1, 1, 1, 1, 2, 2, 1]","[]","[]",10,0,10,1
2638,"['acompanhamento', 'acompanhamento', 'acumular', 'diagnosticar', 'saudar']","[2, 2, 1, 1, 1]","[]","[]",5,0,5,1
2639,"['anvisa', 'atuacao', 'fase', 'globonew', 'imunizacao', 'opcao', 'prioritario', 'saudar', 'vigilancia']","[1, 1, 1, 1, 1, 1, 1, 1, 1]","[]","[]",9,0,9,1
2641,"['consorcio', 'coordenar', 'desenvolvimento', 'domingo', 'epidemiar', 'fabricacao', 'guarulho', 'igualitario', 'imunizacao', 'imunizacao', 'infancia', 'inovacao', 'obtido', 'panamericana', 'preparacao', 'previsto', 'remessar', 'saudar', 'saudar', 'saudar']","[1, 1, 1, 1, 1, 1, 1, 1, 2, 2, 1, 1, 1, 1, 1, 1, 1, 3, 3, 3]","[]","[]",20,0,20,1
2643,"['acordo', 'amplo', 'anvisa', 'aprovacao', 'aprovacao', 'broadcast', 'broadcast', 'constatar', 'crescimento', 'desafiar', 'desenvolvido', 'desenvolvido', 'destacar', 'fundacao', 'fundacao', 'fundacao', 'imunizacao', 'indicador', 'instituto', 'obtido', 'parcelar', 'parcelar', 'parcelar', 'parcelar', 'parceria', 'periodo', 'periodo', 'periodo', 'periodo', 'periodo', 'periodo', 'rejeitar', 'rejeitar', 'reuniao', 'saudar', 'saudar', 'saudar', 'saudar', 'subir', 'subir', 'subir', 'tendencia', 'vigilancia']","[1, 1, 1, 2, 2, 2, 2, 1, 1, 1, 2, 2, 1, 3, 3, 3, 1, 1, 1, 1, 4, 4, 4, 4, 1, 6, 6, 6, 6, 6, 6, 2, 2, 1, 4, 4, 4, 4, 3, 3, 3, 1, 1]","[]","[]",43,0,43,1
2644,"['aspecto', 'demandar', 'diariament', 'distant', 'especialment', 'especifico', 'gued', 'normalment']","[1, 1, 1, 1, 1, 1, 1, 1]","['pelar', 'pelar', 'pelar', 'pelar', 'pelar']","[5, 5, 5, 5, 5]",8,5,13,1
2645,"['augusto', 'augusto', 'condenacao', 'condenacao', 'fase', 'justicar', 'paralisar', 'reclamacao', 'reclamacao', 'sentenca', 'sentenca']","[2, 2, 2, 2, 1, 1, 1, 2, 2, 2, 2]","[]","[]",11,0,11,1
2647,"['fronteiro', 'levantamento', 'parceria', 'pratico', 'preconceito', 'saudar', 'situacao', 'situacao']","[1, 1, 1, 1, 1, 1, 2, 2]","['abortar', 'abortar', 'abortar', 'abortar', 'estuprar']","[4, 4, 4, 4, 1]",8,5,13,1
2649,"['economia', 'impactar']","[1, 1]","['basto', 'usuario', 'usuario', 'versao', 'versao']","[1, 2, 2, 2, 2]",2,5,7,1
2650,"['julgamento', 'ministrar', 'prazo', 'preventivo', 'supremo']","[1, 1, 1, 1, 1]","['soltura']","[1]",5,1,6,1
2653,"['arrecadacao', 'conformar', 'crise', 'crise', 'monitoramento', 'recordar', 'respostar', 'tendencia']","[1, 1, 2, 2, 1, 1, 1, 1]","['imagem']","[1]",8,1,9,1
2655,"['descumprir', 'disseminacao', 'domingo', 'domingo', 'orientacao']","[1, 1, 2, 2, 1]","[]","[]",5,0,5,1
2656,"['ambientar', 'concreto', 'cupula', 'desmatamento', 'diplomata', 'estrategia', 'externo', 'parceiro', 'planalto', 'recebido', 'reuniao']","[1, 1, 1, 1, 1, 1, 1, 1, 1, 1, 1]","[]","[]",11,0,11,1
2658,"['administrativo', 'aplicacao', 'apurar', 'constatar', 'enfermagem', 'enfermagem', 'enfermagem', 'instaurar', 'saudar']","[1, 1, 1, 1, 3, 3, 3, 1, 1]","['fraudar', 'fraudar', 'imagem']","[2, 2, 1]",9,3,12,1
2660,"['ausencia', 'conselho', 'consequencia', 'importancia', 'imunizacao', 'medida', 'medida', 'queiroga', 'tambem', 'ultimo']","[1, 1, 1, 1, 1, 2, 2, 1, 1, 1]","[]","[]",10,0,10,1
2661,"['anuncio', 'expectativa', 'fase', 'folhar', 'integro', 'preliminar', 'sputnik']","[1, 1, 1, 1, 1, 1, 1]","[]","[]",7,0,7,1
2662,"['fabricio', 'pslsp', 'queiroz']","[1, 1, 1]","['pego']","[1]",3,1,4,1
2663,"['alunar', 'alunar', 'assintomatico', 'colegio', 'colegio', 'colegio', 'determinacao', 'orientacao', 'pratico', 'preventivo', 'quarentenar', 'quarentenar', 'quarentenar', 'surtir', 'surtir', 'surtir', 'suspeito', 'viagem']","[2, 2, 1, 3, 3, 3, 1, 1, 1, 1, 3, 3, 3, 3, 3, 3, 1, 1]","['checagem']","[1]",18,1,19,1
2664,"[]","[]","['imagem']","[1]",0,1,1,1
2670,"['andrew', 'cepa', 'cepa', 'comunitario', 'contagioso', 'deteccao', 'inicialment', 'preocupacao', 'transmissao']","[1, 2, 2, 1, 1, 1, 1, 1, 1]","['espalhar']","[1]",9,1,10,1
2672,"['autoridad', 'primeiroministro', 'respectivament', 'sputnik']","[1, 1, 1, 1]","[]","[]",4,0,4,1
2676,"['acompanhamento', 'balancar', 'balancar', 'saudar', 'saudar']","[1, 2, 2, 2, 2]","[]","[]",5,0,5,1
2677,"['ambientar', 'anuncio', 'arthur', 'autoridad', 'autoridad', 'cnj', 'colegiado', 'colegiado', 'colegiado', 'comissao', 'confederacao', 'confederacao', 'demandar', 'demmg', 'dialogo', 'discussao', 'enfrentamento', 'externo', 'federar', 'federar', 'funcionamento', 'iniciativo', 'intervalar', 'justicar', 'legislativo', 'lira', 'lira', 'ministrar', 'necessario', 'oficio', 'pacheco', 'pacheco', 'pacheco', 'pastar', 'planalto', 'planar', 'planar', 'planar', 'planar', 'ppal', 'prazo', 'presenca', 'prever', 'prorrogar', 'queiroga', 'queiroga', 'recurso', 'republico', 'respostar', 'reuniao', 'reuniao', 'reuniao', 'reuniao', 'reuniao', 'reuniao', 'saudar', 'saudar', 'saudar', 'sugestao']","[1, 1, 1, 2, 2, 1, 3, 3, 3, 1, 2, 2, 1, 1, 1, 1, 1, 1, 2, 2, 1, 1, 1, 1, 1, 2, 2, 1, 1, 1, 3, 3, 3, 1, 1, 4, 4, 4, 4, 1, 1, 1, 1, 1, 2, 2, 1, 1, 1, 6, 6, 6, 6, 6, 6, 3, 3, 3, 1]","[]","[]",59,0,59,1
2682,"['anuncio', 'armazenamento', 'atuacao', 'conjuntar', 'conjuntar', 'crise', 'curvo', 'diariament', 'enfrentamento', 'epidemiologico', 'infraestrutura', 'infraestrutura', 'logistico', 'logistico', 'ministrar', 'necessidad', 'regiao', 'reuniao', 'reuniao']","[1, 1, 1, 2, 2, 1, 1, 1, 1, 1, 2, 2, 2, 2, 1, 1, 1, 2, 2]","[]","[]",19,0,19,1
2684,"['enfermagem', 'esperancar', 'europeu', 'quedo', 'regiao', 'ribeiro', 'turistico']","[1, 1, 1, 1, 1, 1, 1]","['arvor', 'deitar', 'estomago', 'versao']","[1, 1, 1, 1]",7,4,11,1
2685,"['aplicacao', 'aplicacao', 'conduta', 'especialment', 'esperancar', 'imunizacao', 'imunizacao', 'imunizacao', 'necessario', 'prever', 'proposto']","[2, 2, 1, 1, 1, 3, 3, 3, 1, 1, 1]","['fraudar']","[1]",11,1,12,1
2687,"['administrativo', 'alckmin', 'ambientar', 'ambientar', 'ambientar', 'condenacao', 'condenacao', 'geraldo', 'improbidad', 'interferencia', 'irregularidad', 'julgamento', 'justicar', 'magistrado', 'martim', 'ministrar', 'ministrar', 'mudanca', 'nogueira', 'planar', 'planar', 'planar', 'recurso', 'ricardo', 'ricardo', 'sall', 'sall', 'sall', 'sessao', 'sessao', 'suspeito', 'suspenso', 'varar', 'videoconferencia']","[1, 1, 3, 3, 3, 2, 2, 1, 1, 1, 1, 1, 1, 1, 1, 2, 2, 1, 1, 3, 3, 3, 1, 2, 2, 3, 3, 3, 2, 2, 1, 1, 1, 1]","[]","[]",34,0,34,1
2688,"['bandeirant', 'decorrencia', 'gorinchteyn', 'palacio', 'periodo']","[1, 1, 1, 1, 1]","[]","[]",5,0,5,1
2690,"['afp', 'autoridad', 'autoridad', 'autorizacao', 'fronteiro', 'sputnik', 'transferir']","[1, 2, 2, 1, 1, 1, 1]","[]","[]",7,0,7,1
2691,"['paralisar', 'rossi', 'turista']","[1, 1, 1]","[]","[]",3,0,3,1
2692,"['adotada', 'adulto', 'fez', 'importancia', 'medida', 'proprio']","[1, 1, 1, 1, 1, 1]","['versao', 'versao']","[2, 2]",6,2,8,1
2694,"['cenario', 'machadar', 'machadar', 'possibilidad', 'possibilidad']","[1, 2, 2, 2, 2]","[]","[]",5,0,5,1
2696,"['aspecto', 'associacao', 'economia', 'impactar', 'jantar', 'necessidad', 'oliveira', 'plano', 'respostar']","[1, 1, 1, 1, 1, 1, 1, 1, 1]","[]","[]",9,0,9,1
2697,"['aglomeracao', 'decorrencia', 'domingo', 'esforco', 'feriar', 'feriar', 'intensivo', 'ministrar', 'normalment', 'quarentenar', 'viagem']","[1, 1, 1, 1, 2, 2, 1, 1, 1, 1, 1]","[]","[]",11,0,11,1
2700,"['azevedo', 'azevedo', 'congresso', 'ministrar', 'pastar', 'periodo', 'preservar']","[2, 2, 1, 1, 1, 1, 1]","['arquivar']","[1]",7,1,8,1
2702,"['constituicao', 'internar', 'revogar']","[1, 1, 1]","[]","[]",3,0,3,1
2704,"['colunista', 'decisao', 'mandatario', 'punicao', 'souza']","[1, 1, 1, 1, 1]","['arquivar']","[1]",5,1,6,1
2707,"['afetado', 'domingo', 'domingo', 'facilitar', 'fluxo', 'fornecimento', 'paralisar', 'regiao', 'respostar']","[1, 2, 2, 1, 1, 1, 1, 1, 1]","['gasolina', 'gasolina']","[2, 2]",9,2,11,1
2711,"['calamidad', 'congresso', 'despesa', 'infectar', 'mudanca', 'periodo', 'prever', 'prever', 'saudar', 'vetar', 'vetar', 'vetar', 'vetar']","[1, 1, 1, 1, 1, 1, 2, 2, 1, 4, 4, 4, 4]","[]","[]",13,0,13,1
2713,"['balancar', 'balancar', 'estabilidad', 'habitant', 'infectar', 'letalidad', 'periodo', 'periodo', 'quedo', 'respectivament', 'saudar', 'subir', 'taxar', 'taxar', 'tendencia']","[2, 2, 1, 1, 1, 1, 2, 2, 1, 1, 1, 1, 2, 2, 1]","[]","[]",15,0,15,1
2715,"['adicionar', 'circulacao', 'desenvolvimento', 'economia', 'epidemiologico', 'esquema', 'flexibilizar', 'gabinet', 'indicador', 'ministrar', 'quarentenar', 'quarentenar', 'reuniao', 'saudar']","[1, 1, 1, 1, 1, 1, 1, 1, 1, 1, 2, 2, 1, 1]","['circular']","[1]",14,1,15,1
2718,"['exprefeito', 'fluminens', 'funcao', 'reajustar']","[1, 1, 1, 1]","['motorista', 'protestar', 'reivindicar']","[1, 1, 1]",4,3,7,1
2720,"['alerj', 'argumentar', 'argumentar', 'corpu', 'esquema', 'fabricio', 'flavio', 'flavio', 'gabinet', 'habea', 'inicialment', 'justicar', 'legislativo', 'ministrar', 'movimentacao', 'necessario', 'plantao', 'presenca', 'preventivo', 'queiroz', 'queiroz', 'queiroz', 'queiroz', 'queiroz', 'queiroz', 'rachadinha', 'republicanosrj', 'saudar', 'supremo']","[1, 2, 2, 1, 1, 1, 2, 2, 1, 1, 1, 1, 1, 1, 1, 1, 1, 1, 1, 6, 6, 6, 6, 6, 6, 1, 1, 1, 1]","[]","[]",29,0,29,1
2722,"['aspecto', 'autoridad', 'belgica', 'biliao', 'comissao', 'conformar', 'conjuntar', 'conjunto', 'coordenar', 'coordenar', 'esforco', 'espanha', 'especialment', 'europeu', 'europeu', 'europeu', 'imunizacao', 'moderno', 'necessidad', 'necessidad', 'plano', 'reafirmar', 'regiao', 'regrar', 'saudar']","[1, 1, 1, 1, 1, 1, 1, 1, 2, 2, 1, 1, 1, 3, 3, 3, 1, 1, 2, 2, 1, 1, 1, 1, 1]","[]","[]",25,0,25,1
2723,"['anuncio', 'fundacao', 'fundacao', 'iniciativo', 'inovacao', 'integro', 'legislativo', 'orcamentaria', 'previsao', 'reajustar']","[1, 2, 2, 1, 1, 1, 1, 1, 1, 1]","[]","[]",10,0,10,1
2725,"['economia', 'economia', 'espanha', 'espanha', 'impactar', 'periodo', 'pib', 'quedo', 'semestr', 'trimestr', 'trimestr', 'trimestr', 'trimestr', 'trimestr', 'trimestr']","[2, 2, 2, 2, 1, 1, 1, 1, 1, 6, 6, 6, 6, 6, 6]","[]","[]",15,0,15,1
2727,"['conselho', 'constatar', 'despesa', 'exercicio', 'fabricio', 'fabricio', 'flavio', 'funcao', 'organizado', 'pagamento', 'pagamento', 'pagamento', 'porqu', 'queiroz', 'queiroz', 'queiroz', 'queiroz', 'republicanosrj', 'submetido']","[1, 1, 1, 1, 2, 2, 1, 1, 1, 3, 3, 3, 1, 4, 4, 4, 4, 1, 1]","[]","[]",19,0,19,1
2732,"['avancar', 'gabi', 'gabi', 'gabi', 'martim', 'quarentenar', 'quarentenar', 'quarentenar', 'quarentenar']","[1, 3, 3, 3, 1, 4, 4, 4, 4]","['clicar', 'legendar']","[1, 1]",9,2,11,1
2734,"['disseminacao', 'disseminacao']","[2, 2]","['boicotar', 'parir', 'protestar']","[1, 1, 1]",2,3,5,1
2735,"['celebrar', 'desenvolvimento', 'destacar', 'destacar', 'dificuldad', 'distrito', 'equipamento', 'esforco', 'estrategia', 'gestant', 'pastar', 'primario', 'saudar', 'saudar', 'saudar', 'saudar', 'saudar', 'saudar', 'saudar', 'saudar', 'situacao', 'vulneravel']","[1, 1, 2, 2, 1, 1, 1, 1, 1, 1, 1, 1, 8, 8, 8, 8, 8, 8, 8, 8, 1, 1]","['verificacao']","[1]",22,1,23,1
2736,"['barroso', 'comissao', 'decisao', 'demmg', 'determinacao', 'inquerito', 'magistrado', 'mudanca', 'pacheco', 'pacheco', 'pedido', 'plenario', 'randolf', 'recurso', 'requerimento', 'supremo']","[1, 1, 1, 1, 1, 1, 1, 1, 2, 2, 1, 1, 1, 1, 1, 1]","[]","[]",16,0,16,1
2738,"['deteccao', 'fornecimento', 'justificativo', 'privar']","[1, 1, 1, 1]","[]","[]",4,0,4,1
2739,"['alteracao', 'alteracao', 'disseminacao', 'espanha', 'quarentenar', 'quarentenar']","[2, 2, 1, 1, 2, 2]","[]","[]",6,0,6,1
2740,"['decisao', 'determinacao', 'determinacao', 'expectativa', 'monitoramento', 'observar', 'pastar', 'possibilidad', 'presenciar', 'privar', 'reforcar', 'rossi', 'suspeito', 'suspensao']","[1, 2, 2, 1, 1, 1, 1, 1, 1, 1, 1, 1, 1, 1]","['realment']","[1]",14,1,15,1
2742,"['adversario', 'alerj', 'consecutivo', 'flavio', 'flavio', 'gabinet', 'integro', 'legislativo', 'periodo', 'republicanosrj', 'sabado']","[1, 1, 1, 2, 2, 1, 1, 1, 1, 1, 1]","['inocentar', 'tampouco']","[1, 1]",11,2,13,1
2743,"['hubei', 'infectar', 'investigacao', 'kong', 'provincia', 'surtir', 'totalizar']","[1, 1, 1, 1, 1, 1, 1]","[]","[]",7,0,7,1
2744,"['antonio', 'anvisa', 'anvisa', 'comissao', 'comissao', 'plenario', 'plenario', 'sabatino', 'substituto', 'substituto', 'vigilancia']","[1, 2, 2, 2, 2, 2, 2, 1, 2, 2, 1]","[]","[]",11,0,11,1
2746,"['avancar', 'biliao', 'domicilio', 'estatistico', 'geografia', 'ibg', 'ibg', 'impacto', 'instituto', 'levantamento', 'necessario', 'parcelar', 'proporcao', 'saudar', 'suspenso', 'totalizar']","[1, 1, 1, 1, 1, 2, 2, 1, 1, 1, 1, 1, 1, 1, 1, 1]","['versao']","[1]",16,1,17,1
2748,"['atuacao', 'decisao', 'embora', 'enfermagem', 'estabilidad', 'henriqu', 'internacao', 'pedido', 'pedido', 'pedido', 'plantao', 'plantao', 'plantao', 'proposta', 'rotina', 'sociai', 'sorocaba', 'ultimo']","[1, 1, 1, 1, 1, 1, 1, 3, 3, 3, 3, 3, 3, 1, 1, 1, 1, 1]","[]","[]",18,0,18,1
2749,"['afetado', 'assistencia', 'balancar', 'epicentro', 'habitant', 'infectar', 'michael', 'recordar', 'reforcar', 'regiao', 'saudar', 'saudar', 'taxar', 'taxar']","[1, 1, 1, 1, 1, 1, 1, 1, 1, 1, 2, 2, 2, 2]","[]","[]",14,0,14,1
2751,"['boletim', 'caxia', 'duqu', 'fluminens', 'goncalo', 'investigacao', 'saudar']","[1, 1, 1, 1, 1, 1, 1]","[]","[]",7,0,7,1
2752,"['consorcio', 'instalacao', 'saudar']","[1, 1, 1]","['amplament', 'gleisi']","[1, 1]",3,2,5,1
2753,"['funcao']","[1]","['postagen']","[1]",1,1,2,1
2754,"['comparacao', 'consolidar', 'consorcio', 'domingo', 'levantamento', 'recordar', 'saudar', 'situacao', 'tendencia', 'variacao']","[1, 1, 1, 1, 1, 1, 1, 1, 1, 1]","[]","[]",10,0,10,1
2755,"['gabinet', 'planar']","[1, 1]","[]","[]",2,0,2,1
2758,"['adotada', 'atuacao', 'bolsonarista', 'bolsonarista', 'bolsonarista', 'bolsonarista', 'bolsonarista', 'carat', 'consultoria', 'consultoria', 'consultoria', 'crescimento', 'crescimento', 'destacar', 'economia', 'flavio', 'interpretar', 'levantamento', 'levantamento', 'mudanca', 'mudanca', 'mudanca', 'mudanca', 'observar', 'palacio', 'palacio', 'parcelar', 'parcelar', 'planalto', 'planalto', 'positivar', 'posturar', 'pratico', 'prever', 'respostar', 'tendencia']","[1, 1, 5, 5, 5, 5, 5, 1, 3, 3, 3, 2, 2, 1, 1, 1, 1, 2, 2, 4, 4, 4, 4, 1, 2, 2, 2, 2, 2, 2, 1, 1, 1, 1, 1, 1]","['imagem', 'postagen', 'postagen']","[1, 2, 2]",36,3,39,1
2759,"['desembarcar', 'diariament', 'epicentro', 'informaco', 'medida', 'passageiro', 'passageiro', 'previsao', 'provincia', 'rotina', 'sabado', 'situacao', 'ultimo']","[1, 1, 1, 1, 1, 2, 2, 1, 1, 1, 1, 1, 1]","['dubai']","[1]",13,1,14,1
2763,"['antonio', 'cerimonia', 'estrategico', 'importancia', 'lancamento', 'primario', 'reducao', 'reforcar', 'saudar', 'saudar', 'saudar', 'saudar', 'saudar']","[1, 1, 1, 1, 1, 1, 1, 1, 5, 5, 5, 5, 5]","[]","[]",13,0,13,1
2764,"['argumentar', 'constituicao', 'decisao', 'espirito', 'julgamento', 'julgamento', 'plenario', 'previsto', 'republico', 'supremo', 'supremo', 'unanimidad']","[1, 1, 1, 1, 2, 2, 1, 1, 1, 2, 2, 1]","[]","[]",12,0,12,1
2770,"['calendario', 'capitar', 'capitar', 'demandar', 'dosar', 'dosar', 'goncalo', 'imunizacao', 'inicialment', 'interrupcao', 'levantamento', 'possibilidad', 'previsao', 'publicoalvo', 'sabado', 'suspensao']","[1, 2, 2, 1, 2, 2, 1, 1, 1, 1, 1, 1, 1, 1, 1, 1]","[]","[]",16,0,16,1
2771,"['domingo', 'equivalent', 'quilometro']","[1, 1, 1]","[]","[]",3,0,3,1
2772,"['diariament', 'renata', 'servidor', 'turma']","[1, 1, 1, 1]","[]","[]",4,0,4,1
2777,"['balancar', 'biliao', 'biliao', 'biliao', 'biliao', 'comparacao', 'economia', 'exportacao', 'exportacao', 'importacao', 'importacao', 'importacao', 'periodo', 'periodo', 'positivar', 'recuar', 'recuar', 'superar', 'totalizar']","[1, 4, 4, 4, 4, 1, 1, 2, 2, 3, 3, 3, 2, 2, 1, 2, 2, 1, 1]","[]","[]",19,0,19,1
2778,"['algun', 'algun', 'autoridad', 'autoridad', 'autoridad', 'bandeirant', 'recurso', 'sigla']","[2, 2, 3, 3, 3, 1, 1, 1]","[]","[]",8,0,8,1
2780,"['afastamento', 'economia', 'interino', 'mudanca', 'mudanca', 'necessidad', 'ricardo']","[1, 1, 1, 2, 2, 1, 1]","[]","[]",7,0,7,1
2784,"['distant']","[1]","['atirar', 'biblia', 'imagem', 'padrar', 'padrar']","[1, 1, 1, 2, 2]",1,5,6,1
2785,"['campino', 'curso', 'excecao', 'fase', 'fase', 'fase', 'intensivo', 'planar', 'planar', 'presenciar', 'regrar', 'restritivo', 'saudar', 'situacao', 'superar', 'suspenso', 'transmissao']","[1, 1, 1, 3, 3, 3, 1, 2, 2, 1, 1, 1, 1, 1, 1, 1, 1]","[]","[]",17,0,17,1
2786,"['desafio', 'destacar', 'pagamento', 'reconhecimento']","[1, 1, 1, 1]","['drone', 'drone']","[2, 2]",4,2,6,1
2789,"['acompanhamento', 'associacao', 'coletivo', 'comissao', 'competicao', 'confederacao', 'elaborar', 'etapa', 'individuar', 'planar', 'planar', 'preliminar', 'saudar', 'saudar', 'treinamento', 'treinamento']","[1, 1, 1, 1, 1, 1, 1, 1, 1, 2, 2, 1, 2, 2, 2, 2]","[]","[]",16,0,16,1
2790,"['anteriorment', 'anvisa', 'autorizacao', 'carla', 'contrato', 'destac', 'destac', 'entregu', 'exemplo', 'globonew', 'imunizacao', 'imunizacao', 'imunizacao', 'mudanca', 'mudanca', 'previsao', 'queiroga']","[1, 1, 1, 1, 1, 2, 2, 1, 1, 1, 3, 3, 3, 2, 2, 1, 1]","['sequer']","[1]",17,1,18,1
2791,"['client', 'destacar', 'destinar', 'fronteiro', 'fronteiro', 'internar', 'situacao', 'turista']","[1, 1, 1, 2, 2, 1, 1, 1]","[]","[]",8,0,8,1
2795,"['cnj', 'cnj', 'condenacao', 'constituicao', 'justicar', 'justicar', 'justicar', 'pagamento', 'pagamento', 'pagamento', 'planar', 'previsto', 'recurso', 'regrar', 'regrar', 'regrar', 'resolucao', 'resolucao', 'supremo']","[2, 2, 1, 1, 3, 3, 3, 3, 3, 3, 1, 1, 1, 3, 3, 3, 2, 2, 1]","[]","[]",19,0,19,1
2797,"['afastamento', 'barroso', 'barroso', 'decisao', 'folhar', 'fux', 'inclusao', 'integro', 'julgamento', 'magistrado', 'ministrar', 'plenario', 'revogar', 'supremo']","[1, 2, 2, 1, 1, 1, 1, 1, 1, 1, 1, 1, 1, 1]","[]","[]",14,0,14,1
2798,"['aprovacao', 'diariament', 'folhar', 'habito', 'habito', 'inedito', 'necessario', 'pagamento', 'pagamento', 'plenario', 'pratico', 'prever', 'prioridad', 'rotina', 'vulnerabilidad']","[1, 1, 1, 2, 2, 1, 1, 2, 2, 1, 1, 1, 1, 1, 1]","['abencoar', 'imagem', 'vazio']","[1, 1, 1]",15,3,18,1
2800,"['apostar', 'conformar', 'plano']","[1, 1, 1]","[]","[]",3,0,3,1
2801,"['acompanhamento', 'epidemiar', 'gabinet', 'gabinet', 'gabinet', 'instaurar', 'oficio', 'orientacao', 'risco', 'saudar', 'saudar', 'saudar', 'saudar']","[1, 1, 3, 3, 3, 1, 1, 1, 1, 4, 4, 4, 4]","[]","[]",13,0,13,1
2802,"['esperancar']","[1]","['imagem', 'legendar']","[1, 1]",1,2,3,1
2803,"['crise', 'crise', 'julgamento', 'planar', 'pratico', 'presidir', 'provisorio', 'sessao', 'supremo', 'supremo', 'supremo', 'transferir']","[2, 2, 1, 1, 1, 1, 1, 1, 3, 3, 3, 1]","[]","[]",12,0,12,1
2804,"['anvisa', 'anvisa', 'decisao', 'diretoria', 'extraordinario', 'importacao', 'imunizacao', 'instituto', 'lewandowski', 'ministrar', 'prazo', 'prazo', 'reuniao', 'reuniao', 'ricardo', 'sputnik', 'supremo', 'vigilancia']","[2, 2, 1, 1, 1, 1, 1, 1, 1, 1, 2, 2, 2, 2, 1, 1, 1, 1]","[]","[]",18,0,18,1
2807,"['antonio', 'assistencia', 'cardiologista', 'desenvolvimento', 'estrategico', 'exonerar', 'henriqu', 'implementar', 'inovacao', 'inovacao', 'inovacao', 'ministrar', 'ministrar', 'nelson', 'saudar', 'saudar', 'saudar', 'saudar', 'saudar', 'saudar', 'souza', 'teich']","[1, 1, 1, 1, 1, 1, 1, 1, 3, 3, 3, 2, 2, 1, 6, 6, 6, 6, 6, 6, 1, 1]","[]","[]",22,0,22,1
2813,"['apurar', 'associacao', 'associacao', 'associacao', 'consumidor', 'consumidor', 'integro', 'justicar', 'notificar']","[1, 3, 3, 3, 2, 2, 1, 1, 1]","['abusar']","[1]",9,1,10,1
2814,"['saudar']","[1]","[]","[]",1,0,1,1
2815,"['coreia', 'epidemiar', 'infectar', 'periodo', 'superar']","[1, 1, 1, 1, 1]","[]","[]",5,0,5,1
2817,"['balancar', 'balancar', 'hospitalizar', 'infectar', 'intensivo', 'internar', 'internar', 'positivar', 'quedo', 'totalizar']","[2, 2, 1, 1, 1, 2, 2, 1, 1, 1]","[]","[]",10,0,10,1
2818,"['conselho', 'sociai']","[1, 1]","[]","[]",2,0,2,1
2820,"['adhanom', 'adhanom', 'consecutivo', 'consecutivo', 'notificar', 'saudar', 'situacao', 'tedro', 'tedro', 'velocidad']","[2, 2, 2, 2, 1, 1, 1, 2, 2, 1]","[]","[]",10,0,10,1
2822,"['crise', 'milho', 'pedido', 'pedido', 'relacao']","[1, 1, 2, 2, 1]","[]","[]",5,0,5,1
2823,"['apostar', 'desafio', 'funcao', 'incerteza', 'mudanca', 'necessidad', 'prioridad', 'rotina']","[1, 1, 1, 1, 1, 1, 1, 1]","[]","[]",8,0,8,1
2824,"['aplicacao', 'henri', 'legislativo', 'prever', 'proposto', 'sancao', 'saudar']","[1, 1, 1, 1, 1, 1, 1]","[]","[]",7,0,7,1
2825,"['absoluto', 'arthur', 'bolsonarista', 'constatar', 'converso', 'especifico', 'expressivo', 'favorito', 'folhar', 'lira', 'lira', 'lira', 'necessario', 'ppal', 'respostar', 'rossi', 'situacao']","[1, 1, 1, 1, 1, 1, 1, 1, 1, 3, 3, 3, 1, 1, 1, 1, 1]","['misturar', 'verdadeiro']","[1, 1]",17,2,19,1
2827,"['alteracao', 'congresso', 'economia', 'facilitar', 'gued', 'gued', 'impactar', 'imunizacao', 'imunizacao', 'iniciativo', 'martim', 'ministrar', 'planar', 'previsto', 'prioritario', 'privar', 'privar', 'privar', 'queixar', 'saudar', 'saudar']","[1, 1, 1, 1, 2, 2, 1, 2, 2, 1, 1, 1, 1, 1, 1, 3, 3, 3, 1, 2, 2]","['idioma']","[1]",21,1,22,1
2828,"['antonio', 'boletim', 'cardiologista', 'domingo', 'domingo', 'internar', 'marilia', 'ministrar', 'ministrar', 'ministrar', 'ministrar', 'quedo', 'supremo', 'supremo']","[1, 1, 1, 2, 2, 1, 1, 4, 4, 4, 4, 1, 2, 2]","['acidentar']","[1]",14,1,15,1
2830,"['acumular', 'preocupacao', 'transmissao', 'transmissao']","[1, 1, 2, 2]","[]","[]",4,0,4,1
2831,"['domingo', 'reabrir', 'reforcar', 'regrar', 'saudar']","[1, 1, 1, 1, 1]","[]","[]",5,0,5,1
2833,"['argumentar', 'conduta', 'contabilizar', 'crise', 'economia', 'estrategia', 'henriqu', 'impactar', 'ministrar', 'paralelo', 'quarentenar', 'reabertura', 'respostar', 'saudar']","[1, 1, 1, 1, 1, 1, 1, 1, 1, 1, 1, 1, 1, 1]","['boicotar', 'copiar', 'falsar']","[1, 1, 1]",14,3,17,1
2834,"['correspondent', 'desmatamento', 'desmatamento', 'desmatamento', 'instituto', 'normalment', 'periodo', 'periodo', 'quilometro', 'regiao', 'regiao', 'temporada']","[1, 3, 3, 3, 1, 1, 2, 2, 1, 2, 2, 1]","['espalhar', 'incendio', 'incendio', 'incendio', 'incendio', 'incendio']","[1, 5, 5, 5, 5, 5]",12,6,18,1
2836,"['bandeirant', 'concedido', 'crise', 'gripezinha', 'minimizar', 'palacio', 'posturar', 'saudar', 'tucano']","[1, 1, 1, 1, 1, 1, 1, 1, 1]","['safar']","[1]",9,1,10,1
2838,"['acumular', 'conjuntar', 'dengu', 'fase', 'importancia', 'prioridad', 'proliferacao', 'saudar', 'saudar', 'saudar', 'urbano']","[1, 1, 1, 1, 1, 1, 1, 3, 3, 3, 1]","[]","[]",11,0,11,1
2842,"['afp', 'definitivo', 'geraldo', 'gripezinha', 'importancia', 'ministrar', 'mudanca', 'mudanca', 'saudar']","[1, 1, 1, 1, 1, 1, 2, 2, 1]","[]","[]",9,0,9,1
2843,"['acompanhamento', 'ansiedad', 'consequencia', 'desenvolvimento', 'especifico', 'habito', 'necessidad', 'obesidad', 'psicologo', 'psicologo', 'rotina', 'saudar']","[1, 1, 1, 1, 1, 1, 1, 1, 2, 2, 1, 1]","['estomago', 'realment']","[1, 1]",12,2,14,1
2844,"[]","[]","[]","[]",0,0,0,1
2847,"['ambito', 'biliao', 'biliao', 'boletim', 'crise', 'destinar', 'destinar', 'destinar', 'enfrentamento', 'enfrentamento', 'federativo', 'federativo', 'gabinet', 'recurso']","[1, 2, 2, 1, 1, 3, 3, 3, 2, 2, 2, 2, 1, 1]","['descricao', 'desmentir', 'enganoso']","[1, 1, 1]",14,3,17,1
2849,"['adesao', 'bbc', 'crise', 'diretoria', 'embora', 'fundacao', 'milho', 'milho', 'minoria', 'sendo', 'sociai', 'varga']","[1, 1, 1, 1, 1, 1, 2, 2, 1, 1, 1, 1]","['ampla', 'ampla', 'usuario', 'usuario']","[2, 2, 2, 2]",12,4,16,1
2853,"['crise', 'observar']","[1, 1]","['imagem', 'sacar']","[1, 1]",2,2,4,1
2856,"['algun', 'associacao', 'associacao', 'associacao', 'aumento', 'aumento', 'consumidor', 'demanda', 'equilibrio', 'normalment']","[1, 3, 3, 3, 2, 2, 1, 1, 1, 1]","[]","[]",10,0,10,1
2860,"['apostar', 'circulacao', 'desenvolvimento', 'espanha', 'quarentenar', 'quarentenar', 'quarentenar', 'taxar']","[1, 1, 1, 1, 3, 3, 3, 1]","[]","[]",8,0,8,1
2862,"['adiamento', 'barroso', 'barroso', 'barroso', 'colunista', 'esperancar', 'ministrar', 'ministrar', 'necessario', 'prazo', 'souza', 'supremo']","[1, 3, 3, 3, 1, 1, 2, 2, 1, 1, 1, 1]","[]","[]",12,0,12,1
2867,"['alteracao', 'destinar', 'distrito', 'dosar', 'esquema', 'fase', 'fluxo', 'igualitario', 'instituto', 'necessario', 'operacionalizacao', 'pastar', 'periodo', 'planar', 'previsao', 'publicoalvo', 'saudar', 'saudar']","[1, 1, 1, 1, 1, 1, 1, 1, 1, 1, 1, 1, 1, 1, 1, 1, 2, 2]","[]","[]",18,0,18,1
2868,"['carat', 'coletivo', 'coletivo', 'corpu', 'decisao', 'demandar', 'fabricio', 'flavio', 'habea', 'justicar', 'justificativo', 'ministrar', 'provisorio', 'queiroz', 'queiroz', 'republicanosrj', 'republico', 'situacao', 'transferir', 'turma']","[1, 2, 2, 1, 1, 1, 1, 1, 1, 1, 1, 1, 1, 2, 2, 1, 1, 1, 1, 1]","['amigar']","[1]",20,1,21,1
2869,"['andrew', 'andrew', 'avancar', 'infeccioso', 'primeiroministro', 'propagacao']","[2, 2, 1, 1, 1, 1]","[]","[]",6,0,6,1
2870,"['afetado', 'colaboracao', 'respirador', 'respirador', 'respirador']","[1, 1, 3, 3, 3]","[]","[]",5,0,5,1
2872,"['balancar', 'consorcio', 'distrito', 'dosar', 'dosar', 'folhar', 'parceria', 'spaulo', 'spaulo']","[1, 1, 1, 2, 2, 1, 1, 2, 2]","[]","[]",9,0,9,1
2874,"['comorbidad', 'gestant', 'gestant', 'medeiro', 'pastar', 'pastar', 'primario', 'saudar', 'saudar', 'sugestao']","[1, 2, 2, 1, 2, 2, 1, 2, 2, 1]","[]","[]",10,0,10,1
2875,"['aplicacao', 'calculo', 'economia', 'equivalent', 'estimativo', 'estimativo', 'infectar', 'patamar', 'respectivament', 'sarampo', 'sarampo', 'saudar']","[1, 1, 1, 1, 2, 2, 1, 1, 1, 2, 2, 1]","['minutar', 'minutar']","[2, 2]",12,2,14,1
2876,"['carat', 'confirmado', 'correspondent', 'goncalo', 'medida', 'pulmonar', 'pulmonar', 'reforca', 'temporario', 'ventilatorio', 'ventilatorio']","[1, 1, 1, 1, 1, 2, 2, 1, 1, 2, 2]","[]","[]",11,0,11,1
2877,"['comparacao', 'desigualdad', 'destacar', 'epidemiologico', 'fase', 'regiao']","[1, 1, 1, 1, 1, 1]","[]","[]",6,0,6,1
2878,"['michael']","[1]","['amigar', 'compartilhar']","[1, 1]",1,2,3,1
2881,"['decisao', 'expectativa', 'higienizacao', 'reabrir', 'reuniao', 'sabado', 'salao', 'salao']","[1, 1, 1, 1, 1, 1, 2, 2]","[]","[]",8,0,8,1
2882,"['autorizacao', 'colaborar', 'imunizacao', 'imunizacao', 'justicar', 'planar', 'prioritario', 'sindicato', 'sindicato']","[1, 1, 2, 2, 1, 1, 1, 2, 2]","[]","[]",9,0,9,1
2886,"['administrativo', 'ambientar', 'client', 'descumprimento', 'funcionamento']","[1, 1, 1, 1, 1]","['circular']","[1]",5,1,6,1
2887,"['adulto', 'associacao', 'azevedo', 'desenvolvimento', 'dialogo', 'dialogo', 'especialment', 'especifico', 'fase', 'fase', 'fase', 'infancia', 'martim', 'mudanca', 'necessidad', 'necessidad', 'normalment', 'orientacao', 'periodo', 'psicologo', 'saudar']","[1, 1, 1, 1, 2, 2, 1, 1, 3, 3, 3, 1, 1, 1, 2, 2, 1, 1, 1, 1, 1]","[]","[]",21,0,21,1
2892,"['assintomatico', 'cepa', 'diagnosticar', 'globonew', 'infectar', 'internar', 'piorar', 'positivar', 'saudar', 'saudar']","[1, 1, 1, 1, 1, 1, 1, 1, 2, 2]","[]","[]",10,0,10,1
2898,"['alternativo', 'antonio', 'converso', 'exgovernador', 'exjuiz', 'exministro', 'exministro', 'integro', 'justicar', 'republico']","[1, 1, 1, 1, 1, 2, 2, 1, 1, 1]","[]","[]",10,0,10,1
2899,"['confirmado', 'fundacao', 'inclusao', 'instituto', 'instituto', 'investigacao', 'oswaldo', 'secretarioexecutivo', 'serao', 'suspeito', 'suspeito', 'tambem']","[1, 1, 1, 2, 2, 1, 1, 1, 1, 2, 2, 1]","[]","[]",12,0,12,1
2901,"['aglomeracao', 'conformar', 'feriar', 'guaruja', 'mandatario']","[1, 1, 1, 1, 1]","[]","[]",5,0,5,1
2907,"['adicionar', 'decorrent', 'enfrentamento', 'orientacao', 'privar', 'regrar', 'regrar', 'saudar', 'servidor', 'servidor', 'viagem', 'viagem']","[1, 1, 1, 1, 1, 2, 2, 1, 2, 2, 2, 2]","['circular', 'instrucao']","[1, 1]",12,2,14,1
2908,"['condenacao', 'contrato', 'decisao', 'edson', 'exjuiz', 'fachin', 'forcatarefa', 'guaruja', 'guaruja', 'investigacao', 'investigacao', 'julgamento', 'justicar', 'justicar', 'ministrar', 'prazo', 'privar', 'sentenca', 'transferir', 'triplex', 'triplex', 'triplex', 'triplex', 'triplex', 'turma', 'turma', 'varar']","[1, 1, 1, 1, 1, 1, 1, 2, 2, 2, 2, 1, 2, 2, 1, 1, 1, 1, 1, 5, 5, 5, 5, 5, 2, 2, 1]","[]","[]",27,0,27,1
2909,"['autoridad', 'crise', 'subir']","[1, 1, 1]","['verificar']","[1]",3,1,4,1
2910,"['espanha', 'itamarati', 'itamarati', 'itamarati', 'orientacao', 'pastar', 'prazo']","[1, 3, 3, 3, 1, 1, 1]","[]","[]",7,0,7,1
2913,"['arthur', 'assistencia', 'converso', 'demmg', 'economia', 'gued', 'gued', 'gued', 'lira', 'ministrar', 'pacheco', 'pastar', 'plenario', 'ppal', 'proposto', 'reuniao', 'sessao', 'sessao', 'tributario', 'tributario']","[1, 1, 1, 1, 1, 3, 3, 3, 1, 1, 1, 1, 1, 1, 1, 1, 2, 2, 2, 2]","[]","[]",20,0,20,1
2916,"['anvisa', 'anvisa', 'decisao', 'importacao', 'lewandowski', 'magistrado', 'ministrar', 'prazo', 'prazo', 'prazo', 'respostar', 'ricardo', 'supremo', 'vigilancia']","[2, 2, 1, 1, 1, 1, 1, 3, 3, 3, 1, 1, 1, 1]","[]","[]",14,0,14,1
2928,"['atuacao', 'batalhar', 'batalhar', 'crise', 'dedicar', 'dedicar', 'posicionamento', 'prioridad', 'rotina', 'saudar']","[1, 2, 2, 1, 2, 2, 1, 1, 1, 1]","[]","[]",10,0,10,1
2929,"['adulto', 'condicao', 'efetividad', 'efetividad', 'fase', 'inedito', 'internacao', 'respostar']","[1, 1, 2, 2, 1, 1, 1, 1]","[]","[]",8,0,8,1
2930,"['conflito', 'congresso', 'crise', 'crise', 'exministro', 'globonew', 'sabado', 'sabado']","[1, 1, 2, 2, 1, 1, 2, 2]","[]","[]",8,0,8,1
2931,"['adulto', 'client', 'disseminacao', 'distant', 'esquema', 'funcionamento', 'necessario', 'periodo', 'turista', 'vetar']","[1, 1, 1, 1, 1, 1, 1, 1, 1, 1]","['imagem']","[1]",10,1,11,1
2932,"['bbc']","[1]","['parir']","[1]",1,1,2,1
2935,"['aprovacao', 'condicao', 'desenvolvimento', 'desenvolvimento', 'instituto', 'instituto', 'instituto', 'prever', 'prever']","[1, 1, 2, 2, 3, 3, 3, 2, 2]","['enfim']","[1]",9,1,10,1
2936,"['airlin', 'autoridad', 'colombio', 'companhia', 'companhia', 'reabrir', 'viagem', 'voo', 'voo']","[1, 1, 1, 2, 2, 1, 1, 2, 2]","['equador']","[1]",9,1,10,1
2937,"['afp', 'disseminacao', 'globonew', 'iniciativo', 'justicar', 'parceiro', 'parceria', 'prever']","[1, 1, 1, 1, 1, 1, 1, 1]","['boatar', 'cbn', 'checagem', 'checagem', 'checagem', 'efarsa', 'lupa', 'verificar']","[1, 1, 3, 3, 3, 1, 1, 1]",8,8,16,1
2939,"['ambito', 'apreensao', 'argumentar', 'condicao', 'decisao', 'investigacao', 'investigacao', 'justicar', 'lavagem', 'lavagem', 'ministrar', 'ministrar', 'privilegiar', 'supremo', 'supremo']","[1, 1, 1, 1, 1, 2, 2, 1, 2, 2, 2, 2, 1, 2, 2]","[]","[]",15,0,15,1
2941,"['claudio', 'federar', 'fluminens', 'habitant', 'letalidad', 'letalidad', 'taxar']","[1, 1, 1, 1, 2, 2, 1]","[]","[]",7,0,7,1
2943,"['batalhar', 'esperancar', 'gued', 'gued', 'internar', 'internar', 'pulmonar']","[1, 1, 2, 2, 2, 2, 1]","['menino', 'menino', 'menino', 'soldar']","[3, 3, 3, 1]",7,4,11,1
2944,"['aprovacao', 'discussao', 'independentement', 'proposto', 'rejeicao']","[1, 1, 1, 1, 1]","['bandeiro', 'ideologia', 'legendar']","[1, 1, 1]",5,3,8,1
2945,"['entendimento', 'entendimento', 'entendimento', 'posturar', 'republico', 'saudar']","[3, 3, 3, 1, 1, 1]","['dorio', 'humanar']","[1, 1]",6,2,8,1
2948,"['expressar', 'observar', 'planalto', 'planalto']","[1, 1, 2, 2]","[]","[]",4,0,4,1
2949,"['bancada', 'biliao', 'congresso', 'congresso', 'contribuicao', 'contribuicao', 'economia', 'estimular', 'expressar', 'gued', 'ministrar', 'tributario', 'tributario', 'vetar', 'vetar', 'vetar', 'vetar', 'vetar', 'vetar', 'vetar']","[1, 1, 2, 2, 2, 2, 1, 1, 1, 1, 1, 2, 2, 7, 7, 7, 7, 7, 7, 7]","['biblia', 'perdao', 'perdao']","[1, 2, 2]",20,3,23,1
2950,"['amplo', 'claudio', 'republico', 'respostar']","[1, 1, 1, 1]","['agredir', 'assassinar', 'estuprar', 'estuprar', 'estuprar', 'rosario']","[1, 1, 3, 3, 3, 1]",4,6,10,1
2954,"['atrasar', 'ideologico', 'instituto', 'instituto', 'logistico', 'logistico', 'parceria', 'periodo', 'planar', 'recordar']","[1, 1, 2, 2, 2, 2, 1, 1, 1, 1]","[]","[]",10,0,10,1
2956,"['aprovacao', 'arthur', 'congresso', 'congresso', 'demmg', 'despesa', 'economia', 'gued', 'lira', 'medida', 'pacheco', 'pagamento', 'parcela', 'possibilidad', 'ppal', 'prever']","[1, 1, 2, 2, 1, 1, 1, 1, 1, 1, 1, 1, 1, 1, 1, 1]","[]","[]",16,0,16,1
2959,"['autoridad', 'decisao', 'merkel', 'prorrogar', 'regrar']","[1, 1, 1, 1, 1]","[]","[]",5,0,5,1
2961,"['anvisa', 'anvisa', 'autoridad', 'mudanca', 'prazo', 'provisorio', 'regrar', 'vigilancia', 'vigilancia']","[2, 2, 1, 1, 1, 1, 1, 2, 2]","['versao']","[1]",9,1,10,1
2962,"['atuam', 'coordenar', 'destinar', 'distrito', 'entregu', 'fundacao', 'instituto', 'oswaldo', 'pastar', 'prioritario', 'saudar', 'saudar', 'saudar', 'saudar', 'vigilancia']","[1, 1, 1, 1, 1, 1, 1, 1, 1, 1, 4, 4, 4, 4, 1]","[]","[]",15,0,15,1
2964,"['aspecto', 'interpretar', 'lancamento', 'periodo', 'perspectivo', 'perspectivo', 'situacao']","[1, 1, 1, 1, 2, 2, 1]","[]","[]",7,0,7,1
2965,"['decisao', 'decisao', 'desenvolvimento', 'determinacao', 'flavio', 'henriqu', 'intensivo', 'internacao', 'magistrado', 'oficialment', 'pagamento', 'saudar', 'saudar', 'situacao', 'situacao', 'tramitar', 'varar']","[2, 2, 1, 1, 1, 1, 1, 1, 1, 1, 1, 2, 2, 2, 2, 1, 1]","['sequer']","[1]",17,1,18,1
2970,"['client', 'condicao', 'crise', 'dedicar', 'especialment', 'opcao', 'orientacao', 'parcelar', 'pastar', 'preventivo', 'quarentenar', 'saudar', 'significativo', 'vulnerabilidad']","[1, 1, 1, 1, 1, 1, 1, 1, 1, 1, 1, 1, 1, 1]","[]","[]",14,0,14,1
2973,"['complicacao', 'internar', 'piorar', 'saudar']","[1, 1, 1, 1]","[]","[]",4,0,4,1
2975,"['decisao', 'especifico', 'observacao', 'privar', 'respiratorio', 'saudar']","[1, 1, 1, 1, 1, 1]","['imagem', 'usuario']","[1, 1]",6,2,8,1
2978,"['acompanhamento', 'aglomeracao', 'assistencia', 'especializar', 'mantido', 'normalment', 'pratico', 'presenciar', 'previo', 'realizacao', 'saudar', 'saudar', 'saudar', 'suspenso']","[1, 1, 1, 1, 1, 1, 1, 1, 1, 1, 3, 3, 3, 1]","[]","[]",14,0,14,1
2980,"['capitar', 'espanha', 'europeu', 'fronteiro', 'fronteiro', 'fronteiro', 'parcelar', 'proliferacao', 'regiao', 'temporada', 'temporario', 'voo']","[1, 1, 1, 3, 3, 3, 1, 1, 1, 1, 1, 1]","[]","[]",12,0,12,1
2981,"['dificuldad', 'exportacao', 'exportacao', 'instalacao', 'logistico', 'positivar', 'surto', 'testagem', 'trimestr']","[1, 2, 2, 1, 1, 1, 1, 1, 1]","[]","[]",9,0,9,1
2982,"['autoridad', 'decisao', 'flexibilizar', 'primeiroministro', 'proporcao', 'quarentenar', 'reuniao', 'turista']","[1, 1, 1, 1, 1, 1, 1, 1]","[]","[]",8,0,8,1
2986,"['adiamento', 'avancar', 'avancar', 'comunitario', 'destacar', 'diagnosticar', 'domingo', 'domingo', 'henriqu', 'infectar', 'integrant', 'ministrar', 'saudar', 'spaulo', 'transmissao', 'transmissao', 'wajngarten']","[1, 2, 2, 1, 1, 1, 2, 2, 1, 1, 1, 1, 1, 1, 2, 2, 1]","[]","[]",17,0,17,1
2988,"['fundacao', 'fundacao', 'imunizacao', 'inicialment', 'instituto', 'interrupcao', 'necessario', 'oswaldo', 'paralisar', 'paralisar', 'planar', 'prever', 'remessar', 'volumar']","[2, 2, 1, 1, 1, 1, 1, 1, 2, 2, 1, 1, 1, 1]","[]","[]",14,0,14,1
2989,"['disseminacao', 'internar', 'realizacao', 'reuniao', 'sudest']","[1, 1, 1, 1, 1]","['imagem']","[1]",5,1,6,1
2992,"['comparacao', 'consolidar', 'consorcio', 'estabilidad', 'sabado', 'saudar', 'tendencia', 'tendencia', 'variacao']","[1, 1, 1, 1, 1, 1, 2, 2, 1]","[]","[]",9,0,9,1
2994,"['abordagem', 'adiamento', 'adiamento', 'ampliacao', 'aprovacao', 'discussao', 'mantido', 'mantido', 'pacheco', 'pacheco', 'possibilidad', 'prever', 'proposto', 'reuniao', 'saudar', 'sessao', 'sessao']","[1, 2, 2, 1, 1, 1, 2, 2, 2, 2, 1, 1, 1, 1, 1, 2, 2]","[]","[]",17,0,17,1
2995,"['agravar', 'antonio', 'autoridad', 'circulacao', 'converso', 'crise', 'fronteiro', 'fronteiro', 'fronteiro', 'henriqu', 'ministrar', 'ministrar', 'oficio', 'oficio', 'roraima', 'saudar', 'saudar']","[1, 1, 1, 1, 1, 1, 3, 3, 3, 1, 2, 2, 2, 2, 1, 2, 2]","['enderecar']","[1]",17,1,18,1
2996,"['consumidor', 'crise', 'economia', 'fundacao', 'impactar', 'instituto', 'jornada', 'levantamento', 'periodo', 'quedo', 'quedo', 'reducao', 'suspenso', 'varga']","[1, 1, 1, 1, 1, 1, 1, 1, 1, 2, 2, 1, 1, 1]","['ganhar']","[1]",14,1,15,1
2997,"['ambientar', 'ambientar', 'ambientar', 'decisao', 'determinacao', 'justicar', 'justicar', 'ministrar', 'ministrar', 'prazo', 'prazo', 'previo', 'provisorio', 'regrar', 'republico', 'revogar', 'ricardo', 'sall', 'supremo', 'supremo', 'suspenso']","[3, 3, 3, 1, 1, 2, 2, 2, 2, 2, 2, 1, 1, 1, 1, 1, 1, 1, 2, 2, 1]","[]","[]",21,0,21,1
3000,"['apurar', 'domingo', 'ribeiro', 'ribeiro', 'ribeiro']","[1, 1, 3, 3, 3]","[]","[]",5,0,5,1
3002,"['adicionar', 'bandeirant', 'inicialment', 'instituto', 'instituto', 'palacio', 'pastar', 'prever', 'prever', 'reuter', 'saudar']","[1, 1, 1, 2, 2, 1, 1, 2, 2, 1, 1]","[]","[]",11,0,11,1
3005,"['desafio', 'regiao']","[1, 1]","[]","[]",2,0,2,1
3006,"['associacao', 'celebrar', 'flavio', 'flavio', 'quatro', 'quatro', 'semestr', 'situacao', 'universitario']","[1, 1, 2, 2, 2, 2, 1, 1, 1]","['incendio', 'incendio']","[2, 2]",9,2,11,1
3007,"['converso', 'domingo', 'exgovernador', 'pereira', 'tucano']","[1, 1, 1, 1, 1]","['enderecar', 'legendar', 'rompimento']","[1, 1, 1]",5,3,8,1
3008,"['academiar', 'aglomeracao', 'aglomeracao', 'amplo', 'autorizacao', 'consecutivo', 'decisao', 'economia', 'economia', 'economia', 'epicentro', 'fase', 'fase', 'fase', 'fase', 'fase', 'fase', 'fronteiro', 'funcionamento', 'infeccioso', 'instituto', 'integrant', 'limitacao', 'mandatario', 'periodo', 'periodo', 'planar', 'planar', 'preservar', 'prever', 'prever', 'quedo', 'reabertura', 'reabertura', 'reabrir', 'reabrir', 'reabrir', 'reabrir', 'recordar', 'regrar', 'reuniao', 'saudar', 'saudar', 'saudar', 'superar', 'universitario', 'velocidad', 'vetar', 'viagem', 'viagem']","[1, 2, 2, 1, 1, 1, 1, 3, 3, 3, 1, 6, 6, 6, 6, 6, 6, 1, 1, 1, 1, 1, 1, 1, 2, 2, 2, 2, 1, 2, 2, 1, 2, 2, 4, 4, 4, 4, 1, 1, 1, 3, 3, 3, 1, 1, 1, 1, 2, 2]","['circular', 'circular', 'crech', 'crech']","[2, 2, 2, 2]",50,4,54,1
3010,"['federar', 'possibilidad']","[1, 1]","[]","[]",2,0,2,1
3011,"['anvisa', 'anvisa', 'depoimento', 'instituto', 'vigilancia']","[2, 2, 1, 1, 1]","[]","[]",5,0,5,1
3015,"['medida', 'mexico', 'mexico', 'mexico', 'mexico', 'sendo']","[1, 4, 4, 4, 4, 1]","[]","[]",6,0,6,1
3016,"['condicao', 'diagnosticar', 'internar', 'kong', 'saudar', 'saudar', 'turista', 'viagem']","[1, 1, 1, 1, 2, 2, 1, 1]","[]","[]",8,0,8,1
3018,"['adhanom', 'aglomeracao', 'decorrencia', 'desafio', 'deslocamento', 'disseminacao', 'escassez', 'fornecimento', 'fornecimento', 'imunizacao', 'interrupcao', 'interrupcao', 'interrupcao', 'logistico', 'parceiro', 'prazo', 'previsao', 'reducao', 'respostar', 'sarampo', 'saudar', 'saudar', 'saudar', 'suspensao', 'tedro']","[1, 1, 1, 1, 1, 1, 1, 2, 2, 1, 3, 3, 3, 1, 1, 1, 1, 1, 1, 1, 3, 3, 3, 1, 1]","[]","[]",25,0,25,1
3020,"['crescimento', 'crise', 'economia', 'economia', 'periodo', 'periodo', 'ritmar', 'tendencia', 'trimestr']","[1, 1, 2, 2, 2, 2, 1, 1, 1]","[]","[]",9,0,9,1
3021,"['etapa', 'funcionamento', 'individuar', 'iniciativo', 'inovacao', 'inovacao', 'modelo', 'proposto', 'transferencia']","[1, 1, 1, 1, 2, 2, 1, 1, 1]","['inscricao', 'inscricao']","[2, 2]",9,2,11,1
3025,"['lancamento', 'minimizar', 'minimizar', 'normalment']","[1, 2, 2, 1]","['legendar']","[1]",4,1,5,1
3033,"['consorcio', 'correspondent', 'dosar', 'dosar', 'dosar', 'integro', 'levantamento', 'saudar', 'superar']","[1, 1, 3, 3, 3, 1, 1, 1, 1]","[]","[]",9,0,9,1
3034,"['condicao', 'internar', 'nelson']","[1, 1, 1]","[]","[]",3,0,3,1
3036,"['adversario', 'cenario', 'empatar', 'margem', 'margem']","[1, 1, 1, 2, 2]","[]","[]",5,0,5,1
3038,"['adulto', 'aplicacao', 'condicao', 'consequencia', 'crescimento', 'economia', 'especialment', 'opcao', 'preservar', 'reabrir', 'realizacao', 'reducao', 'reducao', 'significativo']","[1, 1, 1, 1, 1, 1, 1, 1, 1, 1, 1, 2, 2, 1]","['replicar']","[1]",14,1,15,1
3039,"['boletim', 'bruto', 'economia', 'economia', 'estimativo', 'expectativa', 'internar', 'pib', 'pib', 'previsao', 'previsao']","[1, 1, 2, 2, 1, 1, 1, 2, 2, 2, 2]","[]","[]",11,0,11,1
3043,"['destinar', 'reforcar']","[1, 1]","[]","[]",2,0,2,1
3044,"['autoridad', 'entregu', 'forcatarefa', 'normalment', 'respirador', 'respirador', 'respirador', 'respirador', 'respostar']","[1, 1, 1, 1, 4, 4, 4, 4, 1]","[]","[]",9,0,9,1
3046,"['decisao', 'disseminacao', 'domingo', 'domingo', 'gabinet', 'inicialment', 'ministrar', 'movimentacao', 'precedent', 'reuter']","[1, 1, 2, 2, 1, 1, 1, 1, 1, 1]","[]","[]",10,0,10,1
3047,"['adiamento', 'adicionar', 'aglomeracao', 'competicao', 'consequencia', 'coordenar', 'decisao', 'etapa', 'organizador', 'organizador']","[1, 1, 1, 1, 1, 1, 1, 1, 2, 2]","[]","[]",10,0,10,1
3050,"['absoluto', 'absoluto', 'calheiro', 'celso', 'celso', 'concedido', 'decisao', 'deltan', 'domingo', 'eventualment', 'mdbal', 'mello', 'ministrar', 'plantao', 'prescricao', 'punicao']","[2, 2, 1, 2, 2, 1, 1, 1, 1, 1, 1, 1, 1, 1, 1, 1]","[]","[]",16,0,16,1
3053,"['ausencia', 'decisao', 'diplomata', 'funcionamento', 'itamarati', 'posturar', 'posturar']","[1, 1, 1, 1, 1, 2, 2]","[]","[]",7,0,7,1
3057,"['aglomeracao', 'comissao', 'conformar', 'depoimento', 'imunizacao', 'inquerito', 'presenca', 'saudar']","[1, 1, 1, 1, 1, 1, 1, 1]","[]","[]",8,0,8,1
3058,"['dosar', 'importancia', 'imunizacao', 'imunizacao', 'respostar']","[1, 1, 2, 2, 1]","['imagem']","[1]",5,1,6,1
3061,"['equivalent', 'infectar', 'infectar', 'investigacao', 'levantamento', 'reportar', 'reportar', 'reportar', 'reportar', 'saudar', 'transmissao', 'transmissao', 'transmissao']","[1, 2, 2, 1, 1, 4, 4, 4, 4, 1, 3, 3, 3]","[]","[]",13,0,13,1
3062,"['anvisa', 'boletim', 'calculo', 'calculo', 'calculo', 'cenario', 'circulacao', 'colleg', 'consorcio', 'consorcio', 'diariament', 'distrito', 'enxergar', 'escassez', 'estabilidad', 'estatistico', 'estrategico', 'imunizacao', 'inconsistencia', 'informaco', 'informaco', 'instituto', 'margem', 'milho', 'none', 'none', 'none', 'none', 'none', 'none', 'obtido', 'painel', 'periodo', 'plantao', 'prazo', 'prioritario', 'quadro', 'recurso', 'relacao', 'risco', 'spaulo', 'tambem', 'tendencia', 'tendencia', 'ultimo']","[1, 1, 3, 3, 3, 1, 1, 1, 2, 2, 1, 1, 1, 1, 1, 1, 1, 1, 1, 2, 2, 1, 1, 1, 6, 6, 6, 6, 6, 6, 1, 1, 1, 1, 1, 1, 1, 1, 1, 1, 1, 1, 2, 2, 1]","[]","[]",45,0,45,1
3063,"['antonio', 'decisao', 'delacao', 'delacao', 'instituto', 'justicar', 'lavagem', 'ministrar', 'sentenca', 'suspeicao']","[1, 1, 2, 2, 1, 1, 1, 1, 1, 1]","['fingir']","[1]",10,1,11,1
3064,"['celebrar', 'infeccioso']","[1, 1]","['arvor', 'catedr', 'catolico', 'cristao', 'ganhar', 'imagem']","[1, 1, 1, 1, 1, 1]",2,6,8,1
3067,"['administrativo', 'associacao', 'boletim', 'bolsonarista', 'carat', 'cupula', 'domingo', 'domingo', 'entendimento', 'especialment', 'exministro', 'exministro', 'exministro', 'exministro', 'exministro', 'expectativa', 'integrant', 'internar', 'investigacao', 'justificativo', 'ministrar', 'ministrar', 'ministrar', 'notificar', 'notificar', 'oliveira', 'prazo', 'presenca', 'punicao', 'punicao', 'regulamentar', 'sancao', 'saudar', 'saudar', 'situacao', 'situacao', 'temor', 'viagem']","[1, 1, 1, 1, 1, 1, 2, 2, 1, 1, 5, 5, 5, 5, 5, 1, 1, 1, 1, 1, 3, 3, 3, 2, 2, 1, 1, 1, 2, 2, 1, 1, 2, 2, 2, 2, 1, 1]","['imagem']","[1]",38,1,39,1
3068,"['aglomeracao', 'alternativo', 'alternativo', 'alternativo', 'alunar', 'alunar', 'alunar', 'alunar', 'alunar', 'alunar', 'andrea', 'andrea', 'anuncio', 'anvisa', 'anvisa', 'assistenci', 'balancar', 'coletivo', 'comorbidad', 'comorbidad', 'comorbidad', 'condicao', 'condicao', 'condicao', 'contemplar', 'crise', 'decisao', 'decorrencia', 'desenvolvimento', 'desigualdad', 'disseminacao', 'entendimento', 'epidemiologico', 'equipamento', 'facilitar', 'fase', 'higienizacao', 'higienizacao', 'higienizacao', 'hipertensao', 'impactar', 'imunizacao', 'imunizacao', 'indicador', 'lavagem', 'necessario', 'necessario', 'necessario', 'necessidad', 'opcao', 'opcao', 'orientacao', 'parcelar', 'periodo', 'periodo', 'planar', 'planar', 'plano', 'positivar', 'possibilidad', 'possibilidad', 'presenciar', 'presenciar', 'presenciar', 'prioridad', 'privar', 'privar', 'privar', 'privar', 'quarentenar', 'quarentenar', 'quarentenar', 'rastreamento', 'reducao', 'regiao', 'resistencia', 'respiratorio', 'situacao', 'situacao', 'situacao', 'suspeito', 'transmissao', 'turma', 'turma', 'turma', 'turma', 'ventilacao', 'vulnerabilidad']","[1, 3, 3, 3, 6, 6, 6, 6, 6, 6, 2, 2, 1, 2, 2, 1, 1, 1, 3, 3, 3, 3, 3, 3, 1, 1, 1, 1, 1, 1, 1, 1, 1, 1, 1, 1, 3, 3, 3, 1, 1, 2, 2, 1, 1, 3, 3, 3, 1, 2, 2, 1, 1, 2, 2, 2, 2, 1, 1, 2, 2, 3, 3, 3, 1, 4, 4, 4, 4, 3, 3, 3, 1, 1, 1, 1, 1, 3, 3, 3, 1, 1, 4, 4, 4, 4, 1, 1]","['basto', 'compartilhar', 'compartilhar', 'crech', 'crech']","[1, 2, 2, 2, 2]",88,5,93,1
3069,"['amplo', 'autorizacao', 'autorizacao', 'desenvolvido', 'fase', 'fase', 'provisorio']","[1, 2, 2, 1, 2, 2, 1]","[]","[]",7,0,7,1
3070,"['academico', 'adiamento', 'anuncio', 'bandeirant', 'bruno', 'conjunto', 'oficialment', 'palacio', 'tambem', 'tambem']","[1, 1, 1, 1, 1, 1, 1, 1, 2, 2]","[]","[]",10,0,10,1
3072,"['prazo', 'saudar']","[1, 1]","[]","[]",2,0,2,1
3074,"['cronica', 'lesao', 'respiratorio']","[1, 1, 1]","[]","[]",3,0,3,1
3076,"['almeida', 'aprovacao', 'biliao', 'biliao', 'biliao', 'biliao', 'concorrent', 'emergenciai', 'fundacao', 'possibilidad', 'recurso', 'recurso', 'recurso', 'testagem']","[1, 1, 4, 4, 4, 4, 1, 1, 1, 1, 3, 3, 3, 1]","[]","[]",14,0,14,1
3079,"['comorbidad', 'infectar', 'intensivo', 'internacao', 'internar', 'internar', 'positivar', 'semestr', 'suportar']","[1, 1, 1, 1, 2, 2, 1, 1, 1]","[]","[]",9,0,9,1
3082,"['aplicacao', 'dosar', 'dosar', 'imunizacao', 'normalment', 'prever', 'saudar', 'suspenso']","[1, 2, 2, 1, 1, 1, 1, 1]","[]","[]",8,0,8,1
3085,"['academiar', 'academiar', 'academiar', 'academiar', 'academiar', 'ambientar', 'ambientar', 'ambientar', 'associacao', 'flexibilizacao', 'rigoroso', 'risco']","[5, 5, 5, 5, 5, 3, 3, 3, 1, 1, 1, 1]","[]","[]",12,0,12,1
3089,"['andrew', 'arrecadacao', 'arrecadar', 'consultoria', 'distrito', 'esquema', 'fronteiro', 'fronteiro', 'mexico', 'motivacao', 'pslsp', 'recurso', 'recurso']","[1, 1, 1, 1, 1, 1, 2, 2, 1, 1, 1, 2, 2]","['enganar', 'falsar', 'fraudar', 'fraudar']","[1, 1, 2, 2]",13,4,17,1
3095,"['augusto', 'gabinet', 'heleno', 'inovacao', 'ministrar', 'ministrar', 'ministrar', 'ministrar', 'positivar', 'positivar']","[1, 1, 1, 1, 4, 4, 4, 4, 2, 2]","[]","[]",10,0,10,1
3097,"['crise', 'impactar', 'quedo', 'transmissao']","[1, 1, 1, 1]","[]","[]",4,0,4,1
3102,"['apreensao', 'apreensao', 'apurar', 'bolsonarista', 'deflagrar', 'inquerito', 'inquerito', 'interlocutor', 'ministrar', 'palacio', 'planalto', 'supremo']","[2, 2, 1, 1, 1, 2, 2, 1, 1, 1, 1, 1]","[]","[]",12,0,12,1
3103,"['crise', 'infectar', 'iniciativo', 'republico', 'saudar']","[1, 1, 1, 1, 1]","['escutar', 'ganhar']","[1, 1]",5,2,7,1
3105,"['aprovacao', 'avancar', 'colunista', 'congresso', 'martim', 'privar', 'saudar', 'tramitar', 'vieira', 'vieira']","[1, 1, 1, 1, 1, 1, 1, 1, 2, 2]","[]","[]",10,0,10,1
3108,"['associacao', 'colaboracao', 'consumidor', 'decisao', 'fluxo', 'impacto', 'prazo', 'prorrogar']","[1, 1, 1, 1, 1, 1, 1, 1]","[]","[]",8,0,8,1
3109,"['expansao', 'recurso', 'transferencia', 'transferir']","[1, 1, 1, 1]","[]","[]",4,0,4,1
3110,"['calendario', 'correspondent', 'crise', 'equivalent', 'mudanca', 'necessario', 'proposto', 'provisorio', 'recurso', 'reducao', 'reducao', 'reducao', 'suspensao', 'suspensao', 'suspensao']","[1, 1, 1, 1, 1, 1, 1, 1, 1, 3, 3, 3, 3, 3, 3]","['sacar', 'sacar', 'sacar', 'sacar', 'sacar', 'sacar']","[6, 6, 6, 6, 6, 6]",15,6,21,1
3111,"['adicionar', 'anteriorment', 'aumento', 'companhia', 'companhia', 'demandar', 'estimativo', 'instalacao', 'logistico']","[1, 1, 1, 2, 2, 1, 1, 1, 1]","['preencher']","[1]",9,1,10,1
3113,"['esquema', 'flavio', 'flavio', 'flavio']","[1, 3, 3, 3]","[]","[]",4,0,4,1
3115,"['condenacao', 'corpu', 'corpu', 'dificuldad', 'divergencia', 'exjuiz', 'habea', 'habea', 'julgamento', 'ministrar', 'ministrar', 'parceiro', 'processo', 'supremo', 'suspeicao', 'suspeicao', 'suspeicao', 'turma']","[1, 2, 2, 1, 1, 1, 2, 2, 1, 2, 2, 1, 1, 1, 3, 3, 3, 1]","[]","[]",18,0,18,1
3116,"['crise', 'expectativa', 'plano', 'previsao', 'reuniao', 'saudar', 'treinar']","[1, 1, 1, 1, 1, 1, 1]","['vazio']","[1]",7,1,8,1
3119,"['consecutivo', 'economia', 'gued', 'gued', 'ministrar', 'pastar', 'reuniao']","[1, 1, 2, 2, 1, 1, 1]","[]","[]",7,0,7,1
3120,"['aumento', 'consumidor', 'consumidor', 'demanda', 'desafio', 'economia', 'economia', 'economia', 'estimular', 'expectativa', 'preocupacao', 'recuperacao', 'recuperacao', 'recuperacao', 'recuperacao', 'semestr', 'surto', 'tambem', 'tambem', 'temor']","[1, 2, 2, 1, 1, 3, 3, 3, 1, 1, 1, 4, 4, 4, 4, 1, 1, 2, 2, 1]","['ampla']","[1]",20,1,21,1
3121,"['equipamento', 'especifico', 'examinar']","[1, 1, 1]","['pelar']","[1]",3,1,4,1
3122,"['espirito', 'europeu', 'folhar', 'instituto', 'positivar', 'positivar', 'saudar', 'suspeito', 'suspeito', 'viagem']","[1, 1, 1, 1, 2, 2, 1, 2, 2, 1]","['garganta']","[1]",10,1,11,1
3123,"['decisao', 'demandar', 'enfrentamento', 'especialment', 'fundacao', 'habitant', 'importancia', 'instituto', 'intensivo', 'isolar', 'oswaldo', 'reforcar', 'saudar', 'saudar', 'saudar']","[1, 1, 1, 1, 1, 1, 1, 1, 1, 1, 1, 1, 3, 3, 3]","['compartilhar', 'compartilhar']","[2, 2]",15,2,17,1
3124,"['adulto', 'bandeirant', 'bruno', 'determinacao', 'fez', 'palacio', 'proprio', 'reabertura', 'relacao', 'sindicato', 'tambem', 'vigilancia']","[1, 1, 1, 1, 1, 1, 1, 1, 1, 1, 1, 1]","[]","[]",12,0,12,1
3125,"['adiamento', 'concessionario', 'concessionario', 'concessionario', 'concessionario', 'condicao', 'dialogo', 'entendimento', 'entendimento', 'inicialment', 'reajustar', 'reajustar', 'reajustar', 'reajustar', 'situacao']","[1, 4, 4, 4, 4, 1, 1, 2, 2, 1, 4, 4, 4, 4, 1]","[]","[]",15,0,15,1
3126,"['comparacao', 'consorcio', 'crescimento', 'justicar', 'levantamento', 'saudar']","[1, 1, 1, 1, 1, 1]","[]","[]",6,0,6,1
3127,"['apurar', 'depoimento', 'exministro', 'inquerito', 'inquerito', 'justicar', 'justicar', 'justicar', 'ministrar', 'segredar', 'supremo', 'tramitar']","[1, 1, 1, 2, 2, 3, 3, 3, 1, 1, 1, 1]","[]","[]",12,0,12,1
3129,"['complicacao', 'decorrencia', 'internar', 'regiao', 'sabado']","[1, 1, 1, 1, 1]","['compartilhar']","[1]",5,1,6,1
3130,"['alerj', 'alteracao', 'alteracao', 'crise', 'expectativa', 'federar', 'iniciativo', 'iniciativo', 'legislativo', 'periodo', 'recurso', 'recurso', 'respirador', 'respirador', 'respirador', 'transferencia', 'ufrj', 'ufrj', 'ufrj']","[1, 2, 2, 1, 1, 1, 2, 2, 1, 1, 2, 2, 3, 3, 3, 1, 3, 3, 3]","[]","[]",19,0,19,1
3131,"['absoluto', 'aspecto', 'cenario', 'conjuntar', 'consistencia', 'crise', 'crise', 'decisao', 'desafiar', 'dificuldad', 'dificultar', 'disseminacao', 'distrito', 'instituto', 'integrant', 'mergulhar', 'monitoramento', 'painel', 'pastar', 'prazo', 'projeco', 'projeco', 'realizacao', 'ribeiro', 'saudar', 'saudar', 'saudar', 'situacao', 'situacao', 'situacao', 'suspeito', 'teich', 'vulneravel']","[1, 1, 1, 1, 1, 2, 2, 1, 1, 1, 1, 1, 1, 1, 1, 1, 1, 1, 1, 1, 2, 2, 1, 1, 3, 3, 3, 3, 3, 3, 1, 1, 1]","['verdadeiro']","[1]",33,1,34,1
3132,"['anvisa', 'aprovacao', 'autorizacao', 'desenvolvido', 'exigencia', 'importacao', 'instituto', 'lewandowski', 'ministrar', 'ministrar', 'prazo', 'prazo', 'ricardo', 'sputnik', 'sputnik', 'supremo', 'vigilancia']","[1, 1, 1, 1, 1, 1, 1, 1, 2, 2, 2, 2, 1, 2, 2, 1, 1]","[]","[]",17,0,17,1
3137,"['distant', 'quilometro']","[1, 1]","[]","[]",2,0,2,1
3138,"['cilindro', 'dedicar', 'ibg', 'ibg', 'logistico', 'oliveira']","[1, 1, 2, 2, 1, 1]","[]","[]",6,0,6,1
3140,"['carla', 'espanha', 'folhar', 'folhar', 'inglaterra', 'merkel', 'necessidad', 'parceria', 'primeiroministro', 'primeiroministro', 'reabertura', 'sabatino', 'spaulo']","[1, 1, 2, 2, 1, 1, 1, 1, 2, 2, 1, 1, 1]","[]","[]",13,0,13,1
3141,"['comportamento', 'consecutivo', 'consorcio', 'estabilidad', 'estabilidad', 'feriar', 'observar', 'obtido', 'quedo', 'saudar', 'saudar', 'tendencia', 'tendencia', 'variacao']","[1, 1, 1, 2, 2, 1, 1, 1, 1, 2, 2, 2, 2, 1]","[]","[]",14,0,14,1
3144,"['autoridad', 'desenvolvimento', 'parceiro', 'recurso', 'saudar', 'saudar', 'saudar']","[1, 1, 1, 1, 3, 3, 3]","[]","[]",7,0,7,1
3146,"['quarentenar']","[1]","[]","[]",1,0,1,1
3147,"['avancar', 'crise', 'desembarcar', 'desgastar', 'estrategia', 'henriqu', 'ministrar', 'ministrar', 'nelson', 'palacio', 'planalto', 'saudar', 'teich']","[1, 1, 1, 1, 1, 1, 2, 2, 1, 1, 1, 1, 1]","[]","[]",13,0,13,1
3149,"['afp', 'autoridad', 'comissao', 'diagnosticar', 'epicentro', 'epidemiar', 'expansao', 'hubei', 'provincia', 'regiao', 'ritmar', 'saudar', 'saudar', 'surtir', 'vespera']","[1, 1, 1, 1, 1, 1, 1, 1, 1, 1, 1, 2, 2, 1, 1]","[]","[]",15,0,15,1
3150,"['aprovacao', 'estrategia', 'internacao', 'internacao', 'precisao', 'reducao', 'saudar', 'saudar', 'saudar', 'saudar', 'saudar', 'saudar', 'saudar', 'saudar', 'saudar', 'saudar', 'saudar', 'saudar']","[1, 1, 2, 2, 1, 1, 12, 12, 12, 12, 12, 12, 12, 12, 12, 12, 12, 12]","['circular']","[1]",18,1,19,1
3155,"['contagioso', 'economia', 'feriar', 'feriar', 'merkel', 'merkel', 'prorrogar', 'reabertura']","[1, 1, 2, 2, 2, 2, 1, 1]","[]","[]",8,0,8,1
3156,"['ansiedad', 'cenario', 'cenario', 'consequencia', 'desigualdad', 'impacto', 'periferia', 'periferia', 'quadro', 'quarentenar', 'saudar']","[1, 2, 2, 1, 1, 1, 2, 2, 1, 1, 1]","[]","[]",11,0,11,1
3157,"['assistencia', 'congresso', 'folhar', 'folhar', 'operacionalizacao', 'pagamento', 'pagamento', 'pagamento', 'pastar', 'possibilidad', 'temporariament', 'transferencia']","[1, 1, 2, 2, 1, 3, 3, 3, 1, 1, 1, 1]","[]","[]",12,0,12,1
3160,"['enfermagem', 'internar', 'saudar']","[1, 1, 1]","[]","[]",3,0,3,1
3161,"['anuncio', 'anvisa', 'anvisa', 'avancar', 'conformar', 'desenvolvimento', 'etapa', 'fase', 'jorg', 'necessario', 'realizacao', 'saudar', 'sputnik', 'vigilancia']","[1, 2, 2, 1, 1, 1, 1, 1, 1, 1, 1, 1, 1, 1]","[]","[]",14,0,14,1
3163,"['amplo', 'avancar', 'companhia', 'estagio', 'fase', 'fase', 'moderno', 'moderno']","[1, 1, 1, 1, 2, 2, 2, 2]","[]","[]",8,0,8,1
3168,"['administrativo', 'aplicacao', 'autorizacao', 'cenario', 'decisao', 'decisao', 'descumprimento', 'enfrentamento', 'flexibilizacao', 'flexibilizacao', 'flexibilizacao', 'fluminens', 'forcatarefa', 'funcionamento', 'justicar', 'justicar', 'mprj', 'planar', 'presenciar', 'reabertura', 'regrar']","[1, 1, 1, 1, 2, 2, 1, 1, 3, 3, 3, 1, 1, 1, 2, 2, 1, 1, 1, 1, 1]","['amplament']","[1]",21,1,22,1
3169,"['administrativo', 'antecipar', 'comissao', 'conformar', 'correspondent', 'decisao', 'demandar', 'descumprir', 'esforco', 'funcionamento', 'intensivo', 'ministrar', 'ministrar', 'ministrar', 'ministrar', 'necessario', 'necessario', 'orientacao', 'orientacao', 'pagamento', 'pagamento', 'pastar', 'recurso', 'recurso', 'saudar', 'saudar', 'supremo']","[1, 1, 1, 1, 1, 1, 1, 1, 1, 1, 1, 4, 4, 4, 4, 2, 2, 2, 2, 2, 2, 1, 2, 2, 2, 2, 1]","[]","[]",27,0,27,1
3172,"['arthur', 'atuacao', 'bandeirant', 'congresso', 'decisao', 'demrj', 'desembarcar', 'jantar', 'lira', 'orientacao', 'palacio', 'ppal', 'reuniao', 'rossi']","[1, 1, 1, 1, 1, 1, 1, 1, 1, 1, 1, 1, 1, 1]","['legendar']","[1]",14,1,15,1
3173,"['fabricio', 'fabricio', 'fabricio', 'fabricio', 'flavio', 'painel', 'palacio', 'planalto', 'previsto', 'queiroz', 'queiroz', 'queiroz', 'queiroz', 'republicanosrj']","[4, 4, 4, 4, 1, 1, 1, 1, 1, 4, 4, 4, 4, 1]","['protestar']","[1]",14,1,15,1
3176,"['comportamento', 'embora', 'infeccioso', 'mutacao']","[1, 1, 1, 1]","[]","[]",4,0,4,1
3177,"['administrativo', 'economia', 'gued', 'privatizacao', 'privatizacao', 'proposto', 'reducao', 'republico', 'servidor']","[1, 1, 1, 2, 2, 1, 1, 1, 1]","[]","[]",9,0,9,1
3182,"['destinar', 'domingo', 'espanha', 'espanha', 'fronteiro', 'fronteiro', 'normalidad', 'quilometro', 'reabertura', 'turista', 'turistico']","[1, 1, 2, 2, 2, 2, 1, 1, 1, 1, 1]","[]","[]",11,0,11,1
3183,"['alternativo', 'atuam', 'client', 'companhia', 'companhia', 'companhia', 'companhia', 'decorrencia', 'descumprimento', 'dificuldad', 'oferecido', 'oficio', 'oficio', 'operacionalizacao', 'passageiro', 'passageiro', 'passageiro', 'periodo', 'prazo', 'prazo', 'prazo', 'provisorio', 'regrar', 'respostar', 'viagem', 'voo']","[1, 1, 1, 4, 4, 4, 4, 1, 1, 1, 1, 2, 2, 1, 3, 3, 3, 1, 3, 3, 3, 1, 1, 1, 1, 1]","[]","[]",26,0,26,1
3184,"['aurelio', 'manutencao', 'mello', 'pedido', 'prazo', 'supremo']","[1, 1, 1, 1, 1, 1]","[]","[]",6,0,6,1
3185,"['ambientar', 'ambientar', 'infectar', 'infectar', 'infectar', 'portavoz', 'respiratorio', 'respostar', 'reuter', 'saudar', 'transmissao']","[2, 2, 3, 3, 3, 1, 1, 1, 1, 1, 1]","['espalhar', 'espalhar']","[2, 2]",11,2,13,1
3189,"['henriqu', 'integrant', 'ministrar', 'ministrar', 'oliveira']","[1, 1, 2, 2, 1]","[]","[]",5,0,5,1
3192,"['adotada', 'autoridad', 'calendario', 'estrategia', 'lavagem', 'risco', 'risco', 'sabado', 'sarampo']","[1, 1, 1, 1, 1, 2, 2, 1, 1]","[]","[]",9,0,9,1
3193,"['airlin', 'coreia', 'coreia', 'diagnosticar', 'escalar', 'examinar', 'observacao', 'passageiro', 'positivar', 'preocupacao', 'propagacao', 'respiratorio', 'tripulacao']","[1, 2, 2, 1, 1, 1, 1, 1, 1, 1, 1, 1, 1]","[]","[]",13,0,13,1
3194,"['ambientar', 'ambientar', 'ambientar', 'atuacao', 'comissao', 'compilar', 'congresso', 'consultoria', 'destinar', 'destinar', 'destinar', 'economia', 'emendar', 'emendar', 'integro', 'ministrar', 'orcamentaria', 'pastar', 'ricardo', 'sall', 'tramitacao']","[3, 3, 3, 1, 1, 1, 1, 1, 3, 3, 3, 1, 2, 2, 1, 1, 1, 1, 1, 1, 1]","[]","[]",21,0,21,1
3195,"['aprovacao', 'atrair', 'congresso', 'constituicao', 'constituicao', 'constituicao', 'constituicao', 'constituicao', 'emendar', 'interlocutor', 'necessario', 'planalto', 'proposto', 'proposto', 'realizacao', 'ricardo', 'ricardo', 'ricardo']","[1, 1, 1, 5, 5, 5, 5, 5, 1, 1, 1, 1, 2, 2, 1, 3, 3, 3]","[]","[]",18,0,18,1
3198,"['balancar', 'sabado', 'saudar']","[1, 1, 1]","[]","[]",3,0,3,1
3201,"['client', 'decisao', 'decisao', 'fase', 'fase', 'funcionamento', 'fux', 'justicar', 'justicar', 'ministrar', 'proferir', 'provisorio', 'regiao', 'sindicato', 'supremo']","[1, 2, 2, 2, 2, 1, 1, 2, 2, 1, 1, 1, 1, 1, 1]","[]","[]",15,0,15,1
3203,"['abordagem', 'abordagem', 'abordagem', 'abordagem', 'acompanhamento', 'almeida', 'almeida', 'ansiedad', 'ansiedad', 'associacao', 'caxia', 'comparacao', 'comportament', 'comportamento', 'converso', 'depressao', 'depressao', 'duqu', 'especializar', 'flavia', 'normalment', 'oferecido', 'psicologo', 'psicologo', 'psicologo', 'recuperacao', 'respectivament', 'saudar', 'saudar', 'saudar', 'saudar', 'saudar', 'sessao', 'sessao']","[4, 4, 4, 4, 1, 2, 2, 2, 2, 1, 1, 1, 1, 1, 1, 2, 2, 1, 1, 1, 1, 1, 3, 3, 3, 1, 1, 5, 5, 5, 5, 5, 2, 2]","['basto', 'canadens']","[1, 1]",34,2,36,1
3205,"['afetado', 'apreensao', 'competicao', 'confederacao', 'consenso', 'deslocamento', 'escalar', 'fronteiro', 'fronteiro', 'oficialment', 'prazo', 'preocupacao', 'respostar', 'tornear']","[1, 1, 1, 1, 1, 1, 1, 2, 2, 1, 1, 1, 1, 1]","['libertador', 'libertador', 'patrocinador']","[2, 2, 1]",14,3,17,1
3207,"[]","[]","['chorar']","[1]",0,1,1,1
3209,"['amplo', 'atuacao', 'atuacao', 'avancar', 'cnj', 'destacar', 'humberto', 'investigacao', 'jornada', 'justicar', 'justicar', 'martim', 'martim', 'martim', 'ministrar', 'ministrar', 'presidir', 'regiao', 'suspeito', 'varar']","[1, 2, 2, 1, 1, 1, 1, 1, 1, 2, 2, 3, 3, 3, 2, 2, 1, 1, 1, 1]","['espalhar', 'mentiroso']","[1, 1]",20,2,22,1
3210,"['cenario', 'desafio', 'exministro', 'exprefeito', 'painel', 'parceria']","[1, 1, 1, 1, 1, 1]","[]","[]",6,0,6,1
3211,"['antonio', 'antonio', 'decorrent', 'descumprimento', 'descumprir', 'inquerito', 'investigacao', 'ministrar', 'ministrar', 'preventivo', 'provisorio', 'quarentenar', 'sabado', 'supremo', 'transferir']","[2, 2, 1, 1, 1, 1, 1, 2, 2, 1, 1, 1, 1, 1, 1]","['protestar']","[1]",15,1,16,1
3212,"['aliquota', 'bruto', 'congresso', 'congresso', 'contemplar', 'contribuicao', 'folhar', 'folhar', 'pagamento', 'pagamento', 'prorrogacao', 'prorrogar', 'vetar', 'vetar', 'vetar']","[1, 1, 2, 2, 1, 1, 2, 2, 2, 2, 1, 1, 3, 3, 3]","[]","[]",15,0,15,1
3215,"['anvisa', 'autoridad', 'fase', 'fase', 'sputnik', 'sputnik', 'testagem', 'vigilancia']","[1, 1, 2, 2, 2, 2, 1, 1]","[]","[]",8,0,8,1
3216,"['consequencia', 'epicentro', 'epidemiar', 'prever', 'surtir']","[1, 1, 1, 1, 1]","['realment', 'realment']","[2, 2]",5,2,7,1
3218,"[]","[]","[]","[]",0,0,0,1
3220,"['congresso', 'crescimento', 'estrategia', 'ministrar', 'ministrar', 'ministrar', 'plano', 'privatizacao', 'privatizacao', 'regiao']","[1, 1, 1, 3, 3, 3, 1, 2, 2, 1]","[]","[]",10,0,10,1
3222,"['afp', 'colombio', 'economia', 'economia', 'economia', 'economia', 'mexico', 'perspectivo', 'pib', 'pib', 'quedo', 'quedo', 'quedo', 'quedo', 'recuperacao', 'regiao', 'saudar']","[1, 1, 4, 4, 4, 4, 1, 1, 2, 2, 4, 4, 4, 4, 1, 1, 1]","[]","[]",17,0,17,1
3225,"['consolidar', 'consolidar', 'consorcio', 'decisao', 'distrito', 'folhar', 'inedito', 'iniciativo', 'levantamento', 'necessario', 'obtido', 'parceria', 'parceria', 'positivar', 'respostar', 'saudar', 'spaulo', 'spaulo']","[2, 2, 1, 1, 1, 1, 1, 1, 1, 1, 1, 2, 2, 1, 1, 1, 2, 2]","[]","[]",18,0,18,1
3226,"['acordo', 'journal', 'tambem', 'transmissao']","[1, 1, 1, 1]","[]","[]",4,0,4,1
3227,"['antecipar', 'aprovacao', 'decisao', 'journal', 'passageiro', 'periodo', 'recuar', 'volumar', 'voo', 'voo']","[1, 1, 1, 1, 1, 1, 1, 1, 2, 2]","['circular']","[1]",10,1,11,1
3229,"['aplicacao', 'contemplar', 'etapa', 'etapa', 'imunizacao', 'privar', 'publicoalvo', 'regiao', 'saudar', 'saudar']","[1, 1, 2, 2, 1, 1, 1, 1, 2, 2]","['espalhar']","[1]",10,1,11,1
3231,"['acompanhamento', 'circulacao', 'descumprir', 'epidemiologico', 'necessario', 'saudar', 'suspeito', 'suspeito', 'suspeito', 'suspeito', 'testagem', 'vigilancia', 'vigilancia']","[1, 1, 1, 1, 1, 1, 4, 4, 4, 4, 1, 2, 2]","[]","[]",13,0,13,1
3232,"['comparacao', 'consequencia', 'crescimento', 'deteccao', 'reabertura']","[1, 1, 1, 1, 1]","[]","[]",5,0,5,1
3233,"['confederacao', 'desenvolvimento', 'economia', 'especialment', 'exercicio', 'federar', 'federar', 'federar', 'mudanca', 'orcamentaria', 'prazo', 'prazo', 'prazo', 'recurso', 'relativo', 'saudar', 'saudar', 'saudar', 'saudar', 'saudar', 'saudar', 'situacao', 'situacao', 'suspensao', 'transferencia', 'transferencia']","[1, 1, 1, 1, 1, 3, 3, 3, 1, 1, 3, 3, 3, 1, 1, 6, 6, 6, 6, 6, 6, 2, 2, 1, 2, 2]","[]","[]",26,0,26,1
3235,"['assistencia', 'assistencia', 'assistencia', 'conformar', 'desembarcar', 'dificuldad', 'dificuldad', 'distrito', 'enfrentamento', 'enfrentamento', 'equipamento', 'equipamento', 'equipamento', 'equipamento', 'estrategico', 'infectar', 'infectar', 'pulmonar', 'pulmonar', 'pulmonar', 'pulmonar', 'reforcar', 'reforcar', 'respiratorio', 'respiratorio', 'saudar', 'saudar', 'saudar', 'saudar', 'saudar', 'saudar', 'suportar', 'transmissao', 'velocidad', 'ventilador', 'ventilador', 'ventilador', 'ventilador', 'ventilador', 'ventilatorio']","[3, 3, 3, 1, 1, 2, 2, 1, 2, 2, 4, 4, 4, 4, 1, 2, 2, 4, 4, 4, 4, 2, 2, 2, 2, 6, 6, 6, 6, 6, 6, 1, 1, 1, 5, 5, 5, 5, 5, 1]","['ganhar']","[1]",40,1,41,1
3236,"['assintomatico', 'coordenar', 'especifico', 'mantido', 'observacao', 'periodo', 'quarentenar', 'quarentenar', 'quarentenar', 'saudar', 'treinamento']","[1, 1, 1, 1, 1, 1, 3, 3, 3, 1, 1]","[]","[]",11,0,11,1
3239,"['ambientar', 'crise', 'especialment', 'mudanca', 'parceria', 'presenca']","[1, 1, 1, 1, 1, 1]","['arvor', 'protestar', 'protestar', 'protestar', 'protestar']","[1, 4, 4, 4, 4]",6,5,11,1
3240,"['adotada', 'aurelio', 'concedido', 'consolidar', 'decisao', 'decisao', 'fux', 'fux', 'fux', 'mello', 'mello', 'ministrar', 'ministrar', 'pratico', 'recurso', 'sessao', 'supremo', 'supremo', 'suspensao', 'suspensao', 'temor', 'temor']","[1, 1, 1, 1, 2, 2, 3, 3, 3, 2, 2, 2, 2, 1, 1, 1, 2, 2, 2, 2, 2, 2]","[]","[]",22,0,22,1
3241,"['complicacao', 'dedicar', 'heleno', 'intensivo', 'internar', 'universitario']","[1, 1, 1, 1, 1, 1]","[]","[]",6,0,6,1
3242,"['autoridad', 'autoridad', 'pfizerbiontech']","[2, 2, 1]","[]","[]",3,0,3,1
3244,"['administrativo', 'administrativo', 'administrativo', 'congresso', 'decisao', 'economia', 'gued', 'ministrar', 'proposto', 'proposto', 'regrar', 'republico', 'reuniao', 'servidor', 'servidor', 'servidor']","[3, 3, 3, 1, 1, 1, 1, 1, 2, 2, 1, 1, 1, 3, 3, 3]","[]","[]",16,0,16,1
3248,"['fluminens', 'transmissao']","[1, 1]","['implantar']","[1]",2,1,3,1
3252,"['aglomeracao', 'avancar', 'comportamento', 'comportamento', 'dificuldad', 'estatistico', 'souza', 'souza', 'souza']","[1, 1, 2, 2, 1, 1, 3, 3, 3]","[]","[]",9,0,9,1
3256,"['alteracao', 'destinar', 'distrito', 'dosar', 'esquema', 'fase', 'fluxo', 'igualitario', 'instituto', 'necessario', 'operacionalizacao', 'pastar', 'periodo', 'planar', 'previsao', 'publicoalvo', 'saudar', 'saudar']","[1, 1, 1, 1, 1, 1, 1, 1, 1, 1, 1, 1, 1, 1, 1, 1, 2, 2]","[]","[]",18,0,18,1
3257,"['hospitalizar', 'possibilidad', 'transmissao', 'transmissao', 'transmissao']","[1, 1, 3, 3, 3]","[]","[]",5,0,5,1
3258,"['importancia', 'orientacao', 'preliminar', 'publicoalvo', 'saudar', 'saudar', 'transmissao']","[1, 1, 1, 1, 2, 2, 1]","[]","[]",7,0,7,1
3259,"['companhia', 'economia', 'equivalent', 'europeu', 'plano', 'proposto', 'sustentabilidad']","[1, 1, 1, 1, 1, 1, 1]","['desligar']","[1]",7,1,8,1
3261,"['justicar', 'republico']","[1, 1]","[]","[]",2,0,2,1
3263,"['chefiar', 'exministro', 'exonerar', 'justicar', 'justicar', 'ramagem', 'ramagem', 'ramagem', 'ramagem', 'sabado']","[1, 1, 1, 2, 2, 4, 4, 4, 4, 1]","['amigar']","[1]",10,1,11,1
3264,"['mexico', 'quarentenar', 'republico', 'viagem', 'voo', 'voo']","[1, 1, 1, 1, 2, 2]","['espalhar']","[1]",6,1,7,1
3267,"['henriqu', 'nelson', 'reforcar', 'saudar', 'substituto', 'teich']","[1, 1, 1, 1, 1, 1]","[]","[]",6,0,6,1
3269,"['compromisso', 'condicao', 'crise', 'cupula', 'cupula', 'definitivo', 'esperancar', 'inclusao', 'itamarati', 'organizador', 'piorar', 'preservacao', 'provisorio', 'reducao', 'reuniao', 'situacao']","[1, 1, 1, 2, 2, 1, 1, 1, 1, 1, 1, 1, 1, 1, 1, 1]","['parir']","[1]",16,1,17,1
3275,"['anvisa', 'anvisa', 'anvisa', 'desenvolvido', 'impactar', 'normalment', 'parceria', 'possibilidad', 'prever', 'proposto', 'vigilancia']","[3, 3, 3, 1, 1, 1, 1, 1, 1, 1, 1]","[]","[]",11,0,11,1
3276,"['flavio', 'flavio', 'rachadinha', 'ramagem', 'ramagem', 'ramagem', 'republicanosrj', 'reuter', 'servidor']","[2, 2, 1, 3, 3, 3, 1, 1, 1]","['falsar']","[1]",9,1,10,1
3278,"['afp', 'compromisso', 'compromisso', 'compromisso', 'condicao', 'consumidor', 'contemplar', 'fronteiro', 'funcionamento', 'pratico', 'proliferacao']","[1, 3, 3, 3, 1, 1, 1, 1, 1, 1, 1]","['enganoso']","[1]",11,1,12,1
3280,"['desenvolvido', 'periodo', 'primeiroministro', 'regiao']","[1, 1, 1, 1]","['secreto']","[1]",4,1,5,1
3281,"['apurar', 'barroso', 'colegiado', 'comissao', 'comissao', 'concreto', 'curvo', 'curvo', 'decisao', 'demmg', 'discussao', 'enfrentamento', 'enfrentamento', 'enfrentamento', 'estabilidad', 'funcionamento', 'inquerito', 'ministrar', 'pacheco', 'pacheco', 'pacheco', 'pacheco', 'reforcar', 'supremo']","[1, 1, 1, 2, 2, 1, 2, 2, 1, 1, 1, 3, 3, 3, 1, 1, 1, 1, 4, 4, 4, 4, 1, 1]","[]","[]",24,0,24,1
3283,"['balancar', 'consorcio', 'domingo', 'superar', 'variacao', 'variacao']","[1, 1, 1, 1, 2, 2]","[]","[]",6,0,6,1
3285,"['economia', 'equilibrio', 'espanha', 'espanha', 'funcionamento', 'isolar', 'reabrir', 'regiao', 'sabado', 'surto', 'surto', 'temor', 'viagem']","[1, 1, 2, 2, 1, 1, 1, 1, 1, 2, 2, 1, 1]","[]","[]",13,0,13,1
3286,"['afp', 'autoridad', 'concorrent', 'dedicar', 'fornecimento', 'instalacao', 'sabado']","[1, 1, 1, 1, 1, 1, 1]","[]","[]",7,0,7,1
3291,"['ribeiro']","[1]","[]","[]",1,0,1,1
3294,"['contagioso', 'epidemiar', 'epidemiar', 'epidemiar', 'necessario', 'republico', 'taxar']","[1, 3, 3, 3, 1, 1, 1]","[]","[]",7,0,7,1
3295,"['aglomeracao', 'argumentar', 'consumidor', 'consumidor', 'descumprir', 'importancia', 'infectar', 'justificativo', 'legislativo', 'prever', 'proposto']","[1, 1, 2, 2, 1, 1, 1, 1, 1, 1, 1]","['ganhar']","[1]",11,1,12,1
3296,"['colunista', 'colunista', 'ministrar', 'nelson', 'saudar', 'teich', 'teich']","[2, 2, 1, 1, 1, 2, 2]","[]","[]",7,0,7,1
3300,"['comissao', 'comissao', 'congresso', 'forcatarefa', 'inquerito', 'instaurar', 'investigacao', 'justicar', 'ministrar', 'ministrar', 'pagamento', 'pagamento', 'pratico', 'tcu']","[2, 2, 1, 1, 1, 1, 1, 1, 2, 2, 2, 2, 1, 1]","[]","[]",14,0,14,1
3301,"['agravar', 'associacao', 'consequencia', 'enfermagem', 'hospitalizacao', 'indicador', 'intensivo', 'intensivo', 'intensivo', 'jornada', 'observar', 'situacao', 'taxar']","[1, 1, 1, 1, 1, 1, 3, 3, 3, 1, 1, 1, 1]","[]","[]",13,0,13,1
3305,"['colaboracao', 'decisao', 'delacao', 'fluminens', 'integro', 'preventivo', 'proferir', 'provisorio', 'recurso', 'varar']","[1, 1, 1, 1, 1, 1, 1, 1, 1, 1]","[]","[]",10,0,10,1
3307,"['isolar', 'positivar', 'rocha']","[1, 1, 1]","['imagem']","[1]",3,1,4,1
3308,"['araujo', 'araujo', 'carla', 'colunista']","[2, 2, 1, 1]","[]","[]",4,0,4,1
3319,"['calendario', 'calendario', 'emprestimo', 'fluminens', 'fluminens', 'henriqu', 'mudanca', 'reforcar', 'semestr', 'temporada']","[2, 2, 1, 2, 2, 1, 1, 1, 1, 1]","[]","[]",10,0,10,1
3322,"['decisao', 'desenvolvimento', 'enfrentamento', 'globonew', 'metropolitano', 'necessario', 'regiao', 'reuniao', 'sabado', 'situacao']","[1, 1, 1, 1, 1, 1, 1, 1, 1, 1]","[]","[]",10,0,10,1
3323,"['apreensao', 'apreensao', 'contabilizar', 'folhar', 'integro', 'irregularidad', 'justicar', 'temporario', 'temporario']","[2, 2, 1, 1, 1, 1, 1, 2, 2]","[]","[]",9,0,9,1
3324,"['celebrar', 'comorbidad', 'diagnosticar', 'diagnosticar', 'esperancar', 'internacao', 'intubacao', 'isolar', 'necessario', 'pereira', 'recuperacao', 'saudar', 'saudar', 'servidor', 'sessao', 'suspenso']","[1, 1, 2, 2, 1, 1, 1, 1, 1, 1, 1, 2, 2, 1, 1, 1]","['arvor', 'compartilhar', 'compartilhar', 'menino', 'menino', 'menino']","[1, 2, 2, 3, 3, 3]",16,6,22,1
3326,"['congresso', 'mudanca', 'porqu', 'risco', 'sendo', 'transmissao']","[1, 1, 1, 1, 1, 1]","[]","[]",6,0,6,1
3329,"[]","[]","[]","[]",0,0,0,1
3332,"['alteracao', 'calendario', 'cenario', 'competicao', 'crise', 'decisao', 'europeu', 'europeu', 'paralisar']","[1, 1, 1, 1, 1, 1, 2, 2, 1]","[]","[]",9,0,9,1
3333,"['adiamento', 'antonio', 'competicao', 'suspenso', 'treinar']","[1, 1, 1, 1, 1]","['equador']","[1]",5,1,6,1
3338,"['adversario', 'boletim', 'folhar', 'folhar', 'integro', 'ricardo']","[1, 1, 2, 2, 1, 1]","[]","[]",6,0,6,1
3339,"['cnj', 'colegiado', 'comissao', 'comissao', 'comissao', 'constituicao', 'justicar', 'justicar', 'necessario', 'plenario', 'presenciar', 'presenciar', 'reuniao', 'suspenso', 'temporario']","[1, 1, 3, 3, 3, 1, 2, 2, 1, 1, 2, 2, 1, 1, 1]","[]","[]",15,0,15,1
3342,"['alcolumbr', 'alcolumbr', 'alcolumbr', 'alvorar', 'avancar', 'congresso', 'congresso', 'converso', 'crise', 'demap', 'dialogo', 'discussao', 'entendimento', 'flexibilizar', 'legislativo', 'palacio', 'planalto', 'proposto', 'tramitacao']","[3, 3, 3, 1, 1, 2, 2, 1, 1, 1, 1, 1, 1, 1, 1, 1, 1, 1, 1]","[]","[]",19,0,19,1
3343,"['autorizacao', 'autorizacao', 'autorizacao', 'destacar', 'diariament', 'importacao', 'justificativo', 'necessario', 'normalment', 'recurso', 'regiao', 'regrar', 'requerimento', 'transmissao', 'turista']","[3, 3, 3, 1, 1, 1, 1, 1, 1, 1, 1, 1, 1, 1, 1]","[]","[]",15,0,15,1
3348,"['adotada', 'cenario', 'circulacao', 'consenso', 'crise', 'crise', 'crise', 'diminuicao', 'divergencia', 'economia', 'economia', 'economia', 'efetividad', 'emergenciai', 'fase', 'fundacao', 'henriqu', 'incerteza', 'ministrar', 'necessidad', 'nelson', 'piorar', 'piorar', 'privar', 'recordar', 'saudar', 'saudar', 'temporario', 'varga']","[1, 1, 1, 1, 3, 3, 3, 1, 1, 3, 3, 3, 1, 1, 1, 1, 1, 1, 1, 1, 1, 2, 2, 1, 1, 2, 2, 1, 1]","[]","[]",29,0,29,1
3349,"['compromisso', 'conjuntar', 'emendar', 'europeu', 'europeu', 'habitant', 'particularment', 'preocupacao', 'resolucao']","[1, 1, 1, 2, 2, 1, 1, 1, 1]","['parir']","[1]",9,1,10,1
3351,"['alvorar', 'autoridad', 'constituicao', 'converso', 'economia', 'especialment', 'impactar', 'palacio', 'reabertura', 'republico', 'videoconferencia']","[1, 1, 1, 1, 1, 1, 1, 1, 1, 1, 1]","['pelar', 'pelar']","[2, 2]",11,2,13,1
3352,"['autoridad', 'embora', 'epicentro', 'epidemia', 'hubei', 'medida', 'necessario', 'provincia', 'reconhecimento']","[1, 1, 1, 1, 1, 1, 1, 1, 1]","[]","[]",9,0,9,1
3354,"['congresso', 'congresso', 'congresso', 'congresso', 'constituicao', 'destacar', 'folhar', 'folhar', 'folhar', 'folhar', 'inedito', 'liderar', 'palacio', 'planalto', 'possibilidad', 'spaulo']","[4, 4, 4, 4, 1, 1, 4, 4, 4, 4, 1, 1, 1, 1, 1, 1]","['ganhar', 'ganhar', 'manchet']","[2, 2, 1]",16,3,19,1
3355,"['exercicio', 'exercicio', 'quarentenar', 'transmissao']","[2, 2, 1, 1]","['deitar']","[1]",4,1,5,1
3356,"['fase', 'infectar', 'moderno', 'moderno', 'sigla']","[1, 1, 2, 2, 1]","[]","[]",5,0,5,1
3357,"['cepa', 'cepa', 'contagioso', 'implementacao', 'infectar', 'isolar', 'mutacao', 'mutacao', 'preocupacao', 'presenca', 'provincia', 'provincia', 'viagem']","[2, 2, 1, 1, 1, 1, 2, 2, 1, 1, 2, 2, 1]","[]","[]",13,0,13,1
3360,"['almeida', 'destacar', 'dosar', 'funcao', 'importancia', 'saudar', 'saudar', 'saudar', 'sindicato']","[1, 1, 1, 1, 1, 3, 3, 3, 1]","['inscricao']","[1]",9,1,10,1
3361,"['andrew', 'associacao', 'august', 'extraordinari', 'extraordinario', 'planar', 'precaucao', 'presenca', 'tornear']","[1, 1, 1, 1, 1, 1, 1, 1, 1]","[]","[]",9,0,9,1
3362,"['client', 'constatar', 'depoimento', 'flavio', 'integro', 'mprj', 'pratico', 'republicanosrj']","[1, 1, 1, 1, 1, 1, 1, 1]","['fraudar']","[1]",8,1,9,1
3363,"['antecipar', 'aprovacao', 'autorizacao', 'avancar', 'avancar', 'calheiro', 'calheiro', 'calheiro', 'calheiro', 'calheiro', 'calheiro', 'calheiro', 'carat', 'companhia', 'concedido', 'condicao', 'conformar', 'converso', 'depoimento', 'depoimento', 'depoimento', 'depoimento', 'depoimento', 'depoimento', 'depoimento', 'dosar', 'dosar', 'epidemiar', 'fase', 'fase', 'gabinet', 'governista', 'mdbal', 'mdbal', 'mdbal', 'ministrar', 'oficialment', 'palacio', 'pastar', 'planalto', 'positivar', 'posturar', 'prever', 'privar', 'proposto', 'pslsp', 'recordar', 'recordar', 'recordar', 'republico', 'reuniao', 'reuniao', 'reuniao', 'reuniao', 'reuniao', 'reuniao', 'reuniao', 'saudar', 'saudar', 'secom', 'secom', 'secom', 'secom', 'secom', 'secom', 'secom', 'secom', 'secom', 'secom', 'secom', 'servidor', 'wajngarten', 'wajngarten', 'wajngarten', 'wajngarten', 'wajngarten', 'wajngarten', 'wajngarten', 'wajngarten', 'wajngarten', 'wajngarten', 'wajngarten', 'wajngarten', 'wajngarten', 'wajngarten', 'wajngarten', 'wajngarten', 'wajngarten', 'wajngarten', 'wajngarten', 'wajngarten', 'wajngarten']","[1, 1, 1, 2, 2, 7, 7, 7, 7, 7, 7, 7, 1, 1, 1, 1, 1, 1, 7, 7, 7, 7, 7, 7, 7, 2, 2, 1, 2, 2, 1, 1, 3, 3, 3, 1, 1, 1, 1, 1, 1, 1, 1, 1, 1, 1, 3, 3, 3, 1, 7, 7, 7, 7, 7, 7, 7, 2, 2, 11, 11, 11, 11, 11, 11, 11, 11, 11, 11, 11, 1, 21, 21, 21, 21, 21, 21, 21, 21, 21, 21, 21, 21, 21, 21, 21, 21, 21, 21, 21, 21, 21]","['circular', 'circular', 'circular', 'postagen', 'postagen']","[3, 3, 3, 2, 2]",92,5,97,1
3366,"['forcatarefa', 'milho']","[1, 1]","[]","[]",2,0,2,1
3367,"['comissao', 'enfrentamento', 'estrategico', 'iniciativo', 'orientacao', 'saudar', 'saudar', 'saudar', 'saudar', 'saudar', 'saudar']","[1, 1, 1, 1, 1, 6, 6, 6, 6, 6, 6]","[]","[]",11,0,11,1
3370,"['condicao', 'contemplar', 'dificuldad', 'esforco', 'minimizar', 'minimizar', 'periodo', 'quarentenar', 'situacao', 'situacao']","[1, 1, 1, 1, 2, 2, 1, 1, 2, 2]","[]","[]",10,0,10,1
3372,"['agravar', 'saudar', 'situacao']","[1, 1, 1]","[]","[]",3,0,3,1
3373,"['adulto', 'autonomia', 'autorizacao', 'carat', 'conformar', 'demandar', 'distrito', 'enfrentamento', 'infraestrutura', 'necessario', 'pastar', 'reforcar', 'saudar', 'saudar', 'temporario']","[1, 1, 1, 1, 1, 1, 1, 1, 1, 1, 1, 1, 2, 2, 1]","[]","[]",15,0,15,1
3375,"['antecipar', 'desenvolvido', 'desenvolvido', 'folhar', 'instituto', 'instituto', 'parceiro', 'reconhecimento', 'reuter', 'reuter', 'spaulo']","[1, 2, 2, 1, 2, 2, 1, 1, 2, 2, 1]","[]","[]",11,0,11,1
3377,"['etapa', 'organizador', 'positivar', 'positivar', 'tornear', 'tornear']","[1, 1, 2, 2, 2, 2]","['boatar', 'enganar', 'imagem', 'indignacao']","[1, 1, 1, 1]",6,4,10,1
3378,"['capitar', 'moderno', 'primeiroministro']","[1, 1, 1]","['canadens']","[1]",3,1,4,1
3381,"['comprometido', 'conformar', 'consolidar', 'crescimento', 'disseminacao', 'disseminacao', 'epidemiar', 'habitant', 'infectar', 'levantamento', 'observar', 'pastar', 'previsao', 'projeco', 'saudar', 'testagem']","[1, 1, 1, 1, 2, 2, 1, 1, 1, 1, 1, 1, 1, 1, 1, 1]","[]","[]",16,0,16,1
3382,"['converso', 'nelson', 'provisorio', 'reuniao']","[1, 1, 1, 1]","['lazaro']","[1]",4,1,5,1
3385,"['celso', 'domingo', 'empatar', 'levantamento', 'margem']","[1, 1, 1, 1, 1]","[]","[]",5,0,5,1
3390,"['adotada', 'apurar', 'bancada', 'broadcast', 'conformar', 'constituicao', 'crise', 'crise', 'demandar', 'economia', 'emendar', 'gued', 'ministrar', 'mudanca', 'necessidad', 'planar', 'possibilidad', 'proposto', 'reducao', 'servidor', 'situacao', 'vulneravel']","[1, 1, 1, 1, 1, 1, 2, 2, 1, 1, 1, 1, 1, 1, 1, 1, 1, 1, 1, 1, 1, 1]","[]","[]",22,0,22,1
3391,"['biliao', 'companhia', 'companhia', 'crise', 'domingo', 'expansao', 'plano', 'portavoz', 'portavoz', 'voo', 'voo', 'voo']","[1, 2, 2, 1, 1, 1, 1, 2, 2, 3, 3, 3]","[]","[]",12,0,12,1
3395,"['aglomeracao', 'amplo', 'condicao', 'especifico', 'estimular', 'republico']","[1, 1, 1, 1, 1, 1]","[]","[]",6,0,6,1
3396,"['antonio', 'anvisa', 'calculo', 'calculo', 'calculo', 'consorcio', 'consorcio', 'contabilizar', 'diariament', 'enxergar', 'escassez', 'estabilidad', 'estatistico', 'folhar', 'imunizacao', 'inconsistencia', 'infectar', 'iniciativo', 'plantao', 'prazo', 'quedo', 'queixar', 'recurso', 'reforcar', 'roraima', 'saudar', 'saudar', 'saudar', 'spaulo', 'tendencia', 'tendencia', 'totalizar']","[1, 1, 3, 3, 3, 2, 2, 1, 1, 1, 1, 1, 1, 1, 1, 1, 1, 1, 1, 1, 1, 1, 1, 1, 1, 3, 3, 3, 1, 2, 2, 1]","[]","[]",32,0,32,1
3398,"['arrecadacao', 'boletim', 'cenario', 'economia', 'economia', 'henriqu', 'metropolitano', 'metropolitano', 'metropolitano', 'pib', 'planar', 'previsao', 'quedo', 'reabertura', 'reabertura', 'reabertura', 'reabertura', 'recuar', 'regiao', 'regiao', 'regiao']","[1, 1, 1, 2, 2, 1, 3, 3, 3, 1, 1, 1, 1, 4, 4, 4, 4, 1, 3, 3, 3]","[]","[]",21,0,21,1
3400,"['biliao', 'congresso', 'fase', 'fundacao', 'ministrar', 'parceria', 'pastar', 'pastar', 'saudar', 'saudar']","[1, 1, 1, 1, 1, 1, 2, 2, 2, 2]","[]","[]",10,0,10,1
3401,"['conjuntar', 'consecutivo', 'marinhar', 'ministrar', 'negativar', 'recurso', 'sabado', 'viagem']","[1, 1, 1, 1, 1, 1, 1, 1]","[]","[]",8,0,8,1
3402,"['aprovacao', 'argumentar', 'biliao', 'emendar', 'facilitar', 'globonew', 'justificativo', 'proposto', 'proposto', 'prorrogacao']","[1, 1, 1, 1, 1, 1, 1, 2, 2, 1]","[]","[]",10,0,10,1
3403,"['enxergar', 'internar', 'recuperacao', 'saudar', 'superar']","[1, 1, 1, 1, 1]","[]","[]",5,0,5,1
3404,"['anteontem', 'anteriorment', 'associacao', 'compromisso', 'compromisso', 'compromisso', 'determinacao', 'flexibilizacao', 'funcionamento', 'globonew', 'reabertura']","[1, 1, 1, 3, 3, 3, 1, 1, 1, 1, 1]","[]","[]",11,0,11,1
3406,"['absoluto', 'possibilidad']","[1, 1]","[]","[]",2,0,2,1
3409,"['constatar', 'consumidor', 'cooperacao', 'dificuldad', 'fluxo', 'fornecimento', 'infectar', 'instituto', 'instituto', 'levantamento', 'possibilidad', 'preocupacao', 'reducao', 'regiao', 'regiao']","[1, 1, 1, 1, 1, 1, 1, 2, 2, 1, 1, 1, 1, 2, 2]","[]","[]",15,0,15,1
3414,"['comportamento', 'decisao', 'exministro', 'exonerar', 'henriqu', 'ministrar', 'ministrar', 'opcao', 'saudar', 'saudar', 'saudar', 'saudar']","[1, 1, 1, 1, 1, 2, 2, 1, 4, 4, 4, 4]","['misturar']","[1]",12,1,13,1
3420,"['biliao', 'distrito', 'emergenciai', 'habitant', 'periodo', 'propagacao', 'propagacao', 'prorrogacao', 'prorrogacao', 'rigoroso', 'taxar']","[1, 1, 1, 1, 1, 2, 2, 2, 2, 1, 1]","[]","[]",11,0,11,1
3421,"['concedido', 'intubacao', 'intubacao', 'intubacao', 'nogueira', 'nogueira', 'saudar', 'situacao', 'situacao']","[1, 3, 3, 3, 2, 2, 1, 2, 2]","[]","[]",9,0,9,1
3422,"['anticorpo', 'colleg', 'equivalent', 'inglaterra', 'periodo']","[1, 1, 1, 1, 1]","[]","[]",5,0,5,1
3424,"['acordo', 'anteriorment', 'anvisa', 'anvisa', 'anvisa', 'anvisa', 'anvisa', 'anvisa', 'anvisa', 'aprovacao', 'armazenamento', 'armazenamento', 'calculo', 'calculo', 'calculo', 'calculo', 'calculo', 'carat', 'comissao', 'conjunto', 'conselho', 'contrato', 'decisao', 'demanda', 'demanda', 'destac', 'distant', 'domingo', 'extensao', 'extensao', 'extensao', 'extensao', 'fez', 'informaco', 'informaco', 'informaco', 'irregularidad', 'medeiro', 'medeiro', 'medeiro', 'medeiro', 'medeiro', 'medeiro', 'medeiro', 'medeiro', 'medida', 'milho', 'milho', 'milho', 'milho', 'milho', 'montant', 'necessario', 'normalidad', 'oficio', 'orientacao', 'panamericana', 'pedido', 'pedido', 'porqu', 'prazo', 'prazo', 'prazo', 'prazo', 'prazo', 'prazo', 'preocupacao', 'proprio', 'provisorio', 'proximo', 'proximo', 'proximo', 'proximo', 'proximo', 'proximo', 'quatro', 'realizacao', 'recebido', 'resultado', 'semestr', 'sido', 'sido', 'situacao', 'substituicao', 'substituicao', 'ultimo', 'ultimo', 'ultimo', 'vencimento', 'vencimento', 'vencimento', 'vencimento', 'vencimento', 'vigilancia', 'vigilancia', 'vigilancia']","[1, 1, 7, 7, 7, 7, 7, 7, 7, 1, 2, 2, 5, 5, 5, 5, 5, 1, 1, 1, 1, 1, 1, 2, 2, 1, 1, 1, 4, 4, 4, 4, 1, 3, 3, 3, 1, 8, 8, 8, 8, 8, 8, 8, 8, 1, 5, 5, 5, 5, 5, 1, 1, 1, 1, 1, 1, 2, 2, 1, 6, 6, 6, 6, 6, 6, 1, 1, 1, 6, 6, 6, 6, 6, 6, 1, 1, 1, 1, 1, 2, 2, 1, 2, 2, 3, 3, 3, 5, 5, 5, 5, 5, 3, 3, 3]","['mencao']","[1]",96,1,97,1
3427,"['avancar', 'crise', 'dificuldad', 'epicentro', 'posturar', 'provincia', 'quarentenar', 'resolucao', 'respiratorio', 'surtir']","[1, 1, 1, 1, 1, 1, 1, 1, 1, 1]","[]","[]",10,0,10,1
3428,"['constituicao', 'exministro', 'exministro', 'justicar', 'magistrado', 'periodo', 'preocupacao', 'prever', 'proposto', 'proposto', 'reafirmar', 'situacao']","[1, 2, 2, 1, 1, 1, 1, 1, 2, 2, 1, 1]","[]","[]",12,0,12,1
3430,"['cronica', 'facilitar', 'internacao', 'prioritario', 'prioritario', 'privar', 'risco', 'saudar', 'saudar', 'saudar', 'saudar', 'suspeito']","[1, 1, 1, 2, 2, 1, 1, 4, 4, 4, 4, 1]","['circular', 'motorista']","[1, 1]",12,2,14,1
3432,"['cenario', 'machadar', 'oliveira', 'respostar']","[1, 1, 1, 1]","[]","[]",4,0,4,1
3434,"['contrato', 'contribuicao', 'destinar', 'economia', 'legislativo', 'legislativo', 'recurso', 'resolucao']","[1, 1, 1, 1, 2, 2, 1, 1]","[]","[]",8,0,8,1
3435,"['administrativo', 'caxia', 'caxia', 'decisao', 'decisao', 'descumprimento', 'descumprir', 'duqu', 'duqu', 'imunizacao', 'justicar', 'planar', 'relativo']","[1, 2, 2, 2, 2, 1, 1, 2, 2, 1, 1, 1, 1]","[]","[]",13,0,13,1
3436,"['antonio', 'exgovernador']","[1, 1]","['ganhar', 'inscricao', 'versao']","[1, 1, 1]",2,3,5,1
3437,"['administrativo', 'ausencia', 'bancada', 'especifico', 'pacheco', 'pacheco', 'sessao', 'sessao', 'substituto']","[1, 1, 1, 1, 2, 2, 2, 2, 1]","['secreto', 'secreto']","[2, 2]",9,2,11,1
3438,"['calendario', 'delacao', 'delacao', 'destinar', 'exgovernador', 'exprefeito', 'investigacao', 'movimentacao', 'privar', 'tucano']","[1, 2, 2, 1, 1, 1, 1, 1, 1, 1]","['realment']","[1]",10,1,11,1
3440,"['alternativo', 'esforco', 'especialment', 'esperancar', 'necessario', 'possibilidad', 'possibilidad', 'prazo', 'requerimento', 'saudar', 'saudar']","[1, 1, 1, 1, 1, 2, 2, 1, 1, 2, 2]","['minutar']","[1]",11,1,12,1
3442,"['arthur', 'demrj', 'folhar', 'integro', 'lira', 'ppal', 'reuniao', 'rossi']","[1, 1, 1, 1, 1, 1, 1, 1]","[]","[]",8,0,8,1
3444,"['alunar', 'aprovacao', 'comportamento', 'constituicao', 'fundeb', 'fundeb', 'recurso', 'republico']","[1, 1, 1, 1, 2, 2, 1, 1]","['fraudar', 'ilustrar']","[1, 1]",8,2,10,1
3446,"['alcolumbr', 'arthur', 'bolsonarista', 'congresso', 'demap', 'demmg', 'demrj', 'favorito', 'flexibilizacao', 'ideologico', 'inclusao', 'lira', 'lira', 'pacheco', 'palacio', 'planalto', 'planalto', 'ppal']","[1, 1, 1, 1, 1, 1, 1, 1, 1, 1, 1, 2, 2, 1, 1, 2, 2, 1]","[]","[]",18,0,18,1
3448,"['bancada', 'constituicao', 'minoria', 'preconceito']","[1, 1, 1, 1]","['cristao', 'cristao']","[2, 2]",4,2,6,1
3451,"['adotada', 'exministro', 'primeiroministro', 'provincia', 'restritivo', 'reuniao', 'subir']","[1, 1, 1, 1, 1, 1, 1]","[]","[]",7,0,7,1
3452,"['destinar', 'destinar', 'domingo', 'domingo', 'estrategico', 'etapa', 'imunizacao', 'instituto', 'logistico', 'operacionalizacao', 'planar', 'previsao', 'prioritario', 'remessar', 'sabado', 'saudar', 'saudar']","[2, 2, 2, 2, 1, 1, 1, 1, 1, 1, 1, 1, 1, 1, 1, 2, 2]","[]","[]",17,0,17,1
3453,"['economia', 'economia', 'enfrentamento', 'fabricacao', 'importacao', 'importacao', 'importacao', 'presidir', 'resolucao', 'resolucao', 'resolucao', 'respiratorio']","[2, 2, 1, 1, 3, 3, 3, 1, 3, 3, 3, 1]","['minutar']","[1]",12,1,13,1
3456,"['carla', 'carla', 'carla', 'diminuicao', 'fez', 'imunizacao', 'plano', 'processo', 'relacao', 'relacao', 'relacao', 'sendo', 'tambem']","[3, 3, 3, 1, 1, 1, 1, 1, 3, 3, 3, 1, 1]","[]","[]",13,0,13,1
3459,"['isolar', 'isolar', 'isolar', 'marilia', 'marilia', 'marilia', 'mendonca', 'mendonca', 'mendonca']","[3, 3, 3, 3, 3, 3, 3, 3, 3]","['vc']","[1]",9,1,10,1
3461,"['saudar']","[1]","[]","[]",1,0,1,1
3462,"['demandar', 'desafiar', 'equipamento', 'necessario', 'propagacao', 'reuniao', 'reuter', 'reuter', 'saudar', 'servidor', 'suprimento']","[1, 1, 1, 1, 1, 1, 2, 2, 1, 1, 1]","['protestar']","[1]",11,1,12,1
3465,"['acordo', 'anteontem', 'anteontem', 'aumento', 'aumento', 'confirmado', 'confirmado', 'crescimento', 'crescimento', 'relacao', 'relacao']","[1, 2, 2, 2, 2, 2, 2, 2, 2, 2, 2]","[]","[]",11,0,11,1
3469,"[]","[]","['parir']","[1]",0,1,1,1
3470,"['companhia', 'demandar', 'demandar', 'especialment', 'viagem', 'voo', 'voo']","[1, 2, 2, 1, 1, 2, 2]","[]","[]",7,0,7,1
3471,"['aprovacao', 'dosar', 'dosar', 'estagio', 'reuter']","[1, 2, 2, 1, 1]","['sortir']","[1]",5,1,6,1
3473,"['afetado', 'algun', 'aumento', 'economia', 'milho', 'sendo', 'tendencia']","[1, 1, 1, 1, 1, 1, 1]","[]","[]",7,0,7,1
3475,"['alteracao', 'avancar', 'competicao', 'competicao', 'desenvolvimento', 'expressar', 'intervalar', 'situacao', 'tornear']","[1, 1, 2, 2, 1, 1, 1, 1, 1]","[]","[]",9,0,9,1
3477,"['favorito', 'tucano']","[1, 1]","[]","[]",2,0,2,1
3479,"['decisao', 'demandar', 'justicar', 'prazo', 'saudar', 'transferencia']","[1, 1, 1, 1, 1, 1]","[]","[]",6,0,6,1
3482,"['aplicacao', 'necessario', 'saudar']","[1, 1, 1]","[]","[]",3,0,3,1
3483,"['comissao', 'comissao', 'exministro', 'integro', 'ministrar', 'queiroga']","[2, 2, 1, 1, 1, 1]","['rosario']","[1]",6,1,7,1
3486,"['antonio', 'obtido', 'ricardo', 'ricardo', 'suspeito']","[1, 1, 2, 2, 1]","['chorar', 'fraudar', 'invadir', 'lembres']","[1, 1, 1, 1]",5,4,9,1
3488,"['desembarcar', 'deslocamento', 'enquadrar', 'enquadrar', 'epidemiar', 'escalar', 'espanha', 'europeu', 'instituto', 'positivar', 'positivar', 'prever', 'regiao', 'saudar', 'saudar', 'saudar', 'saudar', 'saudar', 'suspeito', 'toquio', 'totalizar', 'viagem']","[1, 1, 2, 2, 1, 1, 1, 1, 1, 2, 2, 1, 1, 5, 5, 5, 5, 5, 1, 1, 1, 1]","[]","[]",22,0,22,1
3489,"['anticorpo', 'justicar', 'plano', 'plano', 'presenca', 'reuniao', 'saudar', 'saudar', 'saudar']","[1, 1, 2, 2, 1, 1, 3, 3, 3]","[]","[]",9,0,9,1
3492,"['autoridad', 'decisao', 'fez', 'habitant', 'medida', 'proximo', 'quatro', 'surto', 'suspenso', 'suspenso', 'tambem', 'turista']","[1, 1, 1, 1, 1, 1, 1, 1, 2, 2, 1, 1]","[]","[]",12,0,12,1
3494,"['acordo', 'aglomeracao', 'aglomeracao', 'conjunto', 'domingo', 'vigilancia']","[1, 2, 2, 1, 1, 1]","[]","[]",6,0,6,1
3495,"['anteontem', 'anteontem', 'crescimento', 'crescimento', 'ritmar', 'ritmar']","[2, 2, 2, 2, 2, 2]","[]","[]",6,0,6,1
3498,"['adotada', 'associacao', 'balancar', 'biliao', 'circulacao', 'client', 'europeu', 'isolar']","[1, 1, 1, 1, 1, 1, 1, 1]","[]","[]",8,0,8,1
3499,"['aglomeracao', 'circulacao', 'decisao', 'instituto', 'internacao', 'transmissao']","[1, 1, 1, 1, 1, 1]","[]","[]",6,0,6,1
3500,"['anvisa', 'anvisa', 'anvisa', 'consorcio', 'consorcio', 'reportar', 'sputnik', 'vigilancia']","[3, 3, 3, 2, 2, 1, 1, 1]","['basto']","[1]",8,1,9,1
3501,"['alerj', 'augusto', 'destinar', 'fabricio', 'flavio', 'flavio', 'flavio', 'gabinet', 'heleno', 'lavagem', 'margem', 'materiaprima', 'obtido', 'orientacao', 'queiroz', 'rachadinha', 'rachadinha', 'republico']","[1, 1, 1, 1, 3, 3, 3, 1, 1, 1, 1, 1, 1, 1, 1, 2, 2, 1]","['estampar', 'invadir', 'supostament']","[1, 1, 1]",18,3,21,1
3502,"['argumentar', 'batalhar', 'republico']","[1, 1, 1]","[]","[]",3,0,3,1
3503,"['alcolumbr', 'aliquota', 'congresso', 'demrj', 'domingo', 'economia', 'estimular', 'gued', 'gued', 'ministrar', 'prioridad', 'prioridad', 'privar', 'privar', 'semestr', 'tributario', 'tributario']","[1, 1, 1, 1, 1, 1, 1, 2, 2, 1, 2, 2, 2, 2, 1, 2, 2]","[]","[]",17,0,17,1
3505,"['associacao', 'infectar', 'parceria', 'saudar', 'saudar']","[1, 1, 1, 2, 2]","['implantar']","[1]",5,1,6,1
3506,"['defendido', 'diagnosticar', 'discussao', 'discussao', 'gabbardo', 'gabbardo', 'implementar', 'mudanca', 'posicionamento', 'prescricao', 'preventivo', 'primario', 'republico', 'significativo']","[1, 1, 2, 2, 2, 2, 1, 1, 1, 1, 1, 1, 1, 1]","[]","[]",14,0,14,1
3507,"['adulto', 'arthur', 'condicao', 'condicao', 'deslocamento', 'instituto', 'instituto', 'lancamento', 'logistico', 'presenca', 'regiao', 'salao', 'saudar', 'viagem']","[1, 1, 2, 2, 1, 2, 2, 1, 1, 1, 1, 1, 1, 1]","[]","[]",14,0,14,1
3508,"['articulacao', 'destacar', 'enfrentamento', 'etapa', 'ministrar', 'ministrar', 'reforcar', 'saudar', 'saudar', 'saudar', 'saudar', 'velocidad']","[1, 1, 1, 1, 2, 2, 1, 4, 4, 4, 4, 1]","[]","[]",12,0,12,1
3509,"['atendido', 'dosar', 'estatistico', 'estatistico', 'parcelar', 'quedo', 'reducao', 'respiratorio', 'sabado', 'saudar']","[1, 1, 2, 2, 1, 1, 1, 1, 1, 1]","[]","[]",10,0,10,1
3511,"['liderar', 'orientacao', 'presenca', 'prioridad', 'saudar', 'transicao', 'transicao']","[1, 1, 1, 1, 1, 2, 2]","[]","[]",7,0,7,1
3513,"['associacao', 'capitar', 'cenario', 'comportamento', 'crescimento', 'crescimento', 'demandar', 'demandar', 'dificuldad', 'expansao', 'expansao', 'expressivo', 'fase', 'levantamento', 'martim', 'normalment', 'precaucao', 'preventivo', 'privar', 'privar', 'privar', 'taxar', 'taxar', 'temor']","[1, 1, 1, 1, 2, 2, 2, 2, 1, 2, 2, 1, 1, 1, 1, 1, 1, 1, 3, 3, 3, 2, 2, 1]","[]","[]",24,0,24,1
3514,"['avancar', 'desafio', 'discussao', 'fundamentar', 'mudanca', 'portavoz']","[1, 1, 1, 1, 1, 1]","[]","[]",6,0,6,1
3517,"['autoridad', 'consequencia', 'ultimo']","[1, 1, 1]","['verdadeiro']","[1]",3,1,4,1
3519,"['absoluto', 'balancar', 'californio', 'contabilizar', 'florido', 'sabado']","[1, 1, 1, 1, 1, 1]","[]","[]",6,0,6,1
3521,"['adiamento', 'barroso', 'julgamento', 'julgamento', 'lewandowski', 'ministrar', 'ministrar', 'ministrar', 'ministrar', 'plenario', 'prazo', 'reconhecimento', 'recurso', 'ricardo', 'supremo', 'supremo']","[1, 1, 2, 2, 1, 4, 4, 4, 4, 1, 1, 1, 1, 1, 2, 2]","[]","[]",16,0,16,1
3522,"['apurar', 'comissao', 'conduta', 'investigacao', 'palacio', 'planalto', 'prtb', 'republico']","[1, 1, 1, 1, 1, 1, 1, 1]","[]","[]",8,0,8,1
3523,"['adulto', 'biliao', 'biliao', 'biliao', 'cenario', 'congresso', 'economia', 'gued', 'minimizar', 'ministrar', 'prazo', 'proposto', 'prorrogar', 'trimestr']","[1, 3, 3, 3, 1, 1, 1, 1, 1, 1, 1, 1, 1, 1]","[]","[]",14,0,14,1
3525,"['araujo', 'araujo', 'araujo', 'colaborar', 'comissao', 'congresso', 'domingo', 'domingo', 'ernesto', 'itamarati', 'martim', 'ministrar', 'ministrar', 'pacheco', 'parcelar', 'pratico', 'sessao', 'sobretudo']","[3, 3, 3, 1, 1, 1, 2, 2, 1, 1, 1, 2, 2, 1, 1, 1, 1, 1]","['agredir', 'sobrar']","[1, 1]",18,2,20,1
3527,"['articulacao', 'bancada', 'bancada', 'republico']","[1, 2, 2, 1]","[]","[]",4,0,4,1
3528,"['autoridad', 'autoridad', 'condicao', 'condicao', 'desembarcar', 'deslocamento', 'destinar', 'infraestrutura', 'ministrar', 'pastar', 'prever', 'previsto', 'regiao']","[2, 2, 2, 2, 1, 1, 1, 1, 1, 1, 1, 1, 1]","[]","[]",13,0,13,1
3529,"['esperanca']","[1]","['ganhar']","[1]",1,1,2,1
3531,"['complicacao', 'consequencia', 'inicialment', 'respiratorio', 'respostar']","[1, 1, 1, 1, 1]","[]","[]",5,0,5,1
3532,"['comportamento', 'conservacao', 'dedicar', 'dedicar', 'importancia', 'isolar', 'quarentenar', 'quarentenar', 'quarentenar', 'republico', 'santiago', 'saudar']","[1, 1, 2, 2, 1, 1, 3, 3, 3, 1, 1, 1]","[]","[]",12,0,12,1
3538,"['cenario', 'curso', 'isolar', 'mergulhar', 'opcao', 'prever', 'turistico', 'viagem']","[1, 1, 1, 1, 1, 1, 1, 1]","['nordestino']","[1]",8,1,9,1
3539,"['ampliacao', 'aurelio', 'aurelio', 'autonomia', 'condicao', 'congresso', 'constituicao', 'decisao', 'depoimento', 'depoimento', 'investigacao', 'irregularidad', 'mello', 'mello', 'supremo']","[1, 2, 2, 1, 1, 1, 1, 1, 2, 2, 1, 1, 2, 2, 1]","[]","[]",15,0,15,1
3540,"['atuacao', 'interino', 'ministrar', 'pastar', 'possibilidad', 'saudar']","[1, 1, 1, 1, 1, 1]","[]","[]",6,0,6,1
3541,"['internacao', 'viagem']","[1, 1]","['amigar', 'amigar', 'imagem', 'legendar']","[2, 2, 1, 1]",2,4,6,1
3542,"['decisao', 'henriqu', 'oposto', 'provisorio', 'regrar', 'saudar', 'souza']","[1, 1, 1, 1, 1, 1, 1]","[]","[]",7,0,7,1
3543,"['aglomeracao', 'aglomeracao', 'globonew', 'globonew', 'infectar', 'internar', 'preocupacao']","[2, 2, 2, 2, 1, 1, 1]","['verdadeiro']","[1]",7,1,8,1
3544,"['condenacao', 'corpu', 'exjuiz', 'exministro', 'folhar', 'guaruja', 'habea', 'inclusao', 'julgamento', 'justicar', 'reportar', 'spaulo', 'triplex']","[1, 1, 1, 1, 1, 1, 1, 1, 1, 1, 1, 1, 1]","['basto']","[1]",13,1,14,1
3545,"['consecutivo', 'consecutivo', 'consorcio', 'infectar', 'intervalar', 'periodo', 'recordar', 'reportar', 'reportar', 'saudar']","[2, 2, 1, 1, 1, 1, 1, 2, 2, 1]","[]","[]",10,0,10,1
3549,"['assistencia', 'condicao', 'cronica', 'cronica', 'cronica', 'cronica', 'destacar', 'estatistico', 'geografia', 'hipertensao', 'hipertensao', 'ibg', 'implementar', 'instituto', 'parceria', 'pastar', 'percepcao', 'primario', 'recurso', 'saudar', 'saudar', 'saudar', 'saudar', 'saudar', 'saudar', 'saudar', 'saudar', 'saudar']","[1, 1, 4, 4, 4, 4, 1, 1, 1, 2, 2, 1, 1, 1, 1, 1, 1, 1, 1, 9, 9, 9, 9, 9, 9, 9, 9, 9]","[]","[]",28,0,28,1
3551,"['adversario', 'arthur', 'calheiro', 'calheiro', 'comissao', 'comissao', 'compromisso', 'depoimento', 'flavio', 'flavio', 'inquerito', 'investigacao', 'lira', 'mdbal', 'ppal', 'republicanosrj', 'republico', 'respostar', 'sessao', 'vespera', 'wajngarten']","[1, 1, 2, 2, 2, 2, 1, 1, 2, 2, 1, 1, 1, 1, 1, 1, 1, 1, 1, 1, 1]","['vagabundar', 'vagabundar', 'vagabundar', 'vagabundar']","[4, 4, 4, 4]",21,4,25,1
3552,"['distrito', 'expectativa', 'levantamento', 'parceria', 'realizacao', 'reforcar', 'rocha', 'saudar', 'saudar']","[1, 1, 1, 1, 1, 1, 1, 2, 2]","[]","[]",9,0,9,1
3554,"['aumento', 'biliao', 'biliao', 'bruto', 'conformar', 'consumidor', 'consumidor', 'demandar', 'depressao', 'desempenhar', 'expectativa', 'expectativa', 'impulsionar', 'impulsionar', 'internar', 'pib', 'regiao', 'reportar', 'trimestr', 'trimestr']","[1, 2, 2, 1, 1, 2, 2, 1, 1, 1, 2, 2, 2, 2, 1, 1, 1, 1, 2, 2]","[]","[]",20,0,20,1
3557,"['bruto', 'internar', 'monetario']","[1, 1, 1]","[]","[]",3,0,3,1
3558,"['acumular', 'augusto', 'augusto', 'cilindro', 'conduta', 'funcao', 'henriqu', 'inquerito', 'investigacao', 'investigacao', 'ministrar', 'ministrar', 'necessario', 'nelson', 'pastar', 'republico', 'republico', 'saudar', 'saudar', 'saudar', 'saudar', 'saudar', 'supremo', 'supremo', 'teich']","[1, 2, 2, 1, 1, 1, 1, 1, 2, 2, 2, 2, 1, 1, 1, 2, 2, 5, 5, 5, 5, 5, 2, 2, 1]","['atribuir']","[1]",25,1,26,1
3559,"['determinacao', 'domingo', 'estimular', 'exgovernador', 'internar', 'realizacao']","[1, 1, 1, 1, 1, 1]","[]","[]",6,0,6,1
3560,"['acordo', 'augusto', 'calheiro', 'celebrar', 'destinar', 'edson', 'fachin', 'justicar', 'lorenzoni', 'mdbal', 'ministrar', 'ministrar', 'onyx', 'prever', 'republico', 'supremo', 'supremo', 'tramitar']","[1, 1, 1, 1, 1, 1, 1, 1, 1, 1, 2, 2, 1, 1, 1, 2, 2, 1]","[]","[]",18,0,18,1
3562,"['colaborar', 'conformar', 'dengu', 'genoma', 'instituto', 'levantamento', 'nelson', 'oliveira', 'oswaldo', 'vigilancia']","[1, 1, 1, 1, 1, 1, 1, 1, 1, 1]","[]","[]",10,0,10,1
3563,"[]","[]","['acidentar']","[1]",0,1,1,1
3564,"['alternativo', 'argumentar', 'calheiro', 'colegiado', 'comissao', 'comissao', 'comissao', 'comissao', 'conformar', 'decisao', 'depoimento', 'depoimento', 'depoimento', 'depoimento', 'depoimento', 'depoimento', 'depoimento', 'depoimento', 'depoimento', 'exministro', 'exministro', 'exministro', 'exministro', 'governista', 'henriqu', 'humberto', 'infectar', 'infectar', 'internar', 'mdbal', 'ministrar', 'ministrar', 'nelson', 'nogueira', 'oficio', 'palacio', 'planalto', 'presenca', 'quarentenar', 'quarentenar', 'respostar', 'sabado', 'saudar', 'saudar', 'servidor', 'sessao', 'sessao', 'sessao', 'sugestao', 'teich', 'treinar']","[1, 1, 1, 1, 4, 4, 4, 4, 1, 1, 9, 9, 9, 9, 9, 9, 9, 9, 9, 4, 4, 4, 4, 1, 1, 1, 2, 2, 1, 1, 2, 2, 1, 1, 1, 1, 1, 1, 2, 2, 1, 1, 2, 2, 1, 3, 3, 3, 1, 1, 1]","['basto']","[1]",51,1,52,1
3565,"['associacao', 'associacao', 'companhia', 'crescimento', 'crise', 'economia', 'elaborar', 'equipamento', 'equipamento', 'escalar', 'estimativo', 'fornecimento', 'levantamento', 'materiaprima', 'observar', 'prazo', 'ricardo']","[2, 2, 1, 1, 1, 1, 1, 2, 2, 1, 1, 1, 1, 1, 1, 1, 1]","[]","[]",17,0,17,1
3569,"['biliao', 'emendar', 'goncalv', 'plenario', 'privar', 'privar', 'proposto', 'saudar']","[1, 1, 1, 1, 2, 2, 1, 1]","[]","[]",8,0,8,1
3570,"['academiar', 'client', 'economia', 'limitacao', 'previsto', 'propagacao', 'reabertura', 'reabrir', 'relaxamento']","[1, 1, 1, 1, 1, 1, 1, 1, 1]","[]","[]",9,0,9,1
3571,"['concedido', 'crise', 'crise', 'divergencia', 'economia', 'gued', 'gued', 'ministrar', 'ministrar', 'observar', 'saudar', 'saudar', 'saudar']","[1, 2, 2, 1, 1, 2, 2, 2, 2, 1, 3, 3, 3]","[]","[]",13,0,13,1
3572,"['algun', 'conjunto', 'conservacao', 'extensa', 'extensa', 'informaco', 'instituto', 'proximo', 'sendo', 'sendo', 'situacao', 'tambem', 'ultimo']","[1, 1, 1, 2, 2, 1, 1, 1, 2, 2, 1, 1, 1]","['banan', 'banan', 'incendio', 'incendio', 'incendio']","[2, 2, 3, 3, 3]",13,5,18,1
3573,"['consecutivo', 'consorcio', 'distrito', 'obtido', 'quedo', 'sabado', 'saudar']","[1, 1, 1, 1, 1, 1, 1]","[]","[]",7,0,7,1
3576,"['avancar', 'dosar', 'especifico', 'estimular', 'moderno', 'respostar']","[1, 1, 1, 1, 1, 1]","[]","[]",6,0,6,1
3577,"['ambientar', 'desmatamento', 'economia', 'especifico', 'instituto', 'ministrar', 'periodo', 'periodo', 'planar', 'ppa', 'pratico', 'preservacao', 'prever', 'proposto', 'proposto', 'proposto', 'rejeitar', 'ricardo', 'sall', 'sall']","[1, 1, 1, 1, 1, 1, 2, 2, 1, 1, 1, 1, 1, 3, 3, 3, 1, 1, 2, 2]","['incendio']","[1]",20,1,21,1
3581,"['avancar', 'gabinet', 'notificar', 'plenario', 'santiago', 'santiago', 'santiago', 'sessao', 'suspeito', 'wilson', 'wilson']","[1, 1, 1, 1, 3, 3, 3, 1, 1, 2, 2]","[]","[]",11,0,11,1
3582,"['antonio', 'antonio', 'avancar', 'regiao']","[2, 2, 1, 1]","[]","[]",4,0,4,1
3584,"['afp', 'biliao', 'crise', 'flexibilizar', 'habitant', 'intensivo', 'respirador', 'temor']","[1, 1, 1, 1, 1, 1, 1, 1]","['parir']","[1]",8,1,9,1
3588,"['academiar', 'californio', 'estimular', 'plano', 'reabertura', 'reabertura', 'reabrir', 'reabrir', 'recordar', 'taxar', 'taxar']","[1, 1, 1, 1, 2, 2, 2, 2, 1, 2, 2]","[]","[]",11,0,11,1
3592,"['balancar', 'consecutivo', 'consorcio', 'decorrencia', 'infectar', 'saudar']","[1, 1, 1, 1, 1, 1]","[]","[]",6,0,6,1
3594,"['anticorpo', 'contagioso', 'definitivo', 'observar', 'respostar', 'saudar', 'saudar', 'taxar', 'transmissao']","[1, 1, 1, 1, 1, 2, 2, 1, 1]","['versao']","[1]",9,1,10,1
3596,"['adesao', 'adversario', 'comissao', 'congresso', 'justicar', 'justicar', 'mendonca', 'ministrar', 'ministrar']","[1, 1, 1, 1, 2, 2, 1, 2, 2]","['amplament']","[1]",9,1,10,1
3599,"['atendido', 'atendido', 'companhia', 'consequencia', 'consumidor', 'decorrencia', 'fornecimento', 'juro', 'minimizar', 'prorrogacao', 'saneamento', 'saneamento', 'vencimento']","[2, 2, 1, 1, 1, 1, 1, 1, 1, 1, 2, 2, 1]","['usuario']","[1]",13,1,14,1
3601,"['alcolumbr', 'alvorar', 'conduta', 'crise', 'demap', 'dialogo', 'divergencia', 'enfrentamento', 'estrategico', 'henriqu', 'interpretar', 'ministrar', 'ministrar', 'ministrar', 'palacio', 'preparacao', 'saudar', 'saudar', 'sigla']","[1, 1, 1, 1, 1, 1, 1, 1, 1, 1, 1, 3, 3, 3, 1, 1, 2, 2, 1]","[]","[]",19,0,19,1
3604,"['aliquota', 'arrecadacao', 'client', 'decisao', 'decisao', 'decisao', 'entendimento', 'especifico', 'julgamento', 'kassio', 'ministrar', 'plenario', 'prever', 'supremo', 'supremo']","[1, 1, 1, 3, 3, 3, 1, 1, 1, 1, 1, 1, 1, 2, 2]","[]","[]",15,0,15,1
3605,"['belgica', 'domingo', 'domingo', 'espanha', 'espanha', 'europeu', 'levantamento', 'situacao']","[1, 2, 2, 2, 2, 1, 1, 1]","[]","[]",8,0,8,1
3606,"['complicacao', 'hospitalizar', 'sabado']","[1, 1, 1]","[]","[]",3,0,3,1
3609,"['adotada', 'aglomeracao', 'aglomeracao', 'associacao', 'economia', 'economia', 'economia', 'economia', 'enfrentamento', 'federar', 'inicialment', 'integrant', 'manutencao', 'prever', 'previsao', 'proposto', 'prorrogar', 'relativo', 'risco', 'suspenso', 'suspenso']","[1, 2, 2, 1, 4, 4, 4, 4, 1, 1, 1, 1, 1, 1, 1, 1, 1, 1, 1, 2, 2]","[]","[]",21,0,21,1
3610,"['alteracao', 'estagio', 'examinar', 'exercicio', 'infectar', 'michael', 'normalment', 'positivar', 'respiratorio']","[1, 1, 1, 1, 1, 1, 1, 1, 1]","['espalhar', 'usuario']","[1, 1]",9,2,11,1
3614,"['balancar', 'balancar', 'distrito', 'dosar', 'dosar', 'espirito', 'reducao', 'saudar']","[2, 2, 1, 2, 2, 1, 1, 1]","['auditoria']","[1]",8,1,9,1
3615,"['argumentar', 'calamidad', 'calamidad', 'calamidad', 'entendimento', 'especifico', 'especifico', 'levantamento', 'movimentacao', 'necessidad', 'parcelar', 'reconhecimento', 'recurso', 'regulamentar', 'situacao', 'supremo', 'supremo']","[1, 3, 3, 3, 1, 2, 2, 1, 1, 1, 1, 1, 1, 1, 1, 2, 2]","['legendar', 'sacar', 'sacar']","[1, 2, 2]",17,3,20,1
3618,"['autoridad', 'autorizacao', 'comissao', 'comorbidad', 'companhia', 'companhia', 'contrato', 'cooperacao', 'desenvolvimento', 'desenvolvimento', 'europeu', 'europeu', 'fase', 'habitant', 'imunizacao', 'imunizacao', 'imunizacao', 'imunizacao', 'inglaterra', 'inicialment', 'instituto', 'kong', 'kong', 'milho', 'milho', 'milho', 'none', 'periodo', 'pfizerbiontech', 'primario', 'profissionai', 'provincia', 'provincia', 'provincia', 'quatro', 'quatro', 'regiao', 'reuniao', 'transmissao']","[1, 1, 1, 1, 2, 2, 1, 1, 2, 2, 2, 2, 1, 1, 4, 4, 4, 4, 1, 1, 1, 2, 2, 3, 3, 3, 1, 1, 1, 1, 1, 3, 3, 3, 2, 2, 1, 1, 1]","['realment']","[1]",39,1,40,1
3619,"['regiao', 'regrar', 'relaxamento', 'reuniao', 'reuniao']","[1, 1, 1, 2, 2]","['casamentar', 'casamentar']","[2, 2]",5,2,7,1
3620,"['adicionar', 'sigla', 'vulnerabilidad']","[1, 1, 1]","['compartilhar', 'imagem']","[1, 1]",3,2,5,1
3627,"['alteracao', 'ausencia', 'crise', 'planar', 'respirador', 'saudar', 'saudar', 'wellington', 'wellington']","[1, 1, 1, 1, 1, 2, 2, 2, 2]","[]","[]",9,0,9,1
3630,"['barroso', 'colegiado', 'comissao', 'decisao', 'decisao', 'demmg', 'enfrentamento', 'folhar', 'instalacao', 'instalacao', 'ministrar', 'necessario', 'pacheco', 'pacheco', 'pacheco', 'pacheco', 'posturar', 'prever', 'regrar', 'supremo', 'supremo']","[1, 1, 1, 2, 2, 1, 1, 1, 2, 2, 1, 1, 4, 4, 4, 4, 1, 1, 1, 2, 2]","[]","[]",21,0,21,1
3631,"['decorrent', 'intensivo', 'internacao', 'internar', 'recordar', 'situacao']","[1, 1, 1, 1, 1, 1]","[]","[]",6,0,6,1
3637,"['calheiro', 'calheiro', 'comissao', 'comissao', 'compilar', 'depoimento', 'epidemiar', 'folhar', 'gabinet', 'integro', 'paralelo']","[2, 2, 2, 2, 1, 1, 1, 1, 1, 1, 1]","[]","[]",11,0,11,1
3640,"['augusto', 'florido', 'gabinet', 'heleno', 'heleno', 'heleno', 'isolar', 'negativar', 'positivar', 'viagem', 'viagem', 'viagem']","[1, 1, 1, 3, 3, 3, 1, 1, 1, 3, 3, 3]","[]","[]",12,0,12,1
3643,"['associacao', 'congresso', 'eventualment', 'globonew', 'lavagem', 'lavagem', 'lavagem', 'ministrar', 'supremo']","[1, 1, 1, 1, 3, 3, 3, 1, 1]","[]","[]",9,0,9,1
3644,"['boletim', 'boletim', 'comparacao', 'consolidar', 'consorcio', 'levantamento', 'quedo', 'quedo', 'saudar', 'saudar', 'saudar', 'situacao', 'tendencia', 'variacao', 'variacao']","[2, 2, 1, 1, 1, 1, 2, 2, 3, 3, 3, 1, 1, 2, 2]","[]","[]",15,0,15,1
3645,"['comparacao', 'consolidar', 'consorcio', 'feriar', 'levantamento', 'plantao', 'quedo', 'quedo', 'quedo', 'quedo', 'quedo', 'saudar', 'situacao', 'tendencia', 'variacao', 'variacao', 'vespera', 'vespera']","[1, 1, 1, 1, 1, 1, 5, 5, 5, 5, 5, 1, 1, 1, 2, 2, 2, 2]","['verificar']","[1]",18,1,19,1
3647,"['positivar', 'transmissao']","[1, 1]","[]","[]",2,0,2,1
3650,"['calheiro', 'comissao', 'comissao', 'crise', 'depoimento', 'excecao', 'inquerito', 'mdbal', 'palacio', 'previsto', 'sendo']","[1, 2, 2, 1, 1, 1, 1, 1, 1, 1, 1]","[]","[]",11,0,11,1
3651,"['avancar', 'avancar', 'cenario', 'destinar', 'destinar', 'elaborar', 'epidemiologico', 'epidemiologico', 'epidemiologico', 'estrategia', 'impactar', 'imunizacao', 'ministrar', 'parceria', 'periodo', 'proposto', 'reforcar', 'regiao', 'regiao', 'republico', 'reuniao', 'saudar', 'saudar', 'saudar', 'unanimidad']","[2, 2, 1, 2, 2, 1, 3, 3, 3, 1, 1, 1, 1, 1, 1, 1, 1, 2, 2, 1, 1, 3, 3, 3, 1]","[]","[]",25,0,25,1
3654,"['avancar', 'distrito', 'equipamento', 'regiao']","[1, 1, 1, 1]","[]","[]",4,0,4,1
3655,"['anteontem', 'celso', 'interlocutor', 'levantamento', 'liderar', 'mudanca', 'pastar', 'sigla', 'transicao', 'transicao', 'tucano']","[1, 1, 1, 1, 1, 1, 1, 1, 2, 2, 1]","[]","[]",11,0,11,1
3656,"['comportamento', 'consecutivo', 'patamar', 'plano', 'quarentenar', 'quarentenar', 'reabertura']","[1, 1, 1, 1, 2, 2, 1]","[]","[]",7,0,7,1
3657,"['avancar', 'escalar', 'expectativa', 'fase', 'fase', 'infectar', 'reforcar']","[1, 1, 1, 2, 2, 1, 1]","[]","[]",7,0,7,1
3662,"['californio', 'californio', 'internacao', 'intervalar', 'recordar', 'taxar']","[2, 2, 1, 1, 1, 1]","[]","[]",6,0,6,1
3664,"['arrecadacao', 'arrecadacao', 'articulacao', 'biliao', 'biliao', 'biliao', 'biliao', 'comissao', 'conformar', 'congresso', 'despesa', 'despesa', 'destinar', 'economia', 'economia', 'emendar', 'emendar', 'emendar', 'expectativa', 'fundeb', 'gued', 'ministrar', 'orcamentaria', 'planar', 'preliminar', 'preliminar', 'previsto', 'recurso']","[2, 2, 1, 4, 4, 4, 4, 1, 1, 1, 2, 2, 1, 2, 2, 3, 3, 3, 1, 1, 1, 1, 1, 1, 2, 2, 1, 1]","[]","[]",28,0,28,1
3665,"['adversario', 'bandeirant', 'especialment', 'manutencao', 'palacio', 'possibilidad', 'possibilidad', 'reforcar', 'sabatino', 'tucano', 'tucano']","[1, 1, 1, 1, 1, 2, 2, 1, 1, 2, 2]","[]","[]",11,0,11,1
3667,"['celso', 'celso', 'celso', 'coordenar', 'exministro', 'inquerito', 'justicar', 'levantamento', 'machadar', 'mello', 'mello', 'mello', 'ministrar', 'ministrar', 'ministrar', 'republico', 'reuniao', 'reuniao', 'reuniao', 'supremo']","[3, 3, 3, 1, 1, 1, 1, 1, 1, 3, 3, 3, 3, 3, 3, 1, 3, 3, 3, 1]","['gravacao', 'gravacao']","[2, 2]",20,2,22,1
3668,"['adotada', 'augusto', 'biliao', 'cenario', 'destinar', 'emergenciai', 'extraordinario', 'inicialment', 'ministrar', 'oficio', 'precedent', 'preocupacao', 'prever', 'prioritario', 'propagacao', 'recurso', 'republico', 'saudar', 'saudar', 'situacao', 'supremo']","[1, 1, 1, 1, 1, 1, 1, 1, 1, 1, 1, 1, 1, 1, 1, 1, 1, 2, 2, 1, 1]","[]","[]",21,0,21,1
3670,"['distrito', 'relacao']","[1, 1]","[]","[]",2,0,2,1
3671,"['academico', 'academico', 'academico', 'desenvolvimento', 'irregularidad', 'justicar', 'kassio', 'kassio', 'kassio', 'ministrar', 'oficialment', 'regiao']","[3, 3, 3, 1, 1, 1, 3, 3, 3, 1, 1, 1]","['imagem']","[1]",12,1,13,1
3675,"['andrea', 'elaborar', 'elaborar', 'exministro', 'implementar', 'infraestrutura', 'necessidad', 'planar', 'planar', 'reabertura', 'sabatino', 'sindicato']","[1, 2, 2, 1, 1, 1, 1, 2, 2, 1, 1, 1]","[]","[]",12,0,12,1
3676,"['congresso', 'constituicao', 'constituicao', 'discussao', 'expressar', 'interpretar', 'ministrar', 'ministrar', 'reuniao', 'supremo', 'viagem']","[1, 2, 2, 1, 1, 1, 2, 2, 1, 1, 1]","['atribuir', 'faccao']","[1, 1]",11,2,13,1
3677,"['avancar', 'cenario', 'decisao', 'infectar', 'painel', 'presenciar', 'presenciar', 'previsao', 'reabertura']","[1, 1, 1, 1, 1, 2, 2, 1, 1]","[]","[]",9,0,9,1
3678,"['absoluto', 'habitant', 'mudanca', 'percepcao', 'perspectivo', 'rejeicao', 'rejeicao']","[1, 1, 1, 1, 1, 2, 2]","['indignacao', 'sobrar']","[1, 1]",7,2,9,1
3681,"['biliao', 'crescimento', 'destacar', 'estatistico', 'impactar']","[1, 1, 1, 1, 1]","[]","[]",5,0,5,1
3687,"['economia', 'fez', 'gued', 'palacio']","[1, 1, 1, 1]","['enfim']","[1]",4,1,5,1
3688,"['governista']","[1]","[]","[]",1,0,1,1
3689,"['concedido', 'consequencia', 'decisao', 'distrito', 'emprestimo', 'entendimento', 'juro', 'justicar', 'magistrado', 'necessario', 'necessario', 'parcelar', 'risco', 'varar', 'vulneravel']","[1, 1, 1, 1, 1, 1, 1, 1, 1, 2, 2, 1, 1, 1, 1]","[]","[]",15,0,15,1
3690,"['escassez', 'estatistico', 'publicitario', 'pulmonar', 'respostar', 'sabado', 'saudar']","[1, 1, 1, 1, 1, 1, 1]","[]","[]",7,0,7,1
3691,"['comissao', 'disseminacao', 'domingo', 'expectativa', 'periodo', 'prorrogar', 'reuniao', 'toquio', 'toquio', 'toquio']","[1, 1, 1, 1, 1, 1, 1, 3, 3, 3]","[]","[]",10,0,10,1
3692,"['adulto', 'autonomia', 'autonomia', 'autorizacao', 'carat', 'cenario', 'contemplar', 'decorrencia', 'demandar', 'distrito', 'enfrentamento', 'enfrentamento', 'infraestrutura', 'necessario', 'necessario', 'recurso', 'regiao', 'saudar', 'saudar', 'saudar', 'saudar', 'saudar', 'temporario']","[1, 2, 2, 1, 1, 1, 1, 1, 1, 1, 2, 2, 1, 2, 2, 1, 1, 5, 5, 5, 5, 5, 1]","[]","[]",23,0,23,1
3693,"['reforcar', 'respostar', 'saudar']","[1, 1, 1]","['circular', 'ganhar']","[1, 1]",3,2,5,1
3694,"['aplicacao', 'aplicacao', 'atuam', 'coordenar', 'destinar', 'destinar', 'dosar', 'dosar', 'fundacao', 'instituto', 'materiaprima', 'oswaldo', 'parcelar', 'prioritario', 'saudar', 'saudar', 'saudar', 'saudar', 'saudar', 'vigilancia']","[2, 2, 1, 1, 2, 2, 2, 2, 1, 1, 1, 1, 1, 1, 5, 5, 5, 5, 5, 1]","[]","[]",20,0,20,1
3695,"['academiar', 'discussao', 'ministrar', 'movimentacao', 'movimentacao', 'normalment', 'periodo', 'restritivo', 'restritivo', 'saudar', 'saudar', 'suspensao', 'suspenso']","[1, 1, 1, 2, 2, 1, 1, 2, 2, 2, 2, 1, 1]","['boatar']","[1]",13,1,14,1
3696,"['acordo', 'imunizacao', 'necessario', 'situacao', 'superar']","[1, 1, 1, 1, 1]","[]","[]",5,0,5,1
3697,"['aglomeracao', 'ambientar', 'ambientar', 'fase', 'implementacao', 'necessidad', 'planar', 'prever', 'previsto', 'reabertura', 'reabertura', 'salao']","[1, 2, 2, 1, 1, 1, 1, 1, 1, 2, 2, 1]","['sobrar']","[1]",12,1,13,1
3701,"['acompanhamento', 'balancar', 'saudar', 'saudar']","[1, 1, 2, 2]","[]","[]",4,0,4,1
3702,"['ausencia', 'autoridad', 'biliao', 'economia', 'economia', 'gued', 'ministrar', 'necessario', 'planalto', 'planalto', 'privatizacao', 'vespera']","[1, 1, 1, 2, 2, 1, 1, 1, 2, 2, 1, 1]","['atribuir', 'despejar']","[1, 1]",12,2,14,1
3704,"['oficialment', 'prever']","[1, 1]","[]","[]",2,0,2,1
3708,"['autoridad', 'consequencia', 'contabilizar', 'crise', 'curvo', 'epidemiar', 'epidemiar', 'habito', 'internacao', 'periodo', 'quarentenar', 'quarentenar', 'quedo', 'relaxamento', 'relaxamento', 'situacao', 'situacao', 'situacao']","[1, 1, 1, 1, 1, 2, 2, 1, 1, 1, 2, 2, 1, 2, 2, 3, 3, 3]","['manchet', 'verificar']","[1, 1]",18,2,20,1
3709,"['adicionar', 'assintomatico', 'autoridad', 'regiao', 'superar']","[1, 1, 1, 1, 1]","[]","[]",5,0,5,1
3712,"['competicao', 'espanha', 'expectativa', 'ministrar', 'organizador', 'plano', 'possibilidad', 'santiago', 'saudar', 'temporada', 'temporada']","[1, 1, 1, 1, 1, 1, 1, 1, 1, 2, 2]","[]","[]",11,0,11,1
3713,"['calculo', 'cenario', 'crise', 'estimativo', 'ibg', 'perspectivo', 'piorar', 'quedo', 'quedo', 'situacao', 'taxar', 'taxar', 'taxar', 'taxar', 'taxar']","[1, 1, 1, 1, 1, 1, 1, 2, 2, 1, 5, 5, 5, 5, 5]","[]","[]",15,0,15,1
3714,"['domingo', 'expectativa', 'saudar', 'sigla']","[1, 1, 1, 1]","[]","[]",4,0,4,1
3715,"['associacao', 'associacao', 'associacao', 'decisao', 'decisao', 'decisao', 'flavio', 'informaco', 'medida', 'rachadinha', 'rachadinha', 'republicanosrj']","[3, 3, 3, 3, 3, 3, 1, 1, 1, 2, 2, 1]","['imagem']","[1]",12,1,13,1
3716,"['comissao', 'converso', 'inquerito', 'instalacao', 'jorg', 'supremo']","[1, 1, 1, 1, 1, 1]","[]","[]",6,0,6,1
3717,"['benjamin', 'quarentenar']","[1, 1]","['legendar']","[1]",2,1,3,1
3720,"['aglomeracao', 'augusto', 'descumprir', 'exigencia', 'folhar', 'integro', 'reforcar', 'republico']","[1, 1, 1, 1, 1, 1, 1, 1]","[]","[]",8,0,8,1
3722,"['aprovacao', 'bandeirant', 'desenvolvido', 'desenvolvimento', 'fase', 'instituto', 'instituto', 'palacio', 'parceiro', 'parceria', 'planar', 'reuter', 'saudar', 'saudar', 'saudar', 'situacao']","[1, 1, 1, 1, 1, 2, 2, 1, 1, 1, 1, 1, 3, 3, 3, 1]","[]","[]",16,0,16,1
3723,"['dedicar', 'domingo', 'domingo', 'metropolitano', 'positivar', 'regiao']","[1, 2, 2, 1, 1, 1]","[]","[]",6,0,6,1
3726,"['crise', 'habitant', 'humanitario', 'impactar', 'inicialment', 'quarentenar', 'quilometro', 'regiao']","[1, 1, 1, 1, 1, 1, 1, 1]","[]","[]",8,0,8,1
3727,"['ambientar', 'ambientar', 'cenario', 'internar', 'plantao', 'queiroz', 'queiroz']","[2, 2, 1, 1, 1, 2, 2]","['incendio']","[1]",7,1,8,1
3730,"['crise', 'metropolitano', 'saudar', 'videoconferencia']","[1, 1, 1, 1]","[]","[]",4,0,4,1
3731,"['anticorpo', 'crescimento', 'desenvolvimento', 'entendimento', 'exercicio', 'exercicio', 'exercicio', 'helen', 'impactar', 'importancia', 'infectar', 'isolar', 'molecular', 'positivar', 'saudar', 'sessao', 'submetido', 'transferir', 'treinamento', 'treinar']","[1, 1, 1, 1, 3, 3, 3, 1, 1, 1, 1, 1, 1, 1, 1, 1, 1, 1, 1, 1]","['cobaia', 'cobaia']","[2, 2]",20,2,22,1
3732,"['anteriorment', 'biliao', 'equipamento', 'equipamento', 'infraestrutura', 'proposto', 'vulnerabilidad']","[1, 1, 2, 2, 1, 1, 1]","['huawei', 'huawei', 'huawei']","[3, 3, 3]",7,3,10,1
3735,"['folhar', 'integro', 'suspeito', 'suspenso']","[1, 1, 1, 1]","['fraudar']","[1]",4,1,5,1
3738,"['flexibilizacao', 'flexibilizacao', 'orientacao', 'orientacao', 'precaucao', 'precaucao']","[2, 2, 2, 2, 2, 2]","[]","[]",6,0,6,1
3739,"['acordo', 'associacao', 'crise', 'crise', 'economia', 'observar', 'perspectivo', 'prazo', 'trimestr', 'trimestr']","[1, 1, 2, 2, 1, 1, 1, 1, 2, 2]","[]","[]",10,0,10,1
3740,"['afetado', 'correspondent', 'domingo', 'epidemiar', 'negativar', 'prever', 'quarentenar', 'sabado', 'situacao', 'viagem']","[1, 1, 1, 1, 1, 1, 1, 1, 1, 1]","[]","[]",10,0,10,1
3742,"['margem']","[1]","[]","[]",1,0,1,1
3743,"['adicionar', 'especifico', 'funcao', 'recurso']","[1, 1, 1, 1]","['compartilhar', 'usuario', 'usuario', 'versao']","[1, 2, 2, 1]",4,4,8,1
3744,"['decisao', 'decisao', 'decisao', 'federativo', 'lewandowski', 'lewandowski', 'ministrar', 'precaucao', 'recurso', 'recurso', 'ricardo', 'saudar', 'supremo']","[3, 3, 3, 1, 2, 2, 1, 1, 2, 2, 1, 1, 1]","[]","[]",13,0,13,1
3746,"['aprovacao', 'apurar', 'comissao', 'converso', 'converso', 'converso', 'diariament', 'diariament', 'enfrentamento', 'exministro', 'fabricio', 'flavio', 'flavio', 'flavio', 'flavio', 'flavio', 'gabinet', 'governista', 'governista', 'humberto', 'humberto', 'humberto', 'humberto', 'margem', 'paralelo', 'paralelo', 'queiroz', 'queiroz', 'queiroz', 'rachadinha', 'randolf', 'randolf', 'randolf', 'republico', 'republico', 'requerimento', 'requerimento', 'requerimento', 'requerimento', 'requerimento', 'requerimento', 'saudar', 'saudar', 'sessao', 'sugestao', 'vieira']","[1, 1, 1, 3, 3, 3, 2, 2, 1, 1, 1, 5, 5, 5, 5, 5, 1, 2, 2, 4, 4, 4, 4, 1, 2, 2, 3, 3, 3, 1, 3, 3, 3, 2, 2, 6, 6, 6, 6, 6, 6, 2, 2, 1, 1, 1]","['crer']","[1]",46,1,47,1
3747,"['instituto']","[1]","['capturar', 'imagem', 'imagem', 'imagem', 'imagem', 'imagem', 'imagem', 'imagem']","[1, 7, 7, 7, 7, 7, 7, 7]",1,8,9,1
3749,"['biliao', 'impactar', 'pulmonar', 'pulmonar', 'pulmonar', 'reuter', 'risco', 'saudar', 'saudar', 'saudar', 'saudar']","[1, 1, 3, 3, 3, 1, 1, 4, 4, 4, 4]","['parir']","[1]",11,1,12,1
3751,"['aplicacao', 'aplicacao', 'aplicacao', 'aumento', 'esquema', 'estrategia', 'etapa', 'importancia', 'imunizacao', 'necessidad', 'necessidad', 'orientacao', 'prazo', 'quatro', 'quatro', 'reforca']","[3, 3, 3, 1, 1, 1, 1, 1, 1, 2, 2, 1, 1, 2, 2, 1]","[]","[]",16,0,16,1
3754,"['associacao', 'desenvolvimento', 'distrito', 'distrito', 'enfermagem', 'etapa', 'fundacao', 'instituto', 'roraima', 'roraima', 'saneamento', 'saudar', 'saudar', 'saudar', 'saudar']","[1, 1, 2, 2, 1, 1, 1, 1, 2, 2, 1, 4, 4, 4, 4]","['inscricao']","[1]",15,1,16,1
3758,"['anticorpo', 'destacar', 'epidemiar', 'estagio', 'infectar', 'inglaterra', 'liderar', 'transmissao']","[1, 1, 1, 1, 1, 1, 1, 1]","['espalhar']","[1]",8,1,9,1
3759,"['apurar', 'comparacao', 'confederacao', 'desafio', 'internar', 'intubacao', 'intubacao', 'quedo', 'regiao', 'respostar']","[1, 1, 1, 1, 1, 2, 2, 1, 1, 1]","[]","[]",10,0,10,1
3760,"['colunista', 'congresso', 'estimular', 'posicionamento']","[1, 1, 1, 1]","[]","[]",4,0,4,1
3761,"['antonio', 'autoridad', 'comissao', 'comissao', 'comprometido', 'discussao', 'enfrentamento', 'epidemiologico', 'externo', 'molecular', 'oliveira', 'reclamacao', 'saudar', 'saudar', 'saudar', 'vigilancia', 'vigilancia']","[1, 1, 2, 2, 1, 1, 1, 1, 1, 1, 1, 1, 3, 3, 3, 2, 2]","[]","[]",17,0,17,1
3763,"['bruto', 'consequencia', 'impulsionar', 'internar', 'ministrar', 'reuniao']","[1, 1, 1, 1, 1, 1]","[]","[]",6,0,6,1
3765,"['autoridad', 'colombio', 'compromisso', 'coreia', 'decisao', 'iniciativo', 'iniciativo', 'itamarati', 'regiao']","[1, 1, 1, 1, 1, 2, 2, 1, 1]","['equador', 'tampouco']","[1, 1]",9,2,11,1
3766,"['desafiar', 'saudar', 'situacao']","[1, 1, 1]","['secreto']","[1]",3,1,4,1
3767,"['client', 'client', 'desafiar', 'distrito', 'jornada', 'reabrir', 'turistico']","[2, 2, 1, 1, 1, 1, 1]","['boatar', 'boatar']","[2, 2]",7,2,9,1
3768,"['capitar', 'diminuicao', 'expectativa', 'legislativo', 'legislativo']","[1, 1, 1, 2, 2]","['legendar']","[1]",5,1,6,1
3769,"['alcolumbr', 'demap', 'demmg', 'expectativa', 'favorito', 'pacheco', 'pacheco', 'republico']","[1, 1, 1, 1, 1, 2, 2, 1]","[]","[]",8,0,8,1
3771,"['aglomeracao', 'aplicacao', 'capitar', 'capitar', 'conformar', 'dosar', 'dosar', 'dosar', 'dosar', 'dosar', 'imunizacao', 'instituto', 'paralisar', 'paralisar', 'regiao', 'saudar', 'saudar', 'suspensao']","[1, 1, 2, 2, 1, 5, 5, 5, 5, 5, 1, 1, 2, 2, 1, 2, 2, 1]","[]","[]",18,0,18,1
3772,"['batalhar', 'levantamento', 'previo', 'previo', 'revisar', 'saudar']","[1, 1, 2, 2, 1, 1]","['versao']","[1]",6,1,7,1
3775,"['adesao', 'aspecto', 'atuacao', 'autoridad', 'biliao', 'correspondent', 'decisao', 'decisao', 'diariament', 'distrito', 'efetividad', 'elaborar', 'elaborar', 'elaborar', 'elaborar', 'enfrentamento', 'enfrentamento', 'esperancar', 'estrategia', 'estrategia', 'expansao', 'feriar', 'feriar', 'feriar', 'feriar', 'flavio', 'implementacao', 'imunizacao', 'integrant', 'justicar', 'justicar', 'lorenzoni', 'ministrar', 'ministrar', 'ministrar', 'ministrar', 'onyx', 'orientacao', 'orientacao', 'pastar', 'planar', 'planar', 'planar', 'planar', 'planar', 'planar', 'planar', 'planar', 'planar', 'pratico', 'prazo', 'preocupacao', 'prever', 'prever', 'previo', 'previsto', 'previsto', 'publicitario', 'publicitario', 'publicitario', 'queiroga', 'regiao', 'rocha', 'saudar', 'saudar', 'saudar', 'saudar', 'saudar', 'secom', 'secom', 'secom', 'secom', 'secretariager', 'situacao', 'substituicao', 'tramitacao', 'transmissao', 'transmissao', 'varar', 'vespera']","[1, 1, 1, 1, 1, 1, 2, 2, 1, 1, 1, 4, 4, 4, 4, 2, 2, 1, 2, 2, 1, 4, 4, 4, 4, 1, 1, 1, 1, 2, 2, 1, 4, 4, 4, 4, 1, 2, 2, 1, 9, 9, 9, 9, 9, 9, 9, 9, 9, 1, 1, 1, 2, 2, 1, 2, 2, 3, 3, 3, 1, 1, 1, 5, 5, 5, 5, 5, 4, 4, 4, 4, 1, 1, 1, 1, 2, 2, 1, 1]","['descricao', 'espalhar', 'imagem', 'imagem']","[1, 1, 2, 2]",80,4,84,1
3780,"['apurar', 'gabinet', 'inicialment', 'lewandowski', 'lewandowski', 'ministrar', 'negativar', 'ricardo', 'supremo']","[1, 1, 1, 2, 2, 1, 1, 1, 1]","['sortear']","[1]",9,1,10,1
3783,"['necessario']","[1]","[]","[]",1,0,1,1
3785,"['adesao', 'adversario', 'alcolumbr', 'alcolumbr', 'anuncio', 'demap', 'demmg', 'flavio', 'pacheco', 'pacheco', 'pacheco', 'palacio', 'planalto', 'planalto', 'precandidato', 'queixar']","[1, 1, 2, 2, 1, 1, 1, 1, 3, 3, 3, 1, 2, 2, 1, 1]","[]","[]",16,0,16,1
3792,"['afp', 'gabinet', 'notificar', 'notificar', 'preventivo', 'quarentenar', 'rotina', 'santiago']","[1, 1, 2, 2, 1, 1, 1, 1]","[]","[]",8,0,8,1
3793,"['claudio', 'deltan', 'determinacao', 'dialogo', 'dialogo', 'exjuiz', 'forcatarefa', 'integrant', 'integro', 'lewandowski', 'martim', 'ministrar', 'ricardo', 'supremo']","[1, 1, 1, 2, 2, 1, 1, 1, 1, 1, 1, 1, 1, 1]","['arquivar', 'arquivar', 'verificar', 'wagner']","[2, 2, 1, 1]",14,4,18,1
3797,"['ambito', 'aurelio', 'corpu', 'curso', 'decisao', 'decisao', 'edson', 'fachin', 'fachin', 'fachin', 'fachin', 'fez', 'habea', 'julgamento', 'julgamento', 'lewandowski', 'processo', 'processo', 'processo', 'proprio', 'recurso', 'resultado', 'ricardo', 'sendo', 'supremo', 'suspeicao', 'suspeicao', 'tambem', 'turma', 'turma', 'turma', 'turma']","[1, 1, 1, 1, 2, 2, 1, 4, 4, 4, 4, 1, 1, 2, 2, 1, 3, 3, 3, 1, 1, 1, 1, 1, 1, 2, 2, 1, 4, 4, 4, 4]","[]","[]",32,0,32,1
3800,"['acumular', 'aspecto', 'constatar', 'crise', 'crise', 'dificuldad', 'economia', 'impacto', 'indicador', 'instituto', 'instituto', 'levantamento', 'reconhecimento', 'situacao', 'tendencia', 'vulnerabilidad', 'vulneravel']","[1, 1, 1, 2, 2, 1, 1, 1, 1, 2, 2, 1, 1, 1, 1, 1, 1]","[]","[]",17,0,17,1
3802,"['isolar', 'orientacao', 'portavoz', 'portavoz', 'primeiroministro', 'primeiroministro', 'reportar']","[1, 1, 2, 2, 2, 2, 1]","[]","[]",7,0,7,1
3804,"['adhanom', 'biliao', 'disseminacao', 'domingo', 'habitant', 'iniciativo', 'lancamento', 'moderno', 'moderno', 'pfizerbiontech', 'pfizerbiontech', 'primeiroministro', 'proporcao', 'saudar', 'saudar', 'tedro', 'trimestr']","[1, 1, 1, 1, 1, 1, 1, 2, 2, 2, 2, 1, 1, 2, 2, 1, 1]","['compartilhar']","[1]",17,1,18,1
3809,"['bastidor', 'enfrentamento', 'justicar', 'recurso', 'saudar', 'tucano', 'viagem']","[1, 1, 1, 1, 1, 1, 1]","['abusar', 'imagem', 'pego']","[1, 1, 1]",7,3,10,1
3810,"['advocaciager', 'congresso', 'decisao', 'fez', 'integrant', 'sociai', 'sociai', 'supremo', 'suspensao']","[1, 1, 1, 1, 1, 2, 2, 1, 1]","[]","[]",9,0,9,1
3811,"['aplicacao', 'atrasar', 'avancar', 'capitar', 'capitar', 'condicao', 'consorcio', 'diminuicao', 'domingo', 'domingo', 'dosar', 'dosar', 'dosar', 'dosar', 'equivalent', 'imunizacao', 'interrupcao', 'ritmar', 'suspenso']","[1, 1, 1, 2, 2, 1, 1, 1, 2, 2, 4, 4, 4, 4, 1, 1, 1, 1, 1]","[]","[]",19,0,19,1
3814,"['aliviar', 'equivalent', 'preocupacao', 'quarentenar', 'situacao']","[1, 1, 1, 1, 1]","['ilustrar', 'usuario']","[1, 1]",5,2,7,1
3816,"['ambito', 'autorizacao', 'fundacao', 'fundacao', 'isolar', 'isolar', 'isolar', 'prever', 'propagacao', 'propagacao', 'saudar', 'temporario']","[1, 1, 2, 2, 3, 3, 3, 1, 2, 2, 1, 1]","[]","[]",12,0,12,1
3817,"['comportamento', 'disseminacao', 'economia', 'fase', 'fase', 'flexibilizacao', 'intensivo', 'planar', 'reabertura', 'reabertura', 'reabertura', 'regrar', 'saudar', 'taxar', 'taxar']","[1, 1, 1, 2, 2, 1, 1, 1, 3, 3, 3, 1, 1, 2, 2]","[]","[]",15,0,15,1
3821,"['antecipar', 'atuacao', 'comissao', 'comissao', 'congresso', 'enfermagem', 'externo', 'federar', 'instituto', 'instituto', 'ministrar', 'ministrar', 'monitoramento', 'painel', 'pastar', 'presenciar', 'recurso', 'ribeiro', 'ribeiro', 'ribeiro', 'saudar', 'suspensao', 'universitario']","[1, 1, 2, 2, 1, 1, 1, 1, 2, 2, 2, 2, 1, 1, 1, 1, 1, 3, 3, 3, 1, 1, 1]","[]","[]",23,0,23,1
3822,"['aurelio', 'colegiado', 'colunista', 'mello', 'periodo', 'supremo']","[1, 1, 1, 1, 1, 1]","[]","[]",6,0,6,1
3824,"['acumular', 'impulsionar', 'interino', 'ministrar', 'ministrar', 'piorar', 'recordar', 'saudar', 'saudar', 'saudar', 'saudar', 'situacao']","[1, 1, 1, 2, 2, 1, 1, 4, 4, 4, 4, 1]","[]","[]",12,0,12,1
3825,"['afp', 'complicacao', 'fluxo', 'infectar', 'intensivo', 'intensivo', 'reportar', 'taxar']","[1, 1, 1, 1, 2, 2, 1, 1]","[]","[]",8,0,8,1
3829,"[]","[]","['circular', 'compartilhar', 'imagem', 'imagem']","[1, 1, 2, 2]",0,4,4,1
3831,"['client', 'colaborar', 'implementar', 'importancia', 'imunizacao', 'orientacao', 'parceria', 'reforcar', 'saudar']","[1, 1, 1, 1, 1, 1, 1, 1, 1]","[]","[]",9,0,9,1
3832,"['cenario', 'cerimonia', 'cerimonia', 'cerimonia', 'etapa']","[1, 3, 3, 3, 1]","[]","[]",5,0,5,1
3835,"['caxia', 'caxia', 'duqu', 'duqu', 'goncalo', 'goncalo', 'infectar', 'investigacao', 'liderar', 'prorrogar', 'redondo', 'redondo', 'saudar', 'wilson', 'witzel']","[2, 2, 2, 2, 2, 2, 1, 1, 1, 1, 2, 2, 1, 1, 1]","[]","[]",15,0,15,1
3837,"['ambito', 'contencao', 'destacar', 'disseminacao', 'especifico', 'fornecimento', 'insuficient', 'modelo', 'periodo', 'quedo', 'reducao', 'reducao', 'regiao', 'regiao', 'regiao', 'situacao', 'transmissao', 'transmissao', 'velocidad']","[1, 1, 1, 1, 1, 1, 1, 1, 1, 1, 2, 2, 3, 3, 3, 1, 2, 2, 1]","['disseminar']","[1]",19,1,20,1
3838,"['apostar', 'calculo', 'calculo', 'equipamento', 'equipamento', 'impactar', 'intervalar', 'manutencao', 'suspeito', 'temporariament']","[1, 2, 2, 2, 2, 1, 1, 1, 1, 1]","['ganhar']","[1]",10,1,11,1
3840,"['esperancar', 'expressar', 'parceria', 'possibilidad', 'saudar', 'saudar']","[1, 1, 1, 1, 2, 2]","[]","[]",6,0,6,1
3841,"['privar', 'privar']","[2, 2]","['espalhar']","[1]",2,1,3,1
3845,"['confirmado', 'oficialment', 'regiao', 'sido', 'situacao']","[1, 1, 1, 1, 1]","[]","[]",5,0,5,1
3846,"['demandar', 'especialment', 'hospitalizacao', 'hospitalizacao', 'igualitario', 'importancia', 'martim', 'relativo', 'respectivament', 'saudar', 'saudar', 'saudar', 'saudar', 'saudar', 'saudar', 'subir']","[1, 1, 2, 2, 1, 1, 1, 1, 1, 6, 6, 6, 6, 6, 6, 1]","[]","[]",16,0,16,1
3847,"['aglomeracao', 'dificuldad', 'guaruja', 'normalment', 'parcelar']","[1, 1, 1, 1, 1]","['verificar']","[1]",5,1,6,1
3849,"['consequencia', 'crise', 'infancia', 'interrupcao', 'piorar', 'proporcao', 'situacao', 'situacao']","[1, 1, 1, 1, 1, 1, 2, 2]","['casamentar', 'menino', 'menino', 'menino']","[1, 3, 3, 3]",8,4,12,1
3851,"['consorcio', 'infectar', 'respectivament', 'superar']","[1, 1, 1, 1]","[]","[]",4,0,4,1
3855,"['atuam', 'funcionamento', 'infraestrutura', 'pagamento', 'pagamento', 'servidor']","[1, 1, 1, 2, 2, 1]","[]","[]",6,0,6,1
3856,"['condenacao', 'decisao', 'decisao', 'distrito', 'henriqu', 'justicar', 'pereira', 'prever', 'sentenca']","[1, 2, 2, 1, 1, 1, 1, 1, 1]","[]","[]",9,0,9,1
3857,"['definitivo', 'diagnosticar', 'negativar', 'negativar', 'positivar', 'positivar']","[1, 1, 2, 2, 2, 2]","['zincar']","[1]",6,1,7,1
3858,"['arthur', 'estrategico', 'lira', 'lira', 'ppal', 'privatizacao', 'privatizacao', 'privatizacao', 'provisorio', 'reforcar', 'vetar']","[1, 1, 2, 2, 1, 3, 3, 3, 1, 1, 1]","[]","[]",11,0,11,1
3859,"['internar', 'provincia']","[1, 1]","[]","[]",2,0,2,1
3861,"['aglomeracao', 'cenario', 'higienizacao', 'necessario', 'necessidad', 'prioridad', 'saudar', 'saudar', 'situacao', 'situacao', 'suspenso']","[1, 1, 1, 1, 1, 1, 2, 2, 2, 2, 1]","[]","[]",11,0,11,1
3862,"['adiamento', 'anuncio', 'apurar', 'competicao', 'consolidar', 'crise', 'decisao', 'destacar', 'impactar', 'minimizar', 'orientacao', 'proposto', 'reducao', 'reducao', 'reuniao', 'situacao']","[1, 1, 1, 1, 1, 1, 1, 1, 1, 1, 1, 1, 2, 2, 1, 1]","['patrocinador']","[1]",16,1,17,1
3865,"['despesa', 'pagamento', 'reducao', 'reducao', 'temporario']","[1, 1, 2, 2, 1]","[]","[]",5,0,5,1
3866,"['facilitar', 'taxar']","[1, 1]","[]","[]",2,0,2,1
3867,"['apoio', 'certeza', 'concorrent', 'etapa', 'excecao', 'exministro', 'relacao', 'tatto']","[1, 1, 1, 1, 1, 1, 1, 1]","[]","[]",8,0,8,1
3869,"['entregu', 'fundacao', 'instituto', 'oswaldo', 'previsao', 'saudar', 'voo']","[1, 1, 1, 1, 1, 1, 1]","['checagem']","[1]",7,1,8,1
3871,"['aprovacao', 'celso', 'desigualdad', 'federar', 'transferencia']","[1, 1, 1, 1, 1]","[]","[]",5,0,5,1
3873,"['boletim', 'boletim', 'comparacao', 'comparacao', 'conformar', 'dengu', 'dengu', 'dengu', 'epidemiologico', 'infectar', 'notificar', 'notificar', 'pastar', 'periodo', 'periodo', 'saudar']","[2, 2, 2, 2, 1, 3, 3, 3, 1, 1, 2, 2, 1, 2, 2, 1]","[]","[]",16,0,16,1
3880,"['acompanhamento', 'assistencia', 'biliao', 'biliao', 'comunitario', 'comunitario', 'cronica', 'enfrentamento', 'enfrentamento', 'estrategia', 'hipertensao', 'mantido', 'modelo', 'oferecido', 'previsao', 'primario', 'recurso', 'reforcar', 'rotina', 'saudar', 'saudar', 'saudar', 'saudar']","[1, 1, 2, 2, 2, 2, 1, 2, 2, 1, 1, 1, 1, 1, 1, 1, 1, 1, 1, 4, 4, 4, 4]","[]","[]",23,0,23,1
3881,"['balancar', 'diariament', 'estimativo', 'fase', 'fase', 'fase', 'internacao', 'planar', 'regiao', 'restritivo']","[1, 1, 1, 3, 3, 3, 1, 1, 1, 1]","[]","[]",10,0,10,1
3886,"['associacao', 'compilar', 'conformar', 'equivalent', 'intensivo', 'intensivo', 'intensivo', 'internar', 'intubacao', 'levantamento', 'observar', 'privar', 'privar', 'privar', 'regiao', 'saudar', 'saudar', 'situacao', 'taxar', 'taxar', 'ventilacao']","[1, 1, 1, 1, 3, 3, 3, 1, 1, 1, 1, 3, 3, 3, 1, 2, 2, 1, 2, 2, 1]","[]","[]",21,0,21,1
3887,"['boletim', 'intensivo', 'internar', 'recuperacao', 'saudar', 'ventilacao']","[1, 1, 1, 1, 1, 1]","[]","[]",6,0,6,1
3889,"['adicionar', 'adversario', 'agravar', 'biliao', 'biliao', 'legislativo', 'pib', 'republico', 'saudar', 'saudar', 'turma']","[1, 1, 1, 2, 2, 1, 1, 1, 2, 2, 1]","[]","[]",11,0,11,1
3891,"['comparacao', 'hospitalizar', 'significativo', 'significativo']","[1, 1, 2, 2]","[]","[]",4,0,4,1
3894,"['esquema', 'investigacao', 'justicar']","[1, 1, 1]","[]","[]",3,0,3,1
3896,"['argumentar', 'arrecadacao', 'biliao', 'decisao', 'disseminacao', 'economia', 'espirito', 'ministrar', 'ministrar', 'recurso', 'reflexo', 'supremo', 'supremo']","[1, 1, 1, 1, 1, 1, 1, 2, 2, 1, 1, 2, 2]","[]","[]",13,0,13,1
3897,"['domingo', 'economia', 'gued', 'gued', 'ministrar', 'ministrar', 'ministrar', 'piorar', 'privatizacao', 'privatizacao', 'privatizacao', 'salao']","[1, 1, 2, 2, 3, 3, 3, 1, 3, 3, 3, 1]","['sobrar']","[1]",12,1,13,1
3899,"['atuacao', 'atuacao', 'atuam', 'autonomia', 'celebrar', 'compromisso', 'compromisso', 'domingo', 'estrategia', 'expectativa', 'iniciativo', 'primario', 'primario', 'prioritario', 'reforcar', 'reforcar', 'reforcar', 'regulamentar', 'saudar', 'saudar', 'saudar', 'saudar', 'saudar', 'saudar', 'saudar', 'saudar', 'saudar', 'saudar', 'saudar', 'saudar', 'saudar', 'saudar']","[2, 2, 1, 1, 1, 2, 2, 1, 1, 1, 1, 2, 2, 1, 3, 3, 3, 1, 14, 14, 14, 14, 14, 14, 14, 14, 14, 14, 14, 14, 14, 14]","[]","[]",32,0,32,1
3905,"['aglomeracao', 'associacao', 'client', 'mudanca', 'orientacao', 'pagamento', 'pagamento', 'pagamento', 'parcelar', 'proposto']","[1, 1, 1, 1, 1, 3, 3, 3, 1, 1]","['sacar']","[1]",10,1,11,1
3906,"['condicao', 'crescimento', 'demandar', 'exercicio', 'hipertensao', 'mudanca', 'necessario', 'obesidad', 'obesidad', 'obesidad', 'saudar', 'saudar', 'saudar']","[1, 1, 1, 1, 1, 1, 1, 3, 3, 3, 3, 3, 3]","[]","[]",13,0,13,1
3909,"['apurar', 'celso', 'exministro', 'gabinet', 'inquerito', 'interferencia', 'investigacao', 'justicar', 'mello', 'ministrar', 'ministrar', 'palacio', 'planalto', 'preocupacao', 'republico', 'republico', 'reuniao', 'supremo']","[1, 1, 1, 1, 1, 1, 1, 1, 1, 2, 2, 1, 1, 1, 2, 2, 1, 1]","['gravacao']","[1]",18,1,19,1
3911,"['antonio', 'anvisa', 'anvisa', 'anvisa', 'anvisa', 'autoridad', 'comissao', 'compromisso', 'conformar', 'converso', 'diagnosticar', 'externo', 'inicialment', 'palacio', 'pereira', 'planalto', 'positivar', 'positivar', 'prescricao', 'presenca', 'presenciar', 'reuniao', 'reuniao', 'reuniao', 'rossi', 'substituto', 'videoconferencia', 'vigilancia']","[1, 4, 4, 4, 4, 1, 1, 1, 1, 1, 1, 1, 1, 1, 1, 1, 2, 2, 1, 1, 1, 3, 3, 3, 1, 1, 1, 1]","[]","[]",28,0,28,1
3914,"['airlin', 'companhia', 'companhia', 'companhia', 'modelo', 'paralisar', 'saneamento', 'saudar', 'voo']","[1, 3, 3, 3, 1, 1, 1, 1, 1]","['capturar']","[1]",9,1,10,1
3915,"['decisao', 'desenvolvimento', 'domingo', 'economia', 'economia', 'economia', 'economia', 'emprestimo', 'emprestimo', 'estrategia', 'estrategia', 'gued', 'individuar', 'ministrar', 'provisorio', 'recurso', 'recurso', 'recurso', 'suportar', 'tesourar', 'tesourar', 'videoconferencia']","[1, 1, 1, 4, 4, 4, 4, 2, 2, 2, 2, 1, 1, 1, 1, 3, 3, 3, 1, 2, 2, 1]","[]","[]",22,0,22,1
3918,"['depoimento', 'depoimento', 'enfrentamento', 'exministro', 'henriqu', 'integrant', 'integro', 'nelson', 'rejeitar', 'respostar', 'saudar', 'teich', 'wajngarten', 'wajngarten']","[2, 2, 1, 1, 1, 1, 1, 1, 1, 1, 1, 1, 2, 2]","['versao']","[1]",14,1,15,1
3923,"['agravamento', 'cerimonia', 'decorrencia', 'internar', 'internar', 'transferir']","[1, 1, 1, 2, 2, 1]","[]","[]",6,0,6,1
3924,"['balancar', 'boletim', 'conjuntar', 'consorcio', 'consorcio', 'contabilizar', 'contabilizar', 'inedito', 'levantamento', 'oficialment', 'roraima', 'saudar']","[1, 1, 1, 2, 2, 2, 2, 1, 1, 1, 1, 1]","[]","[]",12,0,12,1
3925,"['contabilizar', 'testagem']","[1, 1]","[]","[]",2,0,2,1
3927,"['balancar', 'epicentro', 'infectar', 'respectivament']","[1, 1, 1, 1]","[]","[]",4,0,4,1
3933,"['adesao', 'desafiar', 'esquema', 'esquema', 'esquema', 'instituto', 'opcao', 'prever', 'previsao', 'saudar', 'sigla']","[1, 1, 3, 3, 3, 1, 1, 1, 1, 1, 1]","[]","[]",11,0,11,1
3936,"['alternativo', 'concedido', 'lesao', 'mudanca', 'mudanca', 'periodo', 'regrar', 'regrar', 'regrar', 'regrar', 'suspensao', 'suspensao', 'suspenso', 'suspenso']","[1, 1, 1, 2, 2, 1, 4, 4, 4, 4, 2, 2, 2, 2]","['cnh', 'cnh', 'motorista', 'motorista', 'motorista', 'motorista']","[2, 2, 4, 4, 4, 4]",14,6,20,1
3938,"['agravar', 'aliviar', 'associacao', 'ausencia', 'crise', 'crise', 'desafio', 'dificuldad', 'iniciativo', 'precisao', 'preconceito', 'preocupacao', 'sabado', 'saudad', 'situacao']","[1, 1, 1, 1, 2, 2, 1, 1, 1, 1, 1, 1, 1, 1, 1]","['idioma']","[1]",15,1,16,1
3939,"['autorizacao', 'autorizacao', 'autorizacao', 'autorizacao', 'autorizacao', 'contabilizar', 'epidemiar', 'extensao', 'extensao', 'prorrogar', 'prorrogar', 'prorrogar', 'prorrogar', 'provisorio', 'quarentenar', 'suspenso', 'trimestr']","[5, 5, 5, 5, 5, 1, 1, 2, 2, 4, 4, 4, 4, 1, 1, 1, 1]","[]","[]",17,0,17,1
3943,"['ausencia', 'compromisso', 'flavio', 'flavio', 'flavio', 'marinhar', 'marinhar', 'possibilidad', 'republicanosrj']","[1, 1, 3, 3, 3, 2, 2, 1, 1]","[]","[]",9,0,9,1
3944,"['adotada', 'confederacao', 'decisao', 'desempenhar', 'disseminacao', 'emergenciai', 'estagio', 'flexibilizacao', 'inglaterra', 'levantamento', 'levantamento', 'relaxar']","[1, 1, 1, 1, 1, 1, 1, 1, 1, 2, 2, 1]","['questionario']","[1]",12,1,13,1
3946,"['autoridad', 'calamidad', 'investigacao', 'organizador', 'positivar', 'privar', 'propagacao', 'reuniao', 'rocha', 'sabado']","[1, 1, 1, 1, 1, 1, 1, 1, 1, 1]","[]","[]",10,0,10,1
3947,"['colunista', 'dosar', 'funcao', 'internacao', 'internacao', 'reabrir', 'rossi', 'souza']","[1, 1, 1, 2, 2, 1, 1, 1]","[]","[]",8,0,8,1
3954,"['hipertensao', 'positivar', 'positivar', 'respiratorio', 'saudar']","[1, 2, 2, 1, 1]","[]","[]",5,0,5,1
3955,"['advocaciager', 'distrito', 'distrito', 'exigencia', 'justicar', 'magistrado', 'magistrado', 'necessidad', 'reforcar', 'regiao', 'regrar']","[1, 2, 2, 1, 1, 2, 2, 1, 1, 1, 1]","[]","[]",11,0,11,1
3956,"['circulacao', 'distrito', 'fase', 'implementacao', 'implementar', 'investigacao', 'medeiro', 'mutacao', 'mutacao', 'pastar', 'saudar', 'saudar', 'saudar', 'sequenciamento', 'vigilancia']","[1, 1, 1, 1, 1, 1, 1, 2, 2, 1, 3, 3, 3, 1, 1]","[]","[]",15,0,15,1
3957,"['congresso', 'crise', 'crise', 'depressao', 'destacar', 'economia', 'enfatizar', 'planar', 'planar', 'prazo', 'recuperacao']","[1, 2, 2, 1, 1, 1, 1, 2, 2, 1, 1]","[]","[]",11,0,11,1
3958,"['decisao', 'espanha', 'espanha', 'espanha', 'europeu', 'extensao', 'ministrar', 'parceiro', 'turista']","[1, 3, 3, 3, 1, 1, 1, 1, 1]","[]","[]",9,0,9,1
3959,"['circulacao', 'prazo', 'reducao', 'saudar', 'saudar', 'saudar', 'transmissao']","[1, 1, 1, 3, 3, 3, 1]","[]","[]",7,0,7,1
3961,"['antecipar', 'crise', 'discussao', 'globonew', 'legislativo', 'ministrar', 'presenca', 'prtb', 'republico']","[1, 1, 1, 1, 1, 1, 1, 1, 1]","[]","[]",9,0,9,1
3965,"['afetado', 'complicacao', 'infectar', 'infectar', 'levantamento', 'recordar', 'sabado', 'superar']","[1, 1, 2, 2, 1, 1, 1, 1]","[]","[]",8,0,8,1
3970,"['contrato', 'crise', 'iniciativo', 'legislativo', 'planalto', 'prever', 'privar', 'rejeitar', 'saneamento', 'saneamento', 'vetar']","[1, 1, 1, 1, 1, 1, 1, 1, 2, 2, 1]","[]","[]",11,0,11,1
3971,"['comparacao', 'consolidar', 'consorcio', 'estabilidad', 'estabilidad', 'estabilidad', 'levantamento', 'saudar', 'situacao', 'tendencia', 'tendencia', 'tendencia', 'variacao', 'variacao']","[1, 1, 1, 3, 3, 3, 1, 1, 1, 3, 3, 3, 2, 2]","[]","[]",14,0,14,1
3974,"['arthur', 'economia', 'expectativa', 'feriar', 'gued', 'integrant', 'lira', 'mudanca', 'ppal']","[1, 1, 1, 1, 1, 1, 1, 1, 1]","[]","[]",9,0,9,1
3977,"['bancada', 'bancada', 'congresso', 'congresso', 'federar']","[2, 2, 2, 2, 1]","['legendar']","[1]",5,1,6,1
3978,"['europeu', 'habitant', 'imunizacao', 'imunizacao', 'previsto', 'prioridad', 'reuter', 'sabado', 'sabado']","[1, 1, 2, 2, 1, 1, 1, 2, 2]","[]","[]",9,0,9,1
3979,"['destinar', 'parceiro', 'parceiro', 'resistencia']","[1, 2, 2, 1]","[]","[]",4,0,4,1
3982,"['client', 'consumidor', 'consumidor', 'crise', 'desenvolvimento', 'metropolitano', 'reducao', 'reducao', 'regiao', 'saneamento', 'tesourar', 'wilson', 'witzel']","[1, 2, 2, 1, 1, 1, 2, 2, 1, 1, 1, 1, 1]","[]","[]",13,0,13,1
3989,"['associacao', 'atuam', 'ausencia', 'decisao', 'decisao', 'ministrar', 'ministrar', 'ministrar', 'orientacao', 'plano', 'presenciar', 'proposto', 'queixar', 'reabertura', 'regiao', 'respostar', 'ribeiro', 'situacao', 'situacao', 'suspenso']","[1, 1, 1, 2, 2, 3, 3, 3, 1, 1, 1, 1, 1, 1, 1, 1, 1, 2, 2, 1]","[]","[]",20,0,20,1
3990,"['gabinet', 'gabinet', 'infectar', 'positivar', 'sabado']","[2, 2, 1, 1, 1]","[]","[]",5,0,5,1
3996,"['calendario', 'correspondent', 'crise', 'equivalent', 'mudanca', 'necessario', 'provisorio', 'recurso', 'reducao', 'reducao', 'reducao', 'suspensao', 'suspensao', 'suspensao']","[1, 1, 1, 1, 1, 1, 1, 1, 3, 3, 3, 3, 3, 3]","['sacar', 'sacar', 'sacar', 'sacar', 'sacar', 'sacar']","[6, 6, 6, 6, 6, 6]",14,6,20,1
3997,"['balancar', 'biliao', 'destacar', 'emendar', 'emendar', 'emendar', 'expansao', 'federar', 'gued', 'gued', 'impactar', 'justicar', 'ministrar', 'pereira', 'preservar', 'previsto', 'regrar', 'vulneravel']","[1, 1, 1, 3, 3, 3, 1, 1, 2, 2, 1, 1, 1, 1, 1, 1, 1, 1]","[]","[]",18,0,18,1
4002,"['colombio', 'colombio', 'espanha', 'habitant', 'superar', 'superar']","[2, 2, 1, 1, 2, 2]","[]","[]",6,0,6,1
4004,"['agravamento', 'ausencia', 'consorcio', 'curvo', 'intervalar', 'recordar', 'recordar', 'recordar', 'saudar', 'tendencia']","[1, 1, 1, 1, 1, 3, 3, 3, 1, 1]","[]","[]",10,0,10,1
4008,"['anuncio', 'publicitario']","[1, 1]","['basto', 'boicotar']","[1, 1]",2,2,4,1
4010,"['epidemiologico', 'feriar', 'feriar', 'feriar', 'importancia', 'infectar', 'saudar', 'saudar', 'situacao', 'vigilancia']","[1, 3, 3, 3, 1, 1, 2, 2, 1, 1]","[]","[]",10,0,10,1
4011,"['adulto', 'domingo', 'expectativa', 'habitant', 'justicar']","[1, 1, 1, 1, 1]","[]","[]",5,0,5,1
4013,"['decisao', 'epidemiar', 'epidemiologico', 'justificativo', 'monitoramento', 'publicitario', 'reforcar', 'reforcar', 'risco', 'suspeito', 'suspeito', 'transmissao', 'transmissao']","[1, 1, 1, 1, 1, 1, 2, 2, 1, 2, 2, 2, 2]","[]","[]",13,0,13,1
4014,"[]","[]","[]","[]",0,0,0,1
4018,"['apreensao', 'edson', 'entendimento', 'fachin', 'kassio', 'medida', 'supremo']","[1, 1, 1, 1, 1, 1, 1]","[]","[]",7,0,7,1
4019,"['boletim', 'boletim', 'comparacao', 'confirmado', 'consecutivo', 'consorcio', 'consorcio', 'distrito', 'estabilidad', 'tambem', 'ultimo']","[2, 2, 1, 1, 1, 2, 2, 1, 1, 1, 1]","[]","[]",11,0,11,1
4020,"['planar', 'sabado', 'saudar', 'supremo', 'supremo']","[1, 1, 1, 2, 2]","['versao']","[1]",5,1,6,1
4021,"['alunar', 'antecipar', 'antecipar', 'contencao', 'decorrencia', 'dedicar', 'enfermagem', 'estagio', 'estagio', 'flexibilizar', 'necessidad', 'periodo', 'previsto', 'privar', 'regrar', 'revogar', 'situacao']","[1, 2, 2, 1, 1, 1, 1, 2, 2, 1, 1, 1, 1, 1, 1, 1, 1]","[]","[]",17,0,17,1
4023,"['ministrar']","[1]","[]","[]",1,0,1,1
4024,"['desenvolvimento', 'destacar', 'interino', 'investigacao', 'investigacao', 'investigacao', 'irregularidad', 'ministrar', 'preocupacao', 'recurso', 'respirador', 'saudar', 'saudar', 'saudar', 'ventilador', 'ventilador']","[1, 1, 1, 3, 3, 3, 1, 1, 1, 1, 1, 3, 3, 3, 2, 2]","[]","[]",16,0,16,1
4027,"['desenvolvimento', 'infectar', 'saudar', 'testagem', 'treinar']","[1, 1, 1, 1, 1]","[]","[]",5,0,5,1
4029,"['afetado', 'comparacao', 'crise', 'estatistico', 'europeu', 'gripezinha', 'instituto', 'respiratorio', 'respiratorio', 'respiratorio', 'respiratorio']","[1, 1, 1, 1, 1, 1, 1, 4, 4, 4, 4]","['desmentir', 'humanar']","[1, 1]",11,2,13,1
4030,"['instituto']","[1]","['gravacao']","[1]",1,1,2,1
4034,"['anuncio', 'desenvolvido', 'instituto', 'liderar', 'ministrar', 'parceria', 'reuniao', 'saudar', 'saudar']","[1, 1, 1, 1, 1, 1, 1, 2, 2]","['bandeiro']","[1]",9,1,10,1
4036,"['contagioso', 'decisao', 'dinamarca', 'inglaterra', 'ministrar', 'mudanca', 'mutacao', 'mutacao', 'possibilidad', 'saudar', 'saudar', 'temporariament', 'viagem', 'viajant', 'voo']","[1, 1, 1, 1, 1, 1, 2, 2, 1, 2, 2, 1, 1, 1, 1]","[]","[]",15,0,15,1
4037,"['avancar', 'distant', 'expressivo', 'levantamento', 'periferia', 'periodo', 'rotina', 'saudar', 'sobretudo', 'sobretudo', 'trimestr']","[1, 1, 1, 1, 1, 1, 1, 1, 2, 2, 1]","[]","[]",11,0,11,1
4038,"['argumentar', 'decisao', 'exercicio', 'funcao', 'infectar', 'justicar', 'preservar', 'privar', 'recurso', 'republico']","[1, 1, 1, 1, 1, 1, 1, 1, 1, 1]","[]","[]",10,0,10,1
4040,"['determinacao', 'funcao', 'inglaterra', 'portavoz', 'saudar', 'saudar', 'saudar', 'suportar']","[1, 1, 1, 1, 3, 3, 3, 1]","[]","[]",8,0,8,1
4042,"['assintomatico', 'diariament', 'implementar', 'isolar', 'positivar', 'proliferacao']","[1, 1, 1, 1, 1, 1]","[]","[]",6,0,6,1
4043,"['autoridad', 'autoridad', 'autoridad', 'deslocamento', 'domingo', 'domingo', 'europeu', 'europeu', 'flexibilizacao', 'flexibilizacao', 'impacto', 'impacto', 'normalidad', 'normalidad', 'quilometro', 'regiao', 'relaxamento', 'relaxamento', 'relaxamento']","[3, 3, 3, 1, 2, 2, 2, 2, 2, 2, 2, 2, 2, 2, 1, 1, 3, 3, 3]","['circula']","[1]",19,1,20,1
4049,"['acordo', 'equipamento', 'escassez', 'fabricacao', 'fez', 'possibilidad', 'tambem', 'tambem', 'tambem']","[1, 1, 1, 1, 1, 1, 3, 3, 3]","[]","[]",9,0,9,1
4051,"['atrasar', 'autoridad', 'coreia', 'coreia', 'decisao', 'supremo']","[1, 1, 2, 2, 1, 1]","[]","[]",6,0,6,1
4055,"['afp', 'implementar', 'realizacao', 'suspensao']","[1, 1, 1, 1]","[]","[]",4,0,4,1
4058,"['aliquota', 'aliquota', 'arrecadacao', 'cardiologista', 'congresso', 'congresso', 'congresso', 'folhar', 'gued', 'ministrar', 'ministrar', 'piorar', 'prazo', 'proposto', 'saudar', 'saudar', 'saudar', 'saudar', 'saudar', 'tesourar', 'tesourar']","[2, 2, 1, 1, 3, 3, 3, 1, 1, 2, 2, 1, 1, 1, 5, 5, 5, 5, 5, 2, 2]","[]","[]",21,0,21,1
4062,"['circulacao', 'fase', 'fase', 'gorinchteyn', 'internacao', 'restritivo', 'saudar', 'saudar', 'taxar']","[1, 2, 2, 1, 1, 1, 2, 2, 1]","[]","[]",9,0,9,1
4064,"['autoridad', 'crise', 'fase', 'positivar', 'regiao', 'saudar', 'saudar', 'situacao', 'sudest', 'velocidad']","[1, 1, 1, 1, 1, 2, 2, 1, 1, 1]","['espalhar']","[1]",10,1,11,1
4066,"['biliao', 'biliao', 'demandar', 'emendar', 'esquema', 'funcao', 'integro', 'investigacao', 'tcu']","[2, 2, 1, 1, 1, 1, 1, 1, 1]","['secreto']","[1]",9,1,10,1
4069,"['assistencia', 'assistencia', 'boletim', 'condicao', 'condicao', 'contabilizar', 'epidemiologico', 'hospitalizar', 'internar', 'internar', 'minoria', 'piorar', 'piorar', 'proporcao', 'proporcao', 'respiratorio', 'saudar']","[2, 2, 1, 2, 2, 1, 1, 1, 2, 2, 1, 2, 2, 2, 2, 1, 1]","[]","[]",17,0,17,1
4072,"['congresso', 'decisao', 'punicao']","[1, 1, 1]","['arquivar', 'imagem', 'imagem']","[1, 2, 2]",3,3,6,1
4074,"['concessionario', 'conformar', 'conjunto', 'desenvolvimento', 'fase', 'fase', 'flexibilizacao', 'funcionamento', 'funcionamento', 'iniciativo', 'reabertura', 'regiao', 'regiao', 'regiao', 'resolucao', 'resolucao', 'respostar']","[1, 1, 1, 1, 2, 2, 1, 2, 2, 1, 1, 3, 3, 3, 2, 2, 1]","[]","[]",17,0,17,1
4075,"['associacao', 'conjuntar', 'imunizacao', 'investigacao', 'liderar', 'monitoramento', 'notificar', 'notificar', 'prioritario', 'saudar', 'vigilancia']","[1, 1, 1, 1, 1, 1, 2, 2, 1, 1, 1]","['supostament']","[1]",11,1,12,1
4079,"['acumular', 'afp', 'aliviar', 'crise', 'decisao', 'economia', 'instalacao', 'piorar', 'quarentenar', 'reabrir', 'ricardo']","[1, 1, 1, 1, 1, 1, 1, 1, 1, 1, 1]","[]","[]",11,0,11,1
4080,"['alcolumbr', 'alcolumbr', 'augusto', 'bastidor', 'congresso', 'demap', 'dialogo', 'economia', 'gabinet', 'gued', 'heleno', 'heleno', 'heleno', 'heleno', 'ministrar', 'ministrar', 'ministrar', 'transmissao']","[2, 2, 1, 1, 1, 1, 1, 1, 1, 1, 4, 4, 4, 4, 3, 3, 3, 1]","[]","[]",18,0,18,1
4082,"['antecipar', 'decisao', 'destinar', 'equipamento', 'equipamento', 'equipamento', 'etapa', 'previsto', 'regulamentar', 'respirador', 'saudar']","[1, 1, 1, 3, 3, 3, 1, 1, 1, 1, 1]","[]","[]",11,0,11,1
4083,"['boletim', 'caxia', 'caxia', 'duqu', 'duqu', 'funcao', 'goncalo', 'goncalo', 'periodo', 'redondo', 'saudar', 'suspeito']","[1, 2, 2, 2, 2, 1, 2, 2, 1, 1, 1, 1]","[]","[]",12,0,12,1
4084,"['comparacao', 'coreia', 'habitant', 'infectar', 'iniciativo', 'iniciativo', 'letalidad', 'reportar', 'taxar', 'ufrj']","[1, 1, 1, 1, 2, 2, 1, 1, 1, 1]","[]","[]",10,0,10,1
4087,"['apreensao', 'argumentar', 'decisao', 'defendido', 'justicar', 'justicar', 'previsto', 'proliferacao', 'propagacao', 'proposto', 'regiao', 'saudar', 'saudar']","[1, 1, 1, 1, 2, 2, 1, 1, 1, 1, 1, 2, 2]","[]","[]",13,0,13,1
4089,"['acordo', 'afastamento', 'ambito', 'araujo', 'contrato', 'desvio', 'determinacao', 'fluminens', 'goncalv', 'investigacao', 'legislativo', 'liderar', 'pagamento', 'palacio', 'pedido', 'prazo', 'recurso', 'sociai', 'suspeito', 'wilson', 'witzel', 'witzel']","[1, 1, 1, 1, 1, 1, 1, 1, 1, 1, 1, 1, 1, 1, 1, 1, 1, 1, 1, 1, 2, 2]","[]","[]",22,0,22,1
4090,"['desenvolvido', 'fase', 'fase', 'gorinchtey', 'guarulho', 'instituto', 'instituto', 'limitacao', 'necessario', 'observar', 'palacio', 'parceria', 'parceria', 'preliminar', 'presenca', 'recebido', 'ricardo', 'saudar', 'vigilancia']","[1, 2, 2, 1, 1, 2, 2, 1, 1, 1, 1, 2, 2, 1, 1, 1, 1, 1, 1]","['versao']","[1]",19,1,20,1
4092,"['alternativo', 'alternativo', 'consorcio', 'exministro', 'henriqu', 'levantamento', 'saudar']","[2, 2, 1, 1, 1, 1, 1]","[]","[]",7,0,7,1
4093,"['celebrar', 'celebrar', 'companhia', 'dedicar', 'isolar', 'periodo', 'presenca', 'transmissao']","[2, 2, 1, 1, 1, 1, 1, 1]","['abencoar', 'catolico']","[1, 1]",8,2,10,1
4094,"['consolidar', 'empatar', 'instituto', 'rocha', 'sabado', 'vespera']","[1, 1, 1, 1, 1, 1]","[]","[]",6,0,6,1
4101,"['adicionar', 'comparacao', 'demandar', 'exportacao', 'implementar', 'nogueira', 'nogueira', 'periodo', 'precedent', 'reabertura', 'sabado', 'subir', 'surto', 'taxar', 'trimestr']","[1, 1, 1, 1, 1, 2, 2, 1, 1, 1, 1, 1, 1, 1, 1]","[]","[]",15,0,15,1
4102,"['diagnosticar', 'florido', 'isolar', 'oficialment', 'positivar', 'queixar', 'saudar', 'suspeito', 'visitant']","[1, 1, 1, 1, 1, 1, 1, 1, 1]","[]","[]",9,0,9,1
4104,"['destacar', 'imunizacao']","[1, 1]","[]","[]",2,0,2,1
4106,"['circulacao', 'escalar', 'estagio', 'impactar', 'preventivo', 'rotina', 'subir']","[1, 1, 1, 1, 1, 1, 1]","[]","[]",7,0,7,1
4108,"['individuar', 'intensivo', 'internacao']","[1, 1, 1]","[]","[]",3,0,3,1
4109,"['intensivo', 'intensivo', 'internar', 'internar', 'internar', 'saudar', 'taxar']","[2, 2, 3, 3, 3, 1, 1]","[]","[]",7,0,7,1
4112,"['bastidor', 'constituicao', 'constituicao', 'constituicao', 'converso', 'posturar', 'restritivo']","[1, 3, 3, 3, 1, 1, 1]","['cartaz', 'insinuar']","[1, 1]",7,2,9,1
4113,"['comissao', 'disseminacao', 'respostar', 'saudar', 'saudar', 'surtir', 'surtir']","[1, 1, 1, 2, 2, 2, 2]","[]","[]",7,0,7,1
4116,"['atuacao', 'biliao', 'equipamento', 'iniciativo', 'iniciativo', 'justicar', 'prever', 'recurso', 'regulamentar']","[1, 1, 1, 2, 2, 1, 1, 1, 1]","[]","[]",9,0,9,1
4117,"['biliao', 'calamidad', 'comissao', 'comissao', 'congresso', 'economia', 'fase', 'importancia', 'limitacao', 'orcamentaria', 'plenario', 'prever', 'previsto', 'recurso', 'reuniao', 'saudar', 'situacao']","[1, 1, 2, 2, 1, 1, 1, 1, 1, 1, 1, 1, 1, 1, 1, 1, 1]","[]","[]",17,0,17,1
4118,"['academiar', 'aglomeracao', 'coletivo', 'enfrentamento', 'especifico', 'fluminens', 'funcionamento', 'funcionamento', 'funcionamento', 'investigacao', 'mantido', 'presenciar', 'privar', 'privar', 'prorrogar', 'respiratorio', 'restritivo', 'suspenso', 'wilson', 'witzel']","[1, 1, 1, 1, 1, 1, 3, 3, 3, 1, 1, 1, 2, 2, 1, 1, 1, 1, 1, 1]","[]","[]",20,0,20,1
4120,"['avancar', 'deteccao', 'equipamento', 'equivalent', 'especializar', 'especifico', 'flavio', 'goncalo', 'infectar', 'internacao', 'internar', 'isolar', 'presenca', 'presenca', 'resistencia', 'saudar', 'saudar', 'sequenciamento', 'submetido']","[1, 1, 1, 1, 1, 1, 1, 1, 1, 1, 1, 1, 2, 2, 1, 2, 2, 1, 1]","['espalhar', 'espalhar']","[2, 2]",19,2,21,1
4121,"['necessidad', 'prioridad', 'sabado', 'saudar', 'saudar']","[1, 1, 1, 2, 2]","['quinzena']","[1]",5,1,6,1
4124,"['anteriorment']","[1]","['imagem']","[1]",1,1,2,1
4126,"['acumular', 'anuncio', 'aumento', 'confirmado', 'disseminacao', 'epidemia', 'exemplo', 'extensa', 'fase', 'fase', 'fase', 'fase', 'fase', 'habitant', 'hospitalizacao', 'interrupcao', 'medida', 'mexico', 'mexico', 'mexico', 'milho', 'proprio', 'transmissao']","[1, 1, 1, 1, 1, 1, 1, 1, 5, 5, 5, 5, 5, 1, 1, 1, 1, 3, 3, 3, 1, 1, 1]","[]","[]",23,0,23,1
4128,"['antonio', 'autoridad']","[1, 1]","[]","[]",2,0,2,1
4129,"['conselho', 'incerteza', 'propagacao', 'reabertura']","[1, 1, 1, 1]","[]","[]",4,0,4,1
4130,"['antecipar', 'antecipar', 'antecipar', 'biliao', 'decisao', 'decisao', 'destinar', 'infraestrutura', 'ministrar', 'orcamentaria', 'recurso', 'recurso', 'tcu', 'tcu', 'tcu', 'tesourar']","[3, 3, 3, 1, 2, 2, 1, 1, 1, 1, 2, 2, 3, 3, 3, 1]","[]","[]",16,0,16,1
4131,"['anuncio', 'condicao', 'epicentro', 'epidemiar', 'expectativa', 'hospitalizar', 'hubei', 'provincia', 'pulmonar', 'quarentenar', 'sabado', 'saudar', 'saudar', 'turista']","[1, 1, 1, 1, 1, 1, 1, 1, 1, 1, 1, 2, 2, 1]","[]","[]",14,0,14,1
4132,"['palacio', 'quatro', 'quatro']","[1, 2, 2]","[]","[]",3,0,3,1
4136,"['adotada', 'aprovacao', 'dosar', 'epidemiar', 'exministro', 'impactar', 'justicar', 'preventivo', 'previsao', 'recordar', 'superar']","[1, 1, 1, 1, 1, 1, 1, 1, 1, 1, 1]","['realment']","[1]",11,1,12,1
4137,"['anteriorment', 'avancar', 'conformar', 'epidemiar', 'estrategico', 'exministro', 'exonerar', 'exonerar', 'gabinet', 'henriqu', 'ministrar', 'ministrar', 'mudanca', 'nelson', 'oficialment', 'saudar', 'saudar', 'saudar', 'servidor', 'servidor', 'substituto', 'teich', 'teich', 'teich', 'vigilancia']","[1, 1, 1, 1, 1, 1, 2, 2, 1, 1, 2, 2, 1, 1, 1, 3, 3, 3, 2, 2, 1, 3, 3, 3, 1]","[]","[]",25,0,25,1
4141,"['ambientar', 'compromisso', 'compromisso', 'desigualdad', 'desigualdad', 'esperancar', 'esperancar']","[1, 2, 2, 2, 2, 2, 2]","[]","[]",7,0,7,1
4142,"['adulto', 'emendar', 'emendar', 'emendar', 'emendar', 'pagamento', 'pagamento', 'proposto', 'recurso', 'sancao']","[1, 4, 4, 4, 4, 2, 2, 1, 1, 1]","[]","[]",10,0,10,1
4147,"['espanha', 'infeccioso', 'saudar', 'situacao', 'tendencia', 'viagem']","[1, 1, 1, 1, 1, 1]","[]","[]",6,0,6,1
4155,"['anvisa', 'desembarcar', 'dificuldad', 'mantido', 'passageiro', 'passageiro', 'saudar', 'vigilancia']","[1, 1, 1, 1, 2, 2, 1, 1]","[]","[]",8,0,8,1
4157,"['converso', 'integrant', 'lorenzoni', 'lorenzoni', 'manutencao', 'ministrar', 'onyx', 'onyx', 'palacio', 'planalto', 'presenca']","[1, 1, 2, 2, 1, 1, 2, 2, 1, 1, 1]","['amigar']","[1]",11,1,12,1
4158,"['amplo', 'conservacao', 'contemplar', 'especialment', 'estrategico', 'recuperacao', 'regiao', 'regiao', 'regiao', 'sabado', 'turista', 'visitant']","[1, 1, 1, 1, 1, 1, 3, 3, 3, 1, 1, 1]","['soldar']","[1]",12,1,13,1
4160,"['autoridad', 'informaco', 'milho']","[1, 1, 1]","[]","[]",3,0,3,1
4161,"['diagnosticar']","[1]","['estomago']","[1]",1,1,2,1
4162,"['argumentar', 'balancar', 'desenvolvido', 'desenvolvimento', 'estagio', 'etapa', 'etapa', 'fase', 'fase', 'infectar', 'inglaterra', 'iniciativo', 'journal', 'levantamento', 'organizador', 'saudar']","[1, 1, 1, 1, 1, 2, 2, 2, 2, 1, 1, 1, 1, 1, 1, 1]","[]","[]",16,0,16,1
4166,"['academiar', 'infancia', 'periodo', 'presenciar', 'risco', 'transmissao']","[1, 1, 1, 1, 1, 1]","['misturar']","[1]",6,1,7,1
4167,"['economia', 'espanha', 'expressivo', 'impactar', 'minimizar']","[1, 1, 1, 1, 1]","[]","[]",5,0,5,1
4169,"['conjuntar', 'destacar', 'enfrentamento', 'interino', 'ministrar', 'ministrar', 'prescricao', 'recurso', 'saudar', 'saudar', 'saudar', 'saudar']","[1, 1, 1, 1, 2, 2, 1, 1, 4, 4, 4, 4]","[]","[]",12,0,12,1
4170,"['comissao', 'folhar', 'integro', 'requerimento', 'saudar']","[1, 1, 1, 1, 1]","[]","[]",5,0,5,1
4174,"['atrasar', 'autonomia', 'calendario', 'conformar', 'etapa', 'imunizacao', 'imunizacao', 'reforcar']","[1, 1, 1, 1, 1, 2, 2, 1]","[]","[]",8,0,8,1
4183,"['associacao', 'autoridad', 'autoridad', 'epidemiar', 'espanha', 'espanha', 'mudanca', 'mudanca', 'regiao', 'saudar', 'saudar', 'saudar', 'surto']","[1, 2, 2, 1, 2, 2, 2, 2, 1, 3, 3, 3, 1]","['indignacao']","[1]",13,1,14,1
4184,"['anuncio', 'cepa', 'colleg', 'contagioso', 'preocupacao']","[1, 1, 1, 1, 1]","['espalhar']","[1]",5,1,6,1
4185,"['ambientar', 'ambientar', 'condicao', 'desmatamento', 'etapa', 'iniciativo', 'integro', 'preservar', 'preservar', 'privar']","[2, 2, 1, 1, 1, 1, 1, 2, 2, 1]","['parabem']","[1]",10,1,11,1
4186,"['anvisa', 'anvisa', 'carat', 'condicao', 'fundacao', 'prazo', 'prever', 'recordar', 'saudar']","[2, 2, 1, 1, 1, 1, 1, 1, 1]","[]","[]",9,0,9,1
4189,"['decisao', 'importacao', 'integro', 'prever', 'prioritario', 'regiao', 'saudar']","[1, 1, 1, 1, 1, 1, 1]","[]","[]",7,0,7,1
4194,"['aplicacao', 'decisao', 'entendimento', 'integro', 'lewandowski', 'lewandowski', 'ministrar', 'ministrar', 'plenario', 'plenario', 'previsao', 'recurso', 'regrar', 'ricardo', 'supremo']","[1, 1, 1, 1, 2, 2, 2, 2, 2, 2, 1, 1, 1, 1, 1]","[]","[]",15,0,15,1
4196,"['acompanhamento', 'acompanhamento', 'acumular', 'diagnosticar', 'saudar']","[2, 2, 1, 1, 1]","[]","[]",5,0,5,1
4197,"['augusto', 'aurelio', 'constituicao', 'espirito', 'kassio', 'mello', 'mendonca', 'mendonca', 'supremo', 'supremo', 'supremo']","[1, 1, 1, 1, 1, 1, 2, 2, 3, 3, 3]","[]","[]",11,0,11,1
4200,"['comparacao', 'consultoria', 'esforco', 'impactar', 'impactar', 'indicador', 'journal', 'journal', 'sigla']","[1, 1, 1, 2, 2, 1, 2, 2, 1]","[]","[]",9,0,9,1
4201,"['claudio', 'escassez', 'interino', 'respostar']","[1, 1, 1, 1]","[]","[]",4,0,4,1
4202,"['crise', 'importacao', 'mergulhar']","[1, 1, 1]","['despejar', 'torrar']","[1, 1]",3,2,5,1
4204,"['conflito', 'constatar', 'edson', 'fachin', 'funcionamento', 'ministrar', 'prioritario', 'ritmar', 'supremo', 'suspensao', 'tcu']","[1, 1, 1, 1, 1, 1, 1, 1, 1, 1, 1]","['auditoria']","[1]",11,1,12,1
4206,"['amplo', 'avancar', 'consumidor', 'contribuicao', 'domicilio', 'estatistico', 'geografia', 'ibg', 'impactar', 'instituto', 'oposto', 'recuar', 'subir']","[1, 1, 1, 1, 1, 1, 1, 1, 1, 1, 1, 1, 1]","[]","[]",13,0,13,1
4208,"['afetado', 'esperancar', 'intensivo', 'rotina', 'saudar']","[1, 1, 1, 1, 1]","['gravacao']","[1]",5,1,6,1
4210,"['anvisa', 'anvisa', 'exigencia', 'fundacao', 'oswaldo', 'parceria', 'vigilancia']","[2, 2, 1, 1, 1, 1, 1]","[]","[]",7,0,7,1
4211,"['airlin', 'airlin', 'companhia', 'companhia', 'decisao', 'demandar', 'kong', 'kong', 'plano', 'tripulacao', 'viagem', 'voo', 'voo', 'voo']","[2, 2, 2, 2, 1, 1, 2, 2, 1, 1, 1, 3, 3, 3]","[]","[]",14,0,14,1
4213,"['conjunto', 'consorcio', 'consorcio', 'cooperacao', 'parceria', 'recurso', 'saudar']","[1, 2, 2, 1, 1, 1, 1]","[]","[]",7,0,7,1
4214,"['aumento', 'competicao', 'fluxo', 'medida', 'periodo', 'proliferacao', 'quatro']","[1, 1, 1, 1, 1, 1, 1]","[]","[]",7,0,7,1
4215,"['biliao', 'delacao', 'inedito', 'lavagem', 'pagamento', 'periodo']","[1, 1, 1, 1, 1, 1]","['desligar']","[1]",6,1,7,1
4218,"['companhia', 'companhia', 'decisao', 'expectativa', 'mudanca', 'nomeacao', 'recurso']","[2, 2, 1, 1, 1, 1, 1]","[]","[]",7,0,7,1
4219,"['expectativa', 'prever', 'reabertura', 'reabrir']","[1, 1, 1, 1]","[]","[]",4,0,4,1
4220,"['afp', 'levantamento', 'proposto', 'rejeitar', 'saudar', 'temporariament']","[1, 1, 1, 1, 1, 1]","[]","[]",6,0,6,1
4227,"['adulto', 'autoridad', 'autoridad', 'boletim', 'decorrencia', 'dosar', 'guarulho', 'imunizacao', 'imunizacao', 'imunizacao', 'prever', 'sarampo', 'sarampo', 'sarampo', 'sarampo', 'sarampo', 'saudar', 'saudar', 'saudar', 'saudar', 'vulnerabilidad', 'vulneravel']","[1, 2, 2, 1, 1, 1, 1, 3, 3, 3, 1, 5, 5, 5, 5, 5, 4, 4, 4, 4, 1, 1]","['menino', 'menino']","[2, 2]",22,2,24,1
4228,"['absoluto', 'consequencia', 'necessario', 'planar', 'positivar', 'primeiroministro', 'primeiroministro', 'quarentenar', 'quarentenar', 'vigilancia']","[1, 1, 1, 1, 1, 2, 2, 2, 2, 1]","['parir']","[1]",10,1,11,1
4230,"['afp', 'autoridad', 'calendario', 'competicao', 'federar', 'orientacao', 'previsao', 'previsao', 'saudar', 'temporada', 'temporada']","[1, 1, 1, 1, 1, 1, 2, 2, 1, 2, 2]","[]","[]",11,0,11,1
4232,"['absoluto', 'aglomeracao', 'client', 'desempenhar', 'desempenhar', 'orientacao', 'propagacao', 'saudar', 'saudar', 'saudar']","[1, 1, 1, 2, 2, 1, 1, 3, 3, 3]","['boatar', 'espalhar', 'imagem', 'imagem', 'revoltar', 'vazar', 'verdadeiro']","[1, 1, 2, 2, 1, 1, 1]",10,7,17,1
4233,"['depoimento', 'dosar', 'enfermagem', 'regiao', 'saudar', 'saudar', 'saudar', 'servidor', 'suspeito']","[1, 1, 1, 1, 3, 3, 3, 1, 1]","[]","[]",9,0,9,1
4234,"['autoridad', 'deslocamento', 'exigencia', 'periodo', 'primeiroministro', 'restritivo', 'saudar', 'situacao']","[1, 1, 1, 1, 1, 1, 1, 1]","[]","[]",8,0,8,1
4235,"['adhanom', 'necessario', 'necessario', 'propagacao', 'propagacao', 'saudar', 'tedro']","[1, 2, 2, 2, 2, 1, 1]","[]","[]",7,0,7,1
4237,"['alteracao', 'comportamento', 'esforco', 'incerteza', 'preventivo', 'rotina', 'saudar']","[1, 1, 1, 1, 1, 1, 1]","[]","[]",7,0,7,1
4239,"['compromisso', 'infraestrutura', 'processo']","[1, 1, 1]","['inocentar']","[1]",3,1,4,1
4240,"['cenario', 'desempenhar', 'expansao', 'flexibilizar', 'privar', 'quedo', 'semestr', 'trimestr', 'turistico', 'viagem']","[1, 1, 1, 1, 1, 1, 1, 1, 1, 1]","[]","[]",10,0,10,1
4243,"['adiamento', 'ambientar', 'boletim', 'decisao', 'demandar', 'destacar', 'epidemiologico', 'epidemiologico', 'implementacao', 'infectar', 'infectar', 'infectar', 'insuficient', 'justicar', 'justicar', 'justicar', 'magistrado', 'periodo', 'periodo', 'prever', 'respostar', 'risco', 'risco', 'saudar', 'situacao', 'temporario', 'temporario', 'temporario', 'temporario', 'varar']","[1, 1, 1, 1, 1, 1, 2, 2, 1, 3, 3, 3, 1, 3, 3, 3, 1, 2, 2, 1, 1, 2, 2, 1, 1, 4, 4, 4, 4, 1]","[]","[]",30,0,30,1
4244,"['adotada', 'anvisa', 'argumentar', 'comorbidad', 'comorbidad', 'contemplar', 'destacar', 'fundamentar', 'fundamentar', 'gestant', 'gestant', 'gestant', 'gestant', 'gestant', 'gestant', 'imunizacao', 'imunizacao', 'imunizacao', 'imunizacao', 'instituto', 'operacionalizacao', 'paralisar', 'planar', 'planar', 'possibilidad', 'saudar', 'saudar', 'saudar', 'saudar', 'supremo', 'supremo', 'suspensao', 'suspensao', 'suspensao', 'temporario', 'vigilancia', 'vigilancia']","[1, 1, 1, 2, 2, 1, 1, 2, 2, 6, 6, 6, 6, 6, 6, 4, 4, 4, 4, 1, 1, 1, 2, 2, 1, 4, 4, 4, 4, 2, 2, 3, 3, 3, 1, 2, 2]","['legendar', 'versao']","[1, 1]",37,2,39,1
4245,"['aurelio', 'decisao', 'edson', 'fachin', 'folhar', 'integro', 'supremo']","[1, 1, 1, 1, 1, 1, 1]","[]","[]",7,0,7,1
4246,"['favorito', 'florido', 'jorg', 'opcao', 'plano', 'positivar', 'quarentenar', 'respostar', 'sabado', 'situacao']","[1, 1, 1, 1, 1, 1, 1, 1, 1, 1]","[]","[]",10,0,10,1
4247,"['adotada', 'armazenamento', 'economia', 'enfrentamento', 'iniciativo', 'justificativo', 'periodo', 'preservar', 'reabrir', 'superar']","[1, 1, 1, 1, 1, 1, 1, 1, 1, 1]","['circular']","[1]",10,1,11,1
4248,"['fornecimento', 'infectar', 'infectar', 'instituto', 'quedo', 'recordar', 'saudar', 'saudar', 'transmissao']","[1, 2, 2, 1, 1, 1, 2, 2, 1]","['verificar']","[1]",9,1,10,1
4249,"['alternativo', 'bolsonarista', 'celso', 'consolidar', 'isolar', 'liderar', 'palacio', 'periodo', 'planalto', 'prtb']","[1, 1, 1, 1, 1, 1, 1, 1, 1, 1]","[]","[]",10,0,10,1
4253,"['congresso', 'definitivo', 'movimentacao', 'proposto', 'proposto', 'proposto', 'provisorio', 'provisorio']","[1, 1, 1, 3, 3, 3, 2, 2]","['sacar']","[1]",8,1,9,1
4254,"['calheiro', 'comissao', 'condicao', 'folhar', 'governista', 'integro', 'lewandowski', 'magistrado', 'mdbal', 'ministrar', 'rejeitar', 'ricardo', 'subir', 'supremo', 'supremo']","[1, 1, 1, 1, 1, 1, 1, 1, 1, 1, 1, 1, 1, 2, 2]","[]","[]",15,0,15,1
4257,"['efetividad', 'negativar', 'periodo', 'recuperacao']","[1, 1, 1, 1]","[]","[]",4,0,4,1
4259,"['afp']","[1]","[]","[]",1,0,1,1
4266,"['absoluto', 'ampliacao', 'avancar', 'cenario', 'cenario', 'circulacao', 'decisao', 'implementar', 'intensivo', 'necessidad', 'parceria', 'quarentenar', 'saudar', 'situacao']","[1, 1, 1, 2, 2, 1, 1, 1, 1, 1, 1, 1, 1, 1]","[]","[]",14,0,14,1
4268,"['consequencia', 'crescimento', 'intensivo', 'internar', 'saudar', 'saudar', 'superar', 'taxar']","[1, 1, 1, 1, 2, 2, 1, 1]","[]","[]",8,0,8,1
4269,"['autoridad', 'conformar', 'implementar', 'isolar', 'periodo', 'positivar', 'positivar', 'previsao', 'quarentenar', 'quarentenar', 'treinamento', 'treinamento']","[1, 1, 1, 1, 1, 2, 2, 1, 2, 2, 2, 2]","[]","[]",12,0,12,1
4271,"['bolsonarista', 'depoimento', 'destinar', 'justicar', 'justicar', 'justicar', 'servidor']","[1, 1, 1, 3, 3, 3, 1]","[]","[]",7,0,7,1
4272,"['adiamento', 'autoridad', 'interrupcao', 'investigacao', 'possibilidad', 'quilometro', 'saudar', 'universitario']","[1, 1, 1, 1, 1, 1, 1, 1]","[]","[]",8,0,8,1
4274,"['distant', 'equipamento', 'exercicio', 'inglaterra', 'monitoram', 'pratico']","[1, 1, 1, 1, 1, 1]","['drone', 'drone', 'espalhar', 'imagem']","[2, 2, 1, 1]",6,4,10,1
4277,"['apreensao', 'condicao', 'contrato', 'fase', 'investigacao', 'investigacao', 'pastar', 'wellington']","[1, 1, 1, 1, 2, 2, 1, 1]","['replicar']","[1]",8,1,9,1
4281,"[]","[]","[]","[]",0,0,0,1
4282,"['equipamento', 'expressar', 'infectar', 'infectar', 'intensivo', 'preocupacao', 'respirador', 'saudar']","[1, 1, 2, 2, 1, 1, 1, 1]","[]","[]",8,0,8,1
4284,"['adversario', 'celso', 'decisao', 'folhar', 'instituto', 'instituto', 'justicar', 'quedo', 'quedo', 'spaulo']","[1, 1, 1, 1, 2, 2, 1, 2, 2, 1]","['circular']","[1]",10,1,11,1
4285,"['amplo', 'amplo', 'amplo', 'amplo', 'amplo', 'amplo', 'discussao', 'quadro']","[6, 6, 6, 6, 6, 6, 1, 1]","[]","[]",8,0,8,1
4289,"['aliviar', 'cenario', 'client', 'dificuldad', 'percepcao', 'periferia']","[1, 1, 1, 1, 1, 1]","[]","[]",6,0,6,1
4293,"['pastar', 'periodo']","[1, 1]","[]","[]",2,0,2,1
4294,"['aglomeracao', 'aglomeracao', 'fluxo', 'fundacao', 'implementar', 'pagamento', 'patamar', 'propagacao', 'quedo', 'quilometro', 'quilometro', 'rejeitar', 'restritivo', 'restritivo', 'significativo', 'varga']","[2, 2, 1, 1, 1, 1, 1, 1, 1, 2, 2, 1, 2, 2, 1, 1]","['cadastramento']","[1]",16,1,17,1
4297,"['almeida', 'domingo', 'enquadrar', 'punicao', 'respostar', 'rocha', 'souza']","[1, 1, 1, 1, 1, 1, 1]","['sobrar']","[1]",7,1,8,1
4299,"['assistencia', 'coordenar', 'desenvolvimento', 'diariament', 'estrategico', 'inovacao', 'inovacao', 'inovacao', 'nomeacao', 'saudar', 'saudar', 'saudar', 'saudar', 'saudar']","[1, 1, 1, 1, 1, 3, 3, 3, 1, 5, 5, 5, 5, 5]","[]","[]",14,0,14,1
4300,"['cenario', 'crescimento', 'escassez', 'infectar', 'instituto', 'intensivo', 'planar', 'previsto', 'privar', 'projecao', 'proposto', 'reuniao', 'saudar', 'saudar']","[1, 1, 1, 1, 1, 1, 1, 1, 1, 1, 1, 1, 2, 2]","[]","[]",14,0,14,1
4303,"['arthur', 'decorrencia', 'decorrencia']","[1, 2, 2]","[]","[]",3,0,3,1
4304,"['adicionar', 'boletim', 'coordenar', 'diagnosticar', 'internar']","[1, 1, 1, 1, 1]","[]","[]",5,0,5,1
4306,"['arrecadar', 'arthur', 'decisao', 'decisao', 'importacao', 'justicar', 'justicar', 'necessario', 'prazo', 'prazo', 'varar']","[1, 1, 2, 2, 1, 2, 2, 1, 2, 2, 1]","[]","[]",11,0,11,1
4312,"['afetado', 'cenario', 'circulacao', 'colleg', 'colleg', 'disseminacao', 'enfrentamento', 'enfrentamento', 'estimativo', 'estrategia', 'estrategia', 'estrategia', 'impactar', 'impactar', 'imunizacao', 'instituto', 'liderar', 'reducao', 'rigoroso', 'saudar']","[1, 1, 1, 2, 2, 1, 2, 2, 1, 3, 3, 3, 2, 2, 1, 1, 1, 1, 1, 1]","[]","[]",20,0,20,1
4313,"['autoridad', 'autoridad', 'espanha', 'inglaterra', 'quarentenar', 'regrar', 'reuter', 'reuter']","[2, 2, 1, 1, 1, 1, 2, 2]","[]","[]",8,0,8,1
4316,"['inicialment', 'monetario', 'normalment', 'obtido', 'prorrogar', 'recurso', 'recurso']","[1, 1, 1, 1, 1, 2, 2]","[]","[]",7,0,7,1
4317,"['ambientar', 'ambientar', 'decisao', 'determinacao', 'integro', 'justicar', 'ministrar', 'regrar', 'revogar', 'ricardo', 'sall', 'supremo', 'supremo', 'suspenso']","[2, 2, 1, 1, 1, 1, 1, 1, 1, 1, 1, 2, 2, 1]","[]","[]",14,0,14,1
4318,"['contabilizar', 'funcionamento', 'fundacao', 'habitant', 'habitant', 'instituto', 'instituto', 'liderar', 'oswaldo', 'periodo', 'periodo', 'regiao', 'regiao', 'saudar', 'saudar', 'saudar', 'saudar', 'situacao', 'superar', 'taxar', 'taxar', 'taxar', 'vulneravel']","[1, 1, 1, 2, 2, 2, 2, 1, 1, 2, 2, 2, 2, 4, 4, 4, 4, 1, 1, 3, 3, 3, 1]","[]","[]",23,0,23,1
4320,"['apoio', 'circulacao', 'extensao', 'medida', 'porqu', 'porqu', 'preocupacao', 'quilometro', 'quilometro']","[1, 1, 1, 1, 2, 2, 1, 2, 2]","[]","[]",9,0,9,1
4322,"['cooperacao', 'dengu', 'equipamento', 'henriqu', 'ministrar', 'ministrar', 'prever', 'saudar', 'saudar', 'saudar', 'saudar', 'transmissao']","[1, 1, 1, 1, 2, 2, 1, 4, 4, 4, 4, 1]","[]","[]",12,0,12,1
4325,"['atuacao', 'autoridad', 'bandeirant', 'entendimento', 'equipamento', 'impacto', 'instalacao', 'instituto', 'palacio', 'respirador', 'situacao']","[1, 1, 1, 1, 1, 1, 1, 1, 1, 1, 1]","[]","[]",11,0,11,1
4326,"['diagnosticar', 'sabado']","[1, 1]","[]","[]",2,0,2,1
4328,"['anuncio', 'estrategia', 'intensivo', 'levantamento', 'propagacao', 'risco']","[1, 1, 1, 1, 1, 1]","['deitar', 'imagem', 'imagem']","[1, 2, 2]",6,3,9,1
4329,"['acordo', 'autoridad', 'boletim', 'cronica', 'provincia', 'pulmonar', 'ultimo']","[1, 1, 1, 1, 1, 1, 1]","[]","[]",7,0,7,1
4330,"['afp', 'autoridad', 'sabado']","[1, 1, 1]","[]","[]",3,0,3,1
4331,"['administrativo', 'aplicacao', 'atrasar', 'consequencia', 'dosar', 'escassez', 'exministro', 'intubacao', 'opcao', 'orientacao', 'saudar']","[1, 1, 1, 1, 1, 1, 1, 1, 1, 1, 1]","[]","[]",11,0,11,1
4332,"['anuncio', 'biliao', 'comissao', 'desenvolvimento', 'desenvolvimento', 'destacar', 'esforco', 'etapa', 'europeu', 'europeu', 'europeu', 'independentement', 'precedent', 'velocidad']","[1, 1, 1, 2, 2, 1, 1, 1, 3, 3, 3, 1, 1, 1]","[]","[]",14,0,14,1
4336,"['comissao', 'depoimento', 'inquerito', 'oferecido', 'saudar', 'suspeito', 'wajngarten', 'wajngarten']","[1, 1, 1, 1, 1, 1, 2, 2]","[]","[]",8,0,8,1
4338,"['acordo', 'aspecto', 'colegiado', 'depoimento', 'esforco', 'esperanca', 'humberto', 'humberto', 'none', 'none', 'none', 'queiroga', 'queiroga', 'queiroga', 'queiroga', 'queiroga', 'queiroga', 'queiroga', 'queiroga', 'ramagem', 'recebido', 'relacao', 'relacao', 'requerimento', 'sessao', 'sido']","[1, 1, 1, 1, 1, 1, 2, 2, 3, 3, 3, 8, 8, 8, 8, 8, 8, 8, 8, 1, 1, 2, 2, 1, 1, 1]","['insinuar']","[1]",26,1,27,1
4339,"['cenario', 'converso', 'respostar', 'risco', 'sabado']","[1, 1, 1, 1, 1]","[]","[]",5,0,5,1
4340,"['afastamento', 'aglomeracao', 'alternativo', 'anvisa', 'crise', 'integro', 'justicar', 'regrar', 'regrar', 'saudar', 'vigilancia']","[1, 1, 1, 1, 1, 1, 1, 2, 2, 1, 1]","['boicotar']","[1]",11,1,12,1
4341,"['afetado', 'autoridad', 'avancar', 'balancar', 'domingo', 'europeu', 'fronteiro', 'fronteiro', 'fronteiro', 'infectar', 'instituto', 'reforcar', 'regiao', 'sabado', 'saudar']","[1, 1, 1, 1, 1, 1, 3, 3, 3, 1, 1, 1, 1, 1, 1]","['parir']","[1]",15,1,16,1
4342,"['anuncio', 'crise', 'juro', 'recordar', 'reducao', 'reducao', 'reducao', 'taxar', 'taxar', 'taxar', 'taxar', 'taxar', 'transmissao']","[1, 1, 1, 1, 3, 3, 3, 5, 5, 5, 5, 5, 1]","['checar', 'checar']","[2, 2]",13,2,15,1
4345,"['aumento', 'bandeirant', 'bruno', 'decisao', 'domingo', 'embora', 'medida', 'medida', 'palacio', 'periodo', 'possibilidad', 'prorrogacao', 'reuniao', 'tambem', 'tucano']","[1, 1, 1, 1, 1, 1, 2, 2, 1, 1, 1, 1, 1, 1, 1]","[]","[]",15,0,15,1
4346,"['atendido', 'complicacao', 'cronica', 'decorrencia', 'decorrencia', 'internar', 'internar', 'internar', 'isolar', 'isolar', 'metropolitano', 'regiao', 'respiratorio', 'saudar', 'varga']","[1, 1, 1, 2, 2, 3, 3, 3, 2, 2, 1, 1, 1, 1, 1]","[]","[]",15,0,15,1
4347,"['dificuldad', 'necessidad', 'pagamento', 'quarentenar']","[1, 1, 1, 1]","[]","[]",4,0,4,1
4349,"['competicao', 'concedido', 'particularment', 'resistencia']","[1, 1, 1, 1]","[]","[]",4,0,4,1
4350,"['enfrentamento', 'republico', 'rocha', 'rocha']","[1, 1, 2, 2]","['ideologia']","[1]",4,1,5,1
4351,"['atuacao', 'atuacao', 'bbc', 'comissao', 'comissao', 'contrato', 'crise', 'depoimento', 'enfrentamento', 'inquerito', 'insuficient', 'positivar', 'saudar']","[2, 2, 1, 2, 2, 1, 1, 1, 1, 1, 1, 1, 1]","[]","[]",13,0,13,1
4353,"['anticorpo', 'anticorpo', 'fase', 'infectar']","[2, 2, 1, 1]","[]","[]",4,0,4,1
4354,"['associacao', 'carla', 'conduta', 'congresso', 'deflagrar', 'federar', 'federar', 'goncalv', 'justicar', 'ministrar', 'ministrar', 'ministrar', 'necessario', 'pslsp', 'wilson', 'witzel', 'zambelli', 'zambelli']","[1, 1, 1, 1, 1, 2, 2, 1, 1, 3, 3, 3, 1, 1, 1, 1, 2, 2]","[]","[]",18,0,18,1
4355,"['cooperacao', 'crescimento', 'desenvolvimento', 'desvio', 'exemplo', 'exemplo', 'flavio', 'inquerito', 'lavagem', 'observacao', 'percepcao', 'plena', 'supremo', 'tambem']","[1, 1, 1, 1, 2, 2, 1, 1, 1, 1, 1, 1, 1, 1]","['manchet']","[1]",14,1,15,1
4357,"['academiar', 'ambientar', 'ambito', 'apostar', 'argumentar', 'argumentar', 'articulacao', 'articulacao', 'autoridad', 'autorizacao', 'autorizacao', 'cenario', 'colaboracao', 'colaboracao', 'comissao', 'comportamento', 'condicao', 'conflito', 'conflito', 'conjuntar', 'consequencia', 'crise', 'crise', 'crise', 'crise', 'decisao', 'decisao', 'decisao', 'decorrencia', 'demm', 'destinar', 'divergencia', 'economia', 'economia', 'economia', 'enxergar', 'enxergar', 'epidemiar', 'epidemiar', 'epidemiar', 'epidemiar', 'especializar', 'europeu', 'exministro', 'exministro', 'exministro', 'exministro', 'exonerar', 'exonerar', 'fase', 'fase', 'federar', 'gabbardo', 'gabbardo', 'gripezinha', 'henriqu', 'henriqu', 'infeccioso', 'infeccioso', 'infectar', 'iniciativo', 'iniciativo', 'interino', 'interino', 'logistico', 'ministrar', 'ministrar', 'ministrar', 'ministrar', 'necessario', 'necessidad', 'nelson', 'nelson', 'nelson', 'nelson', 'normalidad', 'oliveira', 'orientacao', 'pastar', 'pastar', 'pastar', 'periodo', 'privar', 'privar', 'quarentenar', 'quarentenar', 'recurso', 'regiao', 'regiao', 'respostar', 'saudar', 'saudar', 'saudar', 'saudar', 'saudar', 'saudar', 'saudar', 'saudar', 'saudar', 'saudar', 'saudar', 'saudar', 'saudar', 'saudar', 'saudar', 'saudar', 'saudar', 'saudar', 'saudar', 'saudar', 'saudar', 'segredar', 'segredar', 'segredar', 'segredar', 'segredar', 'segredar', 'supremo', 'teich', 'teich', 'teich', 'teich', 'teich', 'temporariament', 'temporariament', 'vigilancia']","[1, 1, 1, 1, 2, 2, 2, 2, 1, 2, 2, 1, 2, 2, 1, 1, 1, 2, 2, 1, 1, 4, 4, 4, 4, 3, 3, 3, 1, 1, 1, 1, 3, 3, 3, 2, 2, 4, 4, 4, 4, 1, 1, 4, 4, 4, 4, 2, 2, 2, 2, 1, 2, 2, 1, 2, 2, 2, 2, 1, 2, 2, 2, 2, 1, 4, 4, 4, 4, 1, 1, 4, 4, 4, 4, 1, 1, 1, 3, 3, 3, 1, 2, 2, 2, 2, 1, 2, 2, 1, 21, 21, 21, 21, 21, 21, 21, 21, 21, 21, 21, 21, 21, 21, 21, 21, 21, 21, 21, 21, 21, 6, 6, 6, 6, 6, 6, 1, 5, 5, 5, 5, 5, 2, 2, 1]","['adorar', 'adorar', 'crer', 'escutar', 'imagem', 'realment', 'verificar']","[2, 2, 1, 1, 1, 1, 1]",126,7,133,1
4359,"['alternativo', 'antecipar', 'biliao', 'biliao', 'biliao', 'biliao', 'biliao', 'crise', 'emprestimo', 'parcelar', 'recordar', 'recurso', 'reuter', 'superar']","[1, 1, 5, 5, 5, 5, 5, 1, 1, 1, 1, 1, 1, 1]","[]","[]",14,0,14,1
4360,"['coletivo', 'decisao', 'decisao', 'justicar', 'sentenca', 'varar']","[1, 2, 2, 1, 1, 1]","['desgracar', 'desgracar', 'ganhar']","[2, 2, 1]",6,3,9,1
4364,"['domingo', 'funcao', 'funcao', 'sabado', 'vespera']","[1, 2, 2, 1, 1]","[]","[]",5,0,5,1
4365,"['anvisa', 'apurar', 'armazenamento', 'atrasar', 'campino', 'campino', 'campino', 'capitar', 'cerimonia', 'companhia', 'condicao', 'contabilizar', 'contemplar', 'destinar', 'enfrentamento', 'esquema', 'inclusao', 'integrant', 'logistico', 'ministrar', 'necessidad', 'pastar', 'presenca', 'prever', 'previsao', 'queiroga', 'recebido', 'remessar', 'respostar', 'saudar', 'saudar', 'saudar', 'vigilancia']","[1, 1, 1, 1, 3, 3, 3, 1, 1, 1, 1, 1, 1, 1, 1, 1, 1, 1, 1, 1, 1, 1, 1, 1, 1, 1, 1, 1, 1, 3, 3, 3, 1]","[]","[]",33,0,33,1
4368,"['boletim', 'boletim', 'consorcio', 'interino', 'levantamento', 'ministrar', 'saudar', 'saudar']","[2, 2, 1, 1, 1, 1, 2, 2]","['safar']","[1]",8,1,9,1
4370,"['condicao', 'confederacao', 'integro', 'ministrar', 'necessario', 'previsao', 'prioritario', 'saudar', 'suspensao']","[1, 1, 1, 1, 1, 1, 1, 1, 1]","[]","[]",9,0,9,1
4373,"['aspecto', 'cenario', 'colunista', 'consequencia', 'consequencia', 'henriqu', 'henriqu', 'negativa', 'negativa', 'negativa', 'negativa']","[1, 1, 1, 2, 2, 2, 2, 4, 4, 4, 4]","[]","[]",11,0,11,1
4375,"['dificuldad', 'domicilio', 'domicilio', 'domicilio', 'estatistico', 'geografia', 'ibg', 'ibg', 'ibg', 'instituto', 'levantamento', 'necessario', 'saudar', 'taxar']","[1, 3, 3, 3, 1, 1, 3, 3, 3, 1, 1, 1, 1, 1]","[]","[]",14,0,14,1
4376,"[]","[]","[]","[]",0,0,0,1
4377,"['augusto', 'colegiado', 'colegiado', 'comissao', 'comissao', 'cupula', 'elaborar', 'entendimento', 'expressar', 'humanitario', 'internar', 'republico', 'requerimento', 'respostar']","[1, 2, 2, 2, 2, 1, 1, 1, 1, 1, 1, 1, 1, 1]","['realment']","[1]",14,1,15,1
4379,"['anvisa', 'autoridad', 'calamidad', 'circulacao', 'decisao', 'decisao', 'julgamento', 'periodo', 'provisorio', 'restritivo', 'situacao', 'supremo', 'vigilancia']","[1, 1, 1, 1, 2, 2, 1, 1, 1, 1, 1, 1, 1]","[]","[]",13,0,13,1
4380,"['autoridad', 'crise', 'descumprir', 'dinamarca', 'domingo', 'especifico', 'previsto', 'regrar', 'restritivo', 'reuniao', 'situacao']","[1, 1, 1, 1, 1, 1, 1, 1, 1, 1, 1]","[]","[]",11,0,11,1
4381,"['fux', 'fux', 'investigacao', 'investigacao', 'investigacao', 'julgamento', 'justicar', 'ministrar', 'ministrar', 'ministrar', 'servidor', 'servidor', 'supremo', 'supremo', 'sustentabilidad']","[2, 2, 3, 3, 3, 1, 1, 3, 3, 3, 2, 2, 2, 2, 1]","[]","[]",15,0,15,1
4382,"['positivar', 'positivar', 'sabado', 'saudar']","[2, 2, 1, 1]","['clicar']","[1]",4,1,5,1
4385,"['afastamento', 'afastamento', 'afastamento', 'biliao', 'calheiro', 'cnmp', 'colunista', 'deltan', 'destinar', 'forcatarefa', 'fundacao', 'irregularidad', 'mdbal', 'precedent', 'privar', 'processo']","[3, 3, 3, 1, 1, 1, 1, 1, 1, 1, 1, 1, 1, 1, 1, 1]","['checar']","[1]",16,1,17,1
4390,"['balancar', 'crise', 'crise', 'decisao', 'diminuicao', 'discussao', 'economia', 'economia', 'economia', 'equilibrio', 'lesao', 'posicionamento', 'saudar', 'segredar', 'situacao', 'situacao', 'situacao']","[1, 2, 2, 1, 1, 1, 3, 3, 3, 1, 1, 1, 1, 1, 3, 3, 3]","['amigar']","[1]",17,1,18,1
4398,"['antonio', 'compromisso', 'compromisso', 'conflito', 'conflito', 'conjuntar', 'dialogo', 'domingo', 'fronteiro', 'humanitario', 'humanitario', 'jorg', 'necessario', 'necessidad', 'periodo', 'reforcar', 'situacao', 'superar', 'vulnerabilidad']","[1, 2, 2, 2, 2, 1, 1, 1, 1, 2, 2, 1, 1, 1, 1, 1, 1, 1, 1]","['catolico']","[1]",19,1,20,1
4403,"['comissao', 'congresso', 'converso', 'discussao', 'disseminacao', 'inquerito', 'mudanca', 'plenario', 'prever', 'proposto', 'sugestao']","[1, 1, 1, 1, 1, 1, 1, 1, 1, 1, 1]","['versao']","[1]",11,1,12,1
4404,"['armazenamento', 'armazenamento', 'capitar', 'condicao', 'exigencia', 'medeiro', 'prever', 'previsto', 'remessar', 'respostar', 'saudar', 'saudar', 'saudar', 'vigilancia']","[2, 2, 1, 1, 1, 1, 1, 1, 1, 1, 3, 3, 3, 1]","[]","[]",14,0,14,1
4405,"['comparacao', 'consolidar', 'consorcio', 'distrito', 'estabilidad', 'estabilidad', 'levantamento', 'saudar', 'situacao', 'tendencia', 'tendencia', 'variacao', 'variacao']","[1, 1, 1, 1, 2, 2, 1, 1, 1, 2, 2, 2, 2]","[]","[]",13,0,13,1
4413,"['administrativo', 'amplo', 'anvisa', 'decisao', 'lewandowski', 'ministrar', 'prazo', 'ricardo', 'sputnik', 'supremo', 'tramitar', 'vigilancia']","[1, 1, 1, 1, 1, 1, 1, 1, 1, 1, 1, 1]","[]","[]",12,0,12,1
4415,"['afetado', 'economia', 'infectar', 'respectivament', 'volumar']","[1, 1, 1, 1, 1]","[]","[]",5,0,5,1
4416,"['autoridad', 'competicao', 'destinar', 'epidemiar', 'escassez', 'pagamento', 'pratico', 'regiao', 'viagem']","[1, 1, 1, 1, 1, 1, 1, 1, 1]","[]","[]",9,0,9,1
4417,"['instituto', 'negativar', 'periodo', 'positivar', 'presenca', 'quedo']","[1, 1, 1, 1, 1, 1]","['incendio', 'mentiroso', 'mentiroso', 'vazar']","[1, 2, 2, 1]",6,4,10,1
4423,"['aglomeracao', 'calendario', 'calendario', 'crise', 'emergenciai', 'pagamento', 'pagamento', 'recurso', 'transferencia', 'transferencia']","[1, 2, 2, 1, 1, 2, 2, 1, 2, 2]","['sacar', 'sacar', 'sacar']","[3, 3, 3]",10,3,13,1
4425,"['crise', 'crise', 'periodo', 'periodo', 'saudar', 'universitario']","[2, 2, 2, 2, 1, 1]","[]","[]",6,0,6,1
4426,"['circulacao', 'disseminacao', 'estatistico', 'pagamento']","[1, 1, 1, 1]","['disseminar']","[1]",4,1,5,1
4427,"['autoridad', 'balancar', 'belgica', 'epidemiar', 'equipamento', 'espanha', 'espanha', 'preocupacao', 'saudar', 'situacao', 'surto']","[1, 1, 1, 1, 1, 2, 2, 1, 1, 1, 1]","['atribuir']","[1]",11,1,12,1
4428,"['adicionar', 'condicao', 'cronica', 'destinar', 'obesidad', 'parceiro', 'parceiro', 'pulmonar', 'quarentenar', 'temporariament']","[1, 1, 1, 1, 1, 2, 2, 1, 1, 1]","['espalhar']","[1]",10,1,11,1
4430,"['crise', 'destacar', 'respostar', 'sabado']","[1, 1, 1, 1]","['manchet']","[1]",4,1,5,1
4432,"['adiamento', 'afastamento', 'afastamento', 'argumentar', 'decisao', 'deflagrar', 'desvio', 'empatar', 'forcatarefa', 'goncalv', 'irregularidad', 'julgamento', 'julgamento', 'julgamento', 'justicar', 'ministrar', 'necessario', 'recurso', 'republico', 'saudar', 'sessao', 'supremo', 'wilson', 'witzel', 'witzel', 'witzel', 'witzel']","[1, 2, 2, 1, 1, 1, 1, 1, 1, 1, 1, 3, 3, 3, 1, 1, 1, 1, 1, 1, 1, 1, 1, 4, 4, 4, 4]","[]","[]",27,0,27,1
4436,"['aglomeracao', 'argumentar', 'autoridad', 'biliao', 'destacar', 'feriar', 'hospitalizar', 'igualitario', 'infectar', 'iniciativo', 'iniciativo', 'iniciativo', 'panamericana', 'prioridad', 'regiao', 'regiao', 'regiao', 'regiao', 'respostar', 'saudar', 'saudar', 'semestr', 'vulneravel']","[1, 1, 1, 1, 1, 1, 1, 1, 1, 3, 3, 3, 1, 1, 4, 4, 4, 4, 1, 2, 2, 1, 1]","[]","[]",23,0,23,1
4437,"['acumular', 'atuacao', 'condicao', 'crescimento', 'desempenhar', 'enfatizar', 'infancia', 'iniciativo', 'julgamento', 'preconceito', 'preconceito', 'preconceito', 'saudar', 'sugestao', 'sugestao', 'urbano', 'volumar']","[1, 1, 1, 1, 1, 1, 1, 1, 1, 3, 3, 3, 1, 2, 2, 1, 1]","['circular', 'fingir', 'imagem', 'imagem']","[1, 1, 2, 2]",17,4,21,1
4438,"['assintomatico', 'assintomatico', 'boletim', 'domingo', 'mandatario', 'mexico', 'positivar', 'relativo', 'saudar', 'saudar', 'saudar']","[2, 2, 1, 1, 1, 1, 1, 1, 3, 3, 3]","[]","[]",11,0,11,1
4441,"['adhanom', 'adhanom', 'esforco', 'saudar', 'tedro', 'tedro']","[2, 2, 1, 1, 2, 2]","[]","[]",6,0,6,1
4444,"['calculo', 'colunista', 'competicao', 'comportamento', 'realizacao', 'recuar', 'recuar', 'souza']","[1, 1, 1, 1, 1, 2, 2, 1]","['ganhar']","[1]",8,1,9,1
4445,"['comissao', 'comissao', 'comissao', 'consultoria', 'demmg', 'enfrentamento', 'federar', 'humberto', 'inquerito', 'inquerito', 'integrant', 'internar', 'investigacao', 'irregularidad', 'legislativo', 'pacheco', 'pratico', 'recurso', 'recurso', 'relativo', 'secretariager', 'transferir']","[3, 3, 3, 1, 1, 1, 1, 1, 2, 2, 1, 1, 1, 1, 1, 1, 1, 2, 2, 1, 1, 1]","[]","[]",22,0,22,1
4446,"['assistencia', 'orientacao', 'preocupacao', 'saudar', 'saudar', 'saudar', 'saudar', 'situacao']","[1, 1, 1, 4, 4, 4, 4, 1]","['garganta']","[1]",8,1,9,1
4449,"['comissao', 'constituicao', 'crise', 'desafio', 'discussao', 'instituto', 'ministrar', 'ministrar', 'ministrar', 'ministrar', 'ministrar', 'palacio', 'planalto', 'possibilidad', 'situacao', 'substituto', 'supremo']","[1, 1, 1, 1, 1, 1, 5, 5, 5, 5, 5, 1, 1, 1, 1, 1, 1]","[]","[]",17,0,17,1
4450,"['interrupcao', 'parcelar', 'pib']","[1, 1, 1]","[]","[]",3,0,3,1
4452,"['plenario', 'pslrj', 'republico', 'reuniao', 'reuniao', 'sessao', 'silveiro', 'silveiro', 'silveiro', 'silveiro', 'substituicao', 'supremo']","[1, 1, 1, 2, 2, 1, 4, 4, 4, 4, 1, 1]","[]","[]",12,0,12,1
4453,"['biliao', 'biliao', 'comissao', 'comissao', 'concreto', 'desenvolvimento', 'desenvolvimento', 'esforco', 'europeu', 'europeu', 'europeu', 'europeu', 'europeu', 'iniciativo', 'parceria', 'reforcar', 'saudar']","[2, 2, 2, 2, 1, 2, 2, 1, 5, 5, 5, 5, 5, 1, 1, 1, 1]","['verdadeiro']","[1]",17,1,18,1
4454,"['acompanhamento', 'antecipar', 'conformar', 'destinar', 'determinacao', 'diagnostica', 'dificuldad', 'etapa', 'etapa', 'fase', 'flexibilizacao', 'folhar', 'independentement', 'infraestrutura', 'orientacao', 'planar', 'plantao', 'presenciar', 'presenciar', 'presenciar', 'presenciar', 'presenciar', 'presenciar', 'prioridad', 'privar', 'quarentenar', 'realizacao', 'recuperacao', 'reforcar', 'regrar', 'resolucao', 'spaulo']","[1, 1, 1, 1, 1, 1, 1, 2, 2, 1, 1, 1, 1, 1, 1, 1, 1, 6, 6, 6, 6, 6, 6, 1, 1, 1, 1, 1, 1, 1, 1, 1]","[]","[]",32,0,32,1
4455,"['arrecadar', 'assistencia', 'comprometido', 'contribuicao', 'desenvolvimento', 'elson', 'esperancar', 'incerteza', 'infeccioso', 'recurso', 'saudar']","[1, 1, 1, 1, 1, 1, 1, 1, 1, 1, 1]","['desfilar']","[1]",11,1,12,1
4457,"['apreensao', 'augusto', 'celso', 'interferencia', 'investigacao', 'investigacao', 'investigacao', 'mello', 'ministrar', 'republico', 'supremo']","[1, 1, 1, 1, 3, 3, 3, 1, 1, 1, 1]","[]","[]",11,0,11,1
4458,"['amplo', 'autoridad', 'equivalent', 'propagacao', 'saudar']","[1, 1, 1, 1, 1]","['compartilhar', 'gravacao', 'legendar', 'legendar']","[1, 1, 2, 2]",5,4,9,1
4459,"['consorcio', 'decisao', 'dialogo', 'plano', 'regiao', 'reuniao']","[1, 1, 1, 1, 1, 1]","[]","[]",6,0,6,1
4460,"['andrea', 'andrea', 'associacao', 'comprometido', 'condicao', 'etapa', 'fase', 'fase', 'fase', 'funcionamento', 'intenso', 'martim', 'normalment', 'normalment', 'paralisar', 'paralisar', 'periodo', 'psicologo', 'psicologo', 'relaxamento', 'relaxar', 'rotina', 'saudar', 'saudar', 'situacao', 'situacao', 'transicao']","[2, 2, 1, 1, 1, 1, 3, 3, 3, 1, 1, 1, 2, 2, 2, 2, 1, 2, 2, 1, 1, 1, 2, 2, 2, 2, 1]","['compartilhar', 'desligar', 'desligar']","[1, 2, 2]",27,3,30,1
4462,"['ampliacao', 'antecipar', 'bandeirant', 'decisao', 'destacar', 'economia', 'fase', 'flavio', 'funcionamento', 'importancia', 'jornada', 'mudanca', 'palacio', 'planar', 'reabertura', 'reabrir']","[1, 1, 1, 1, 1, 1, 1, 1, 1, 1, 1, 1, 1, 1, 1, 1]","[]","[]",16,0,16,1
4463,"['condicao', 'crise', 'demrj', 'economia', 'pagamento', 'pagamento', 'prazo', 'provisorio', 'recurso', 'reforcar', 'regulamentar', 'sancao', 'vulneravel']","[1, 1, 1, 1, 2, 2, 1, 1, 1, 1, 1, 1, 1]","[]","[]",13,0,13,1
4468,"['comorbidad', 'competicao', 'complicacao', 'decorrencia', 'internar', 'piorar', 'saudar']","[1, 1, 1, 1, 1, 1, 1]","[]","[]",7,0,7,1
4469,"['alternativo', 'argumentar', 'demmg', 'integro', 'pacheco', 'pacheco', 'posturar', 'reuniao']","[1, 1, 1, 1, 2, 2, 1, 1]","[]","[]",8,0,8,1
4470,"['arrecadacao', 'domingo', 'internar', 'isolar', 'palacio', 'privar', 'saudar']","[1, 1, 1, 1, 1, 1, 1]","[]","[]",7,0,7,1
4471,"['consolidar', 'consorcio', 'domingo', 'levantamento', 'saudar', 'situacao', 'variacao', 'variacao']","[1, 1, 1, 1, 1, 1, 2, 2]","[]","[]",8,0,8,1
4472,"['atrasar', 'boletim', 'boletim', 'destacar', 'estimativo', 'estimativo', 'estimativo', 'estimativo', 'funcao', 'fundacao', 'internacao', 'internacao', 'internacao', 'quedo', 'respiratorio', 'tendencia']","[1, 2, 2, 1, 4, 4, 4, 4, 1, 1, 3, 3, 3, 1, 1, 1]","[]","[]",16,0,16,1
4474,"['agravar', 'antecipar', 'decisao', 'desembarcar', 'distant', 'forcatarefa', 'imunizacao', 'indicador', 'ministrar', 'ministrar', 'panamericana', 'planar', 'presenca', 'reafirmar', 'reuniao', 'saudar', 'saudar', 'saudar', 'wilson']","[1, 1, 1, 1, 1, 1, 1, 1, 2, 2, 1, 1, 1, 1, 1, 3, 3, 3, 1]","[]","[]",19,0,19,1
4475,"['acumular', 'avancar', 'congresso', 'discussao', 'flexibilizar', 'iniciativo', 'posturar', 'recurso', 'relativo', 'supremo']","[1, 1, 1, 1, 1, 1, 1, 1, 1, 1]","['deitar', 'ideologia']","[1, 1]",10,2,12,1
4476,"['alteracao', 'ambientar', 'atuam', 'cerimonia', 'cerimonia', 'decisao', 'determinacao', 'enxergar', 'independentement', 'justicar', 'necessario', 'periodo', 'precaucao', 'precaucao', 'respiratorio', 'sindicato', 'suspeito', 'transmissao']","[1, 1, 1, 2, 2, 1, 1, 1, 1, 1, 1, 1, 2, 2, 1, 1, 1, 1]","[]","[]",18,0,18,1
4477,"['autoridad', 'deteccao', 'importacao', 'importacao', 'instalacao', 'positivar', 'previo', 'provincia', 'suspenso', 'temporariament']","[1, 1, 2, 2, 1, 1, 1, 1, 1, 1]","[]","[]",10,0,10,1
4479,"['apurar', 'arrecadacao', 'biliao', 'campino', 'campino', 'crise', 'folhar', 'genoma', 'infraestrutura', 'pagamento', 'previsao', 'previsao', 'recebido', 'recordar', 'recurso', 'recurso', 'recurso', 'regiao', 'universitario', 'universitario']","[1, 1, 1, 2, 2, 1, 1, 1, 1, 1, 2, 2, 1, 1, 3, 3, 3, 1, 2, 2]","['sequer']","[1]",20,1,21,1
4480,"['epidemiologico', 'infectar', 'infectar', 'infectar', 'inquerito', 'necessario', 'necessidad', 'pastar', 'pastar', 'rossi', 'saudar', 'saudar', 'transmissao', 'turma']","[1, 3, 3, 3, 1, 1, 1, 2, 2, 1, 2, 2, 1, 1]","['captar']","[1]",14,1,15,1
4481,"['augusto', 'autoridad', 'diagnosticar', 'diagnosticar', 'gabinet', 'heleno', 'lorenzoni', 'onyx', 'republico', 'saudar', 'saudar']","[1, 1, 2, 2, 1, 1, 1, 1, 1, 2, 2]","[]","[]",11,0,11,1
4482,"['iniciativo', 'periodo', 'periodo', 'reclamacao']","[1, 2, 2, 1]","['filmar', 'filmar', 'filmar']","[3, 3, 3]",4,3,7,1
4483,"['adversario', 'aurelio', 'barroso', 'decisao', 'edson', 'exjuiz', 'exjuiz', 'fachin', 'fux', 'fux', 'julgamento', 'manutencao', 'mello', 'palacio', 'planalto', 'plenario', 'plenario', 'sessao', 'sessao', 'supremo', 'suspeicao', 'suspeicao', 'turma']","[1, 1, 1, 1, 1, 2, 2, 1, 2, 2, 1, 1, 1, 1, 1, 2, 2, 2, 2, 1, 2, 2, 1]","[]","[]",23,0,23,1
4486,"['folhar', 'infancia', 'nelson', 'parceria', 'sabatino', 'sabatino', 'spaulo', 'varar', 'wilson', 'witzel']","[1, 1, 1, 1, 2, 2, 1, 1, 1, 1]","[]","[]",10,0,10,1
4487,"['economia', 'levantamento', 'paralisar', 'prioridad', 'sindicato']","[1, 1, 1, 1, 1]","['amplament', 'amplament', 'greve', 'greve']","[2, 2, 2, 2]",5,4,9,1
4492,"['atrasar', 'crescimento', 'demandar', 'domingo', 'equipamento', 'intensivo', 'metropolitano', 'previsao', 'previsao']","[1, 1, 1, 1, 1, 1, 1, 2, 2]","[]","[]",9,0,9,1
4493,"['autoridad', 'californio', 'disseminacao', 'piorar', 'preocupacao', 'presenca', 'regiao', 'saudar', 'situacao', 'suprimento']","[1, 1, 1, 1, 1, 1, 1, 1, 1, 1]","[]","[]",10,0,10,1
4494,"['acordo', 'afp', 'autoridad', 'deteccao', 'epicentro', 'epidemia', 'genoma', 'mutacao', 'tambem', 'viajant']","[1, 1, 1, 1, 1, 1, 1, 1, 1, 1]","[]","[]",10,0,10,1
4496,"['autonomia', 'compromisso', 'decisao', 'decisao', 'efetividad', 'enfrentamento', 'entendimento', 'equipamento', 'estrategico', 'necessidad', 'orientacao', 'orientacao', 'pastar', 'pastar', 'reducao', 'regiao', 'respostar', 'saudar', 'saudar', 'supremo', 'transmissao']","[1, 1, 2, 2, 1, 1, 1, 1, 1, 1, 2, 2, 2, 2, 1, 1, 1, 2, 2, 1, 1]","[]","[]",21,0,21,1
4497,"['escalar', 'impacto', 'negativar', 'passageiro', 'passageiro', 'preservacao', 'sabado', 'sabado', 'submetido', 'viagem']","[1, 1, 1, 2, 2, 1, 2, 2, 1, 1]","['ganhar']","[1]",10,1,11,1
4498,"['distant', 'imunizacao', 'ministrar', 'recurso', 'saudar', 'vieira', 'vieira']","[1, 1, 1, 1, 1, 2, 2]","[]","[]",7,0,7,1
4499,"['desenvolvido', 'folhar', 'instituto', 'instituto', 'integro', 'pastar', 'pastar', 'saudar']","[1, 1, 2, 2, 1, 2, 2, 1]","[]","[]",8,0,8,1
4501,"['apurar', 'decisao', 'decisao', 'decisao', 'decisao', 'flavio', 'flavio', 'fundamentar', 'gabinet', 'justicar', 'justicar', 'legislativo', 'magistrado', 'mprj', 'rachadinha', 'republicanosrj', 'turma', 'varar']","[1, 4, 4, 4, 4, 2, 2, 1, 1, 2, 2, 1, 1, 1, 1, 1, 1, 1]","[]","[]",18,0,18,1
4502,"['carla', 'carla', 'carla', 'compromisso', 'compromisso', 'positivar', 'pslsp', 'zambelli', 'zambelli', 'zambelli', 'zambelli', 'zambelli']","[3, 3, 3, 2, 2, 1, 1, 5, 5, 5, 5, 5]","['compartilhar', 'compartilhar']","[2, 2]",12,2,14,1
4503,"['acompanhamento', 'acumular', 'diagnosticar', 'domingo', 'parceria', 'saudar', 'saudar', 'saudar', 'saudar']","[1, 1, 1, 1, 1, 4, 4, 4, 4]","[]","[]",9,0,9,1
4504,"['atrasar', 'boletim', 'consorcio', 'decorrencia', 'epidemiar', 'epidemiar', 'estatistico', 'levantamento', 'notificar', 'observar', 'observar', 'regiao', 'sabado', 'sudest', 'tendencia', 'variacao']","[1, 1, 1, 1, 2, 2, 1, 1, 1, 2, 2, 1, 1, 1, 1, 1]","[]","[]",16,0,16,1
4506,"['anteontem', 'comorbidad', 'comorbidad', 'etapa', 'etapa']","[1, 2, 2, 2, 2]","[]","[]",5,0,5,1
4507,"['biliao', 'cenario', 'cenario', 'comissao', 'epidemiar', 'estagio', 'estimativo', 'impactar', 'infectar', 'projecao', 'projeco', 'propagacao', 'regiao', 'vulneravel']","[1, 2, 2, 1, 1, 1, 1, 1, 1, 1, 1, 1, 1, 1]","[]","[]",14,0,14,1
4509,"['argumentar', 'associacao', 'associacao', 'bandeirant', 'concedido', 'condicao', 'destacar', 'espanha', 'flexibilizacao', 'flexibilizacao', 'funcionamento', 'oficio', 'palacio', 'periodo', 'possibilidad', 'rejeitar', 'situacao']","[1, 2, 2, 1, 1, 1, 1, 1, 2, 2, 1, 1, 1, 1, 1, 1, 1]","[]","[]",17,0,17,1
4510,"['companhia', 'comportamento', 'contencao', 'diariament', 'restritivo']","[1, 1, 1, 1, 1]","['libertador']","[1]",5,1,6,1
4514,"['depoimento', 'depoimento', 'exministro', 'exministro', 'exministro', 'logistico', 'planar', 'saudar', 'saudar', 'saudar', 'saudar', 'servidor', 'servidor']","[2, 2, 3, 3, 3, 1, 1, 4, 4, 4, 4, 2, 2]","['atribuir']","[1]",13,1,14,1
4515,"['biliao', 'carat', 'congresso', 'domingo', 'economia', 'economia', 'gued', 'gued', 'justicar', 'ministrar', 'ministrar', 'orcamentaria', 'pagamento', 'pagamento', 'proposto', 'proposto', 'proposto', 'proposto', 'provisorio', 'rejeitar']","[1, 1, 1, 1, 2, 2, 2, 2, 1, 2, 2, 1, 2, 2, 4, 4, 4, 4, 1, 1]","[]","[]",20,0,20,1
4516,"['algun', 'economia', 'fez', 'medida', 'medida', 'medida', 'medida', 'privilegiar', 'risco', 'sido']","[1, 1, 1, 4, 4, 4, 4, 1, 1, 1]","[]","[]",10,0,10,1
4520,"['aliviar', 'preocupacao', 'pulmonar']","[1, 1, 1]","['arquivar', 'imagem', 'imagem']","[1, 2, 2]",3,3,6,1
4524,"['ambientar', 'atuacao', 'fux', 'fux', 'importancia', 'ministrar', 'ministrar', 'ministrar', 'ministrar', 'ministrar', 'supremo', 'supremo', 'videoconferencia']","[1, 1, 2, 2, 1, 5, 5, 5, 5, 5, 2, 2, 1]","[]","[]",13,0,13,1
4528,"['ambientar', 'ambientar', 'ambientar', 'ambientar', 'avancar', 'cupula', 'desafiar', 'desmatamento', 'desmatamento', 'flexibilizacao', 'instituto', 'necessidad', 'preservar', 'regrar']","[4, 4, 4, 4, 1, 1, 1, 2, 2, 1, 1, 1, 1, 1]","[]","[]",14,0,14,1
4530,"['autoridad', 'cenario', 'decisao', 'epidemiologico', 'mutacao', 'mutacao', 'prorrogacao', 'regiao', 'regiao', 'reuniao', 'saudar', 'saudar']","[1, 1, 1, 1, 2, 2, 1, 2, 2, 1, 2, 2]","[]","[]",12,0,12,1
4531,"['conjunto', 'conjunto', 'distrito', 'distrito', 'enfrentamento', 'fronteiro', 'justicar', 'reforcar', 'saudar', 'saudar', 'suprimento']","[2, 2, 2, 2, 1, 1, 1, 1, 2, 2, 1]","[]","[]",11,0,11,1
4532,"['apurar', 'augusto', 'azevedo', 'celso', 'celso', 'improbidad', 'informaco', 'mello', 'processo', 'supremo', 'supremo']","[1, 1, 1, 2, 2, 1, 1, 1, 1, 2, 2]","[]","[]",11,0,11,1
4535,"['acordo', 'carat', 'comorbidad', 'decisao', 'embora', 'especifico', 'gestant', 'gestant', 'gestant', 'gestant', 'inclusao', 'inclusao', 'independentement', 'informaco', 'letalidad', 'previo', 'quadro', 'rigoroso', 'risco', 'risco', 'risco', 'risco', 'risco', 'risco', 'sendo', 'sendo']","[1, 1, 1, 1, 1, 1, 4, 4, 4, 4, 2, 2, 1, 1, 1, 1, 1, 1, 6, 6, 6, 6, 6, 6, 2, 2]","[]","[]",26,0,26,1
4536,"['apurar', 'atrair', 'claudio', 'client', 'client', 'colaboracao', 'condenacao', 'destacar', 'esquema', 'exportacao', 'funcao', 'lavagem', 'lavagem', 'movimentacao', 'obtido', 'obtido', 'pagamento', 'pagamento', 'pagamento', 'paralelo', 'sentenca', 'sentenca', 'varar', 'varar']","[1, 1, 1, 2, 2, 1, 1, 1, 1, 1, 1, 2, 2, 1, 2, 2, 3, 3, 3, 1, 2, 2, 2, 2]","[]","[]",24,0,24,1
4537,"['assistencia', 'assistencia', 'assistencia', 'conformar', 'desembarcar', 'dificuldad', 'dificuldad', 'distrito', 'enfrentamento', 'enfrentamento', 'equipamento', 'equipamento', 'equipamento', 'equipamento', 'estrategico', 'infectar', 'infectar', 'pulmonar', 'pulmonar', 'pulmonar', 'pulmonar', 'reforcar', 'reforcar', 'respiratorio', 'respiratorio', 'saudar', 'saudar', 'saudar', 'saudar', 'saudar', 'saudar', 'suportar', 'transmissao', 'velocidad', 'ventilador', 'ventilador', 'ventilador', 'ventilador', 'ventilador', 'ventilatorio']","[3, 3, 3, 1, 1, 2, 2, 1, 2, 2, 4, 4, 4, 4, 1, 2, 2, 4, 4, 4, 4, 2, 2, 2, 2, 6, 6, 6, 6, 6, 6, 1, 1, 1, 5, 5, 5, 5, 5, 1]","['ganhar']","[1]",40,1,41,1
4542,"['anvisa', 'aprovacao', 'fase', 'imunizacao', 'inclusao', 'ministrar', 'oficialment', 'planar', 'previsao', 'sabado', 'saudar', 'saudar', 'saudar', 'supremo', 'vigilancia']","[1, 1, 1, 1, 1, 1, 1, 1, 1, 1, 3, 3, 3, 1, 1]","['cobaia']","[1]",15,1,16,1
4543,"['dedicar', 'funcionamento', 'respostar', 'tendencia', 'trimestr']","[1, 1, 1, 1, 1]","[]","[]",5,0,5,1
4546,"['academiar', 'aglomeracao', 'client', 'condicao', 'distrito', 'especifico', 'especifico', 'paralisar', 'prazo', 'privar', 'reabrir', 'rocha', 'suspensao']","[1, 1, 1, 1, 1, 2, 2, 1, 1, 1, 1, 1, 1]","[]","[]",13,0,13,1
4550,"['distrito', 'esperancar', 'inicialment', 'integro', 'intensivo', 'internar', 'periferia', 'quilometro', 'regiao', 'regiao', 'republico']","[1, 1, 1, 1, 1, 1, 1, 1, 2, 2, 1]","[]","[]",11,0,11,1
4552,"['anvisa', 'autorizacao', 'comissao', 'elaborar', 'estrategia', 'imunizacao', 'instituto', 'interpretar', 'ministrar', 'parceria', 'planar', 'preocupacao', 'saudar', 'vigilancia', 'wellington']","[1, 1, 1, 1, 1, 1, 1, 1, 1, 1, 1, 1, 1, 1, 1]","[]","[]",15,0,15,1
4553,"['internar', 'internar']","[2, 2]","['menino']","[1]",2,1,3,1
4554,"['saudar']","[1]","[]","[]",1,0,1,1
4555,"['aprovacao', 'saudar', 'saudar', 'triagem']","[1, 2, 2, 1]","[]","[]",4,0,4,1
4556,"['decisao', 'enquadrar', 'folhar', 'folhar', 'irregularidad', 'ministrar', 'ministrar', 'montant', 'pagamento', 'pagamento', 'pagamento', 'tcu']","[1, 1, 2, 2, 1, 2, 2, 1, 3, 3, 3, 1]","[]","[]",12,0,12,1
4557,"['inglaterra', 'primeiroministro', 'sudest']","[1, 1, 1]","[]","[]",3,0,3,1
4560,"['acordo', 'associacao', 'cenario', 'condicao', 'condicao', 'crise', 'dificuldad', 'domingo', 'economia', 'epidemia', 'inclusao', 'levantamento', 'milho', 'orientacao', 'painel', 'porqu', 'preconceito', 'preconceito', 'preconceito', 'risco', 'suspensao', 'tambem', 'wilson', 'wilson']","[1, 1, 1, 2, 2, 1, 1, 1, 1, 1, 1, 1, 1, 1, 1, 1, 3, 3, 3, 1, 1, 1, 2, 2]","[]","[]",24,0,24,1
4561,"['comportamento', 'internacao', 'internar', 'observar', 'quadro', 'regiao', 'restritivo', 'risco', 'saudar', 'transmissao']","[1, 1, 1, 1, 1, 1, 1, 1, 1, 1]","[]","[]",10,0,10,1
4563,"['autoridad', 'fase', 'journal', 'reducao', 'risco']","[1, 1, 1, 1, 1]","[]","[]",5,0,5,1
4564,"['saudar']","[1]","[]","[]",1,0,1,1
4568,"['biliao', 'biliao', 'biliao', 'economia', 'gued', 'gued', 'pastar', 'reforcar']","[3, 3, 3, 1, 2, 2, 1, 1]","['torturar']","[1]",8,1,9,1
4569,"['araujo', 'comissao', 'congresso', 'converso', 'ernesto', 'europeu', 'ministrar', 'pslsp']","[1, 1, 1, 1, 1, 1, 1, 1]","[]","[]",8,0,8,1
4572,"['concedido', 'decisao', 'fux', 'julgamento', 'kassio', 'ministrar', 'plenario', 'prazo', 'prazo', 'supremo']","[1, 1, 1, 1, 1, 1, 1, 2, 2, 1]","[]","[]",10,0,10,1
4574,"['flexibilizar', 'flexibilizar', 'infraestrutura', 'integrant', 'palacio', 'planalto', 'possibilidad', 'possibilidad', 'possibilidad', 'prever']","[2, 2, 1, 1, 1, 1, 3, 3, 3, 1]","[]","[]",10,0,10,1
4578,"['alcolumbr', 'bastidor', 'congresso', 'congresso', 'decisao', 'demap', 'demrj', 'economia', 'governista', 'gued', 'legislativo', 'ministrar', 'pagamento', 'proposto', 'proposto', 'resistencia']","[1, 1, 2, 2, 1, 1, 1, 1, 1, 1, 1, 1, 1, 2, 2, 1]","[]","[]",16,0,16,1
4579,"['concedido', 'conformar', 'decisao', 'decisao', 'definitivo', 'entendimento', 'ministrar', 'plenario', 'plenario', 'prever', 'provisorio', 'republico', 'supremo', 'supremo', 'suspenso']","[1, 1, 2, 2, 1, 1, 1, 2, 2, 1, 1, 1, 2, 2, 1]","['verificar']","[1]",15,1,16,1
4580,"[]","[]","[]","[]",0,0,0,1
4585,"['afetado', 'belgica', 'belgica', 'belgica', 'espanha', 'habitant', 'proporcao', 'taxar']","[1, 3, 3, 3, 1, 1, 1, 1]","[]","[]",8,0,8,1
4586,"['anvisa', 'anvisa', 'autorizacao', 'autorizacao', 'desenvolvido', 'desenvolvido', 'fase', 'fase', 'fornecimento', 'prever', 'reuter', 'revisar', 'sputnik', 'sputnik', 'vigilancia']","[2, 2, 2, 2, 2, 2, 2, 2, 1, 1, 1, 1, 2, 2, 1]","[]","[]",15,0,15,1
4587,"['administrativo', 'decisao', 'decisao', 'desempenhar', 'destacar', 'nomeacao', 'nomeacao', 'pereira', 'souza', 'varar']","[1, 2, 2, 1, 1, 2, 2, 1, 1, 1]","[]","[]",10,0,10,1
4589,"['acompanhamento', 'anvisa', 'desembarcar', 'dificultar', 'guarulho', 'instituto', 'passageiro', 'viagem', 'viagem', 'vigilancia']","[1, 1, 1, 1, 1, 1, 1, 2, 2, 1]","['versao']","[1]",10,1,11,1
4590,"['contrato', 'expansao', 'fornecimento', 'instituto', 'milho', 'milho', 'milho', 'opcao', 'possibilidad', 'prazo', 'reafirm']","[1, 1, 1, 1, 3, 3, 3, 1, 1, 1, 1]","['cbn']","[1]",11,1,12,1
4597,"['arthur', 'arthur', 'arthur', 'cepa', 'exministro', 'exministro', 'preocupacao', 'republico', 'saudar']","[3, 3, 3, 1, 2, 2, 1, 1, 1]","[]","[]",9,0,9,1
4599,"['administrativo', 'anticorpo', 'anticorpo', 'colegio', 'colegio', 'colegio', 'europeu', 'imunizacao', 'infectar', 'instituto', 'presenca', 'presenca', 'regiao', 'rigoroso']","[1, 2, 2, 3, 3, 3, 1, 1, 1, 1, 2, 2, 1, 1]","['verificacao']","[1]",14,1,15,1
4601,"['bruto', 'decisao', 'fabricio', 'folhar', 'integro', 'justicar', 'queiroz', 'queiroz']","[1, 1, 1, 1, 1, 1, 2, 2]","['soltar']","[1]",8,1,9,1
4603,"['empatar', 'exprefeito', 'fluminens', 'liderar', 'rocha']","[1, 1, 1, 1, 1]","[]","[]",5,0,5,1
4607,"['associacao', 'decisao', 'economia', 'fase', 'flexibilizacao', 'implementacao', 'jurista', 'justicar', 'justicar', 'magistrado', 'planar', 'planar', 'quarentenar', 'quarentenar', 'reabertura', 'reabertura', 'sindicato']","[1, 1, 1, 1, 1, 1, 1, 2, 2, 1, 2, 2, 2, 2, 2, 2, 1]","[]","[]",17,0,17,1
4609,"['anuncio', 'companhia', 'crise', 'crise', 'enfatizar', 'fluxo', 'normalment', 'passageiro', 'piorar', 'prazo', 'preocupacao', 'preocupacao', 'quarentenar', 'quarentenar', 'quarentenar', 'trafego', 'trafego', 'viajant', 'viajant', 'viajant']","[1, 1, 2, 2, 1, 1, 1, 1, 1, 1, 2, 2, 3, 3, 3, 2, 2, 3, 3, 3]","[]","[]",20,0,20,1
4613,"['anuncio', 'campino', 'desenvolvido', 'infectar', 'inovacao', 'ministrar', 'presenca']","[1, 1, 1, 1, 1, 1, 1]","[]","[]",7,0,7,1
4614,"['aglomeracao', 'celebrar', 'comportamento', 'dificuldad', 'gabbardo', 'gabbardo', 'gabbardo', 'presenca', 'sabado', 'sabado', 'saudar', 'saudar', 'transmissao']","[1, 1, 1, 1, 3, 3, 3, 1, 2, 2, 2, 2, 1]","[]","[]",13,0,13,1
4617,"['aplicacao', 'cenario', 'conformar', 'dosar', 'dosar', 'efetividad', 'especializar', 'inicialment', 'panamericana', 'periodo', 'previo', 'saudar', 'transmissao']","[1, 1, 1, 2, 2, 1, 1, 1, 1, 1, 1, 1, 1]","['versao']","[1]",13,1,14,1
4618,"['coletivo', 'descumprir', 'entendimento', 'importancia', 'magistrado', 'martim', 'martim', 'metropolitano', 'reforcar', 'regiao', 'regiao', 'situacao', 'varar']","[1, 1, 1, 1, 1, 2, 2, 1, 1, 2, 2, 1, 1]","[]","[]",13,0,13,1
4622,"['cnmp', 'justicar', 'ministrar', 'punicao', 'republico', 'supremo', 'suspenso']","[1, 1, 1, 1, 1, 1, 1]","['compartilhar', 'compartilhar']","[2, 2]",7,2,9,1
4623,"['aglomeracao', 'aglomeracao', 'especifico', 'feriar', 'feriar', 'necessidad', 'necessidad', 'reforcar', 'reforcar', 'sobretudo', 'viagem', 'viagem', 'vigilancia']","[2, 2, 1, 2, 2, 2, 2, 2, 2, 1, 2, 2, 1]","[]","[]",13,0,13,1
4624,"['atrasar', 'avancar', 'capitar', 'justificativo', 'paralisar']","[1, 1, 1, 1, 1]","['verificacao']","[1]",5,1,6,1
4626,"['andrew', 'dosar']","[1, 1]","[]","[]",2,0,2,1
4628,"['ambito', 'constituicao', 'corpu', 'distrito', 'distrito', 'habea', 'mudanca', 'possibilidad', 'processo']","[1, 1, 1, 2, 2, 1, 1, 1, 1]","[]","[]",9,0,9,1
4629,"['aumento', 'aumento', 'aumento', 'servidor', 'servidor', 'tambem', 'tambem', 'velocidad']","[3, 3, 3, 2, 2, 2, 2, 1]","['quinzena', 'usuario', 'usuario', 'usuario']","[1, 3, 3, 3]",8,4,12,1
4631,"['extensao', 'implementar', 'quarentenar']","[1, 1, 1]","['caixao', 'imagem', 'protestar', 'protestar']","[1, 1, 2, 2]",3,4,7,1
4634,"['afetado', 'campino', 'compromisso', 'crise', 'decisao', 'dificultar', 'situacao']","[1, 1, 1, 1, 1, 1, 1]","[]","[]",7,0,7,1
4640,"['decisao', 'destinar', 'dificuldad', 'intenso', 'marinhar', 'marinhar', 'molecular', 'respirador', 'respirador', 'respiratorio']","[1, 1, 1, 1, 2, 2, 1, 2, 2, 1]","[]","[]",10,0,10,1
4641,"['assistencia', 'avancar', 'distrito', 'estrategia', 'intubacao', 'necessario', 'reforcar', 'reuniao', 'saudar', 'situacao']","[1, 1, 1, 1, 1, 1, 1, 1, 1, 1]","[]","[]",10,0,10,1
4642,"['orientacao', 'presenca', 'propagacao', 'suspensao']","[1, 1, 1, 1]","[]","[]",4,0,4,1
4643,"['afp', 'autorizacao', 'exigencia', 'periodo', 'previo', 'regulamentar', 'relaxar']","[1, 1, 1, 1, 1, 1, 1]","[]","[]",7,0,7,1
4645,"['adotada', 'comissao', 'comissao', 'comissao', 'comissao', 'estrategia', 'expectativa', 'externo', 'henriqu', 'importancia', 'ministrar', 'ministrar', 'ministrar', 'ministrar', 'ministrar', 'nelson', 'pastar', 'pastar', 'pastar', 'pratico', 'saudar', 'saudar', 'saudar', 'saudar', 'teich', 'teich']","[1, 4, 4, 4, 4, 1, 1, 1, 1, 1, 5, 5, 5, 5, 5, 1, 3, 3, 3, 1, 4, 4, 4, 4, 2, 2]","[]","[]",26,0,26,1
4646,"['conjuntar', 'examinar', 'funcionamento', 'merkel', 'merkel', 'necessario', 'processo', 'reuniao', 'reuter', 'saudar', 'saudar', 'superar', 'superar']","[1, 1, 1, 2, 2, 1, 1, 1, 1, 2, 2, 2, 2]","[]","[]",13,0,13,1
4647,"['administrativo', 'apurar', 'apurar', 'associacao', 'coordenar', 'crise', 'decorrencia', 'demrj', 'investigacao', 'jorg', 'mprj', 'plenario', 'precandidato', 'saudar', 'servidor', 'servidor', 'vespera']","[1, 2, 2, 1, 1, 1, 1, 1, 1, 1, 1, 1, 1, 1, 2, 2, 1]","[]","[]",17,0,17,1
4648,"['biliao', 'biliao', 'recordar', 'superar']","[2, 2, 1, 1]","[]","[]",4,0,4,1
4649,"['boletim', 'cenario', 'confirmado', 'contabiliz', 'crescimento', 'etapa', 'fase', 'fez', 'fez', 'medida', 'oficialment', 'periodo', 'preocupacao', 'reabertura', 'relacao', 'situacao', 'ultimo']","[1, 1, 1, 1, 1, 1, 1, 2, 2, 1, 1, 1, 1, 1, 1, 1, 1]","[]","[]",17,0,17,1
4650,"['celebrar', 'destinar', 'florido']","[1, 1, 1]","[]","[]",3,0,3,1
4651,"['academico', 'argumentar', 'atuacao', 'condicao', 'decisao', 'decisao', 'decisao', 'desenvolvimento', 'distrito', 'fundacao', 'fundacao', 'fundacao', 'fundacao', 'justicar', 'magistrado', 'permanencia', 'preservacao', 'privar', 'resistencia', 'varar']","[1, 1, 1, 1, 3, 3, 3, 1, 1, 4, 4, 4, 4, 1, 1, 1, 1, 1, 1, 1]","['abusar', 'escravo']","[1, 1]",20,2,22,1
4653,"['folhar', 'fundacao', 'integro', 'nogueira']","[1, 1, 1, 1]","[]","[]",4,0,4,1
4654,"['arthur', 'condicao', 'domingo', 'enfrentamento', 'facilitar', 'integro', 'lira', 'ppal', 'prorrogar']","[1, 1, 1, 1, 1, 1, 1, 1, 1]","[]","[]",9,0,9,1
4657,"['congresso', 'integro', 'republico']","[1, 1, 1]","[]","[]",3,0,3,1
4659,"['inglaterra', 'isolar']","[1, 1]","['compartilhar']","[1]",2,1,3,1
4661,"['administrativo', 'decorrencia', 'dificuldad', 'fornecimento', 'instalacao', 'instaurar', 'regulamentar', 'regulamentar', 'respostar', 'sabado', 'submetido', 'transmissao']","[1, 1, 1, 1, 1, 1, 2, 2, 1, 1, 1, 1]","[]","[]",12,0,12,1
4662,"['comparacao', 'flexibilizacao', 'medida', 'patamar', 'prever', 'proximo', 'proximo', 'reducao', 'reducao', 'sobretudo', 'tambem', 'tendencia']","[1, 1, 1, 1, 1, 2, 2, 2, 2, 1, 1, 1]","[]","[]",12,0,12,1
4663,"['distant', 'imunizacao', 'milho', 'mudanca', 'possibilidad', 'processo', 'semestr', 'tambem']","[1, 1, 1, 1, 1, 1, 1, 1]","[]","[]",8,0,8,1
4664,"['autoridad', 'biliao', 'economia', 'iniciativo', 'parceria', 'plano', 'preservar', 'proposto', 'recurso', 'republico', 'saudar', 'secom', 'situacao']","[1, 1, 1, 1, 1, 1, 1, 1, 1, 1, 1, 1, 1]","[]","[]",13,0,13,1
4666,"['empatar', 'levantamento', 'respectivament']","[1, 1, 1]","[]","[]",3,0,3,1
4667,"['alteracao', 'articulacao', 'minoria', 'obtido', 'respostar', 'saudar', 'saudar']","[1, 1, 1, 1, 1, 2, 2]","['pelar']","[1]",7,1,8,1
4670,"['ampliacao', 'ampliacao', 'comissao', 'comissao', 'economia', 'gued', 'logistico', 'manutencao', 'ministrar', 'ministrar', 'ministrar', 'pastar', 'pastar', 'requerimento', 'saudar', 'saudar', 'temporario']","[2, 2, 2, 2, 1, 1, 1, 1, 3, 3, 3, 2, 2, 1, 2, 2, 1]","[]","[]",17,0,17,1
4675,"['ambientar', 'ambientar', 'aprovacao', 'aprovacao', 'aprovacao', 'avancar', 'confederacao', 'crise', 'disseminacao', 'inedito', 'levantamento', 'margem', 'margem', 'minimizar', 'periodo', 'respostar']","[2, 2, 3, 3, 3, 1, 1, 1, 1, 1, 1, 2, 2, 1, 1, 1]","['atribuir']","[1]",16,1,17,1
4676,"['afp', 'crise', 'estatistico']","[1, 1, 1]","['ilustrar', 'imagem']","[1, 1]",3,2,5,1
4677,"['condicao', 'condicao', 'curvo', 'fase', 'fase', 'fase', 'flexibilizacao', 'flexibilizacao', 'independentement', 'planar', 'planar', 'planar', 'planar', 'previsao', 'quedo', 'reabertura', 'reducao', 'saudar', 'taxar', 'wilson', 'witzel', 'witzel']","[2, 2, 1, 3, 3, 3, 2, 2, 1, 4, 4, 4, 4, 1, 1, 1, 1, 1, 1, 1, 2, 2]","['bandeiro', 'bandeiro']","[2, 2]",22,2,24,1
4678,"['algun', 'letalidad', 'porqu', 'queiroz', 'recebido']","[1, 1, 1, 1, 1]","['verdadeiro']","[1]",5,1,6,1
4679,"['ampliacao', 'bruto', 'campino', 'habitant', 'internar', 'liderar', 'oficio', 'orientacao', 'orientacao', 'pib', 'reafirmar', 'reforcar', 'respostar']","[1, 1, 1, 1, 1, 1, 1, 2, 2, 1, 1, 1, 1]","[]","[]",13,0,13,1
4680,"['bastidor', 'decisao', 'decisao', 'determinacao', 'expectativa', 'magistrado', 'ministrar', 'plenario', 'presenciar', 'presenciar', 'supremo']","[1, 2, 2, 1, 1, 1, 1, 1, 2, 2, 1]","[]","[]",11,0,11,1
4683,"['atrasar', 'boletim', 'contabilizar', 'levantamento', 'pastar', 'recordar', 'saudar', 'saudar']","[1, 1, 1, 1, 1, 1, 2, 2]","[]","[]",8,0,8,1
4684,"['alcolumbr', 'arrecadacao', 'biliao', 'biliao', 'circulacao', 'congresso', 'demrj', 'distrito', 'oficio', 'prever', 'prorrogacao', 'provisorio', 'provisorio', 'relativo']","[1, 1, 2, 2, 1, 1, 1, 1, 1, 1, 1, 2, 2, 1]","[]","[]",14,0,14,1
4685,"['conselho', 'constituicao', 'decisao', 'demanda', 'equivalent', 'informaco', 'medida', 'pedido', 'plenario', 'prazo', 'prazo', 'servidor', 'supremo', 'suspensao', 'suspensao']","[1, 1, 1, 1, 1, 1, 1, 1, 1, 2, 2, 1, 1, 2, 2]","[]","[]",15,0,15,1
4686,"['concedido', 'conformar', 'conjuntar', 'deltan', 'destinar', 'destinar', 'edson', 'fachin', 'fachin', 'fachin', 'fachin', 'fachin', 'ministrar', 'ministrar', 'parceria', 'precedent', 'republico', 'supremo', 'supremo']","[1, 1, 1, 1, 2, 2, 1, 5, 5, 5, 5, 5, 2, 2, 1, 1, 1, 2, 2]","['manipular', 'parir', 'telegram']","[1, 1, 1]",19,3,22,1
4687,"['adotada', 'advocaciager', 'agravamento', 'alteracao', 'aprovacao', 'araujo', 'araujo', 'araujo', 'araujo', 'articulacao', 'articulacao', 'ausencia', 'azevedo', 'azevedo', 'azevedo', 'azevedo', 'azevedo', 'bancada', 'bastidor', 'bolsonarista', 'circulacao', 'colunista', 'congresso', 'congresso', 'congresso', 'desenvolvimento', 'destacar', 'diretoria', 'distrito', 'emendar', 'ernesto', 'ernesto', 'ernesto', 'estrategia', 'expressar', 'externo', 'externo', 'flavia', 'flavia', 'flavia', 'integrant', 'interlocutor', 'interlocutor', 'justicar', 'justicar', 'liderar', 'mendonca', 'mendonca', 'ministrar', 'ministrar', 'ministrar', 'mudanca', 'nomeacao', 'oficialment', 'palacio', 'palacio', 'parceiro', 'permanencia', 'planalto', 'planalto', 'planalto', 'planalto', 'preservar', 'privilegiar', 'republico', 'republico', 'restritivo', 'sigla', 'subordinar', 'supremo', 'supremo', 'transferir']","[1, 1, 1, 1, 1, 4, 4, 4, 4, 2, 2, 1, 5, 5, 5, 5, 5, 1, 1, 1, 1, 1, 3, 3, 3, 1, 1, 1, 1, 1, 3, 3, 3, 1, 1, 2, 2, 3, 3, 3, 1, 2, 2, 2, 2, 1, 2, 2, 3, 3, 3, 1, 1, 1, 2, 2, 1, 1, 4, 4, 4, 4, 1, 1, 2, 2, 1, 1, 1, 2, 2, 1]","[]","[]",72,0,72,1
4691,"['bbc', 'biliao', 'colaboracao', 'conjuntar', 'desenvolvimento', 'federar', 'iniciativo', 'instituto', 'instituto', 'instituto', 'oliveira', 'saudar']","[1, 1, 1, 1, 1, 1, 1, 3, 3, 3, 1, 1]","[]","[]",12,0,12,1
4692,"['acompanhamento', 'acompanhamento', 'diariament', 'equipamento', 'esforco', 'parceria', 'pastar', 'pulmonar', 'recurso', 'recurso', 'saudar', 'saudar', 'saudar', 'saudar', 'saudar', 'saudar', 'saudar', 'superar', 'ventilador']","[2, 2, 1, 1, 1, 1, 1, 1, 2, 2, 7, 7, 7, 7, 7, 7, 7, 1, 1]","[]","[]",19,0,19,1
4693,"[]","[]","[]","[]",0,0,0,1
4695,"['adiamento', 'adiamento', 'biliao', 'dificuldad', 'discussao', 'estatistico', 'geografia', 'ibg', 'instituto', 'orcamentaria', 'previo', 'previsto', 'previsto', 'proposto', 'recurso']","[2, 2, 1, 1, 1, 1, 1, 1, 1, 1, 1, 2, 2, 1, 1]","[]","[]",15,0,15,1
4696,"['anteontem', 'anteontem', 'crescimento', 'crescimento', 'ritmar', 'ritmar', 'subir']","[2, 2, 2, 2, 2, 2, 1]","[]","[]",7,0,7,1
4698,"['comissao', 'respostar']","[1, 1]","[]","[]",2,0,2,1
4700,"['apurar', 'araujo', 'araujo', 'atuacao', 'comissao', 'depoimento', 'enfrentamento', 'ernesto', 'exministro', 'externo', 'inquerito', 'institut', 'itamarati', 'saudar', 'saudar']","[1, 2, 2, 1, 1, 1, 1, 1, 1, 1, 1, 1, 1, 2, 2]","['capturar']","[1]",15,1,16,1
4702,"['perspectivo']","[1]","[]","[]",1,0,1,1
4706,"['apreensao', 'arthur', 'cardiologista', 'cardiologista', 'circulacao', 'desempenhar', 'desempenhar', 'dialogo', 'enxergar', 'federativo', 'funcao', 'impactar', 'interlocutor', 'lira', 'lira', 'minimizar', 'ministrar', 'ministrar', 'necessario', 'planalto', 'ppal', 'saudar', 'saudar', 'saudar']","[1, 1, 2, 2, 1, 2, 2, 1, 1, 1, 1, 1, 1, 2, 2, 1, 2, 2, 1, 1, 1, 3, 3, 3]","['atribuir']","[1]",24,1,25,1
4707,"['demrj', 'exigencia', 'federar', 'imunizacao', 'integro', 'legislativo', 'legislativo', 'saudar', 'supremo', 'tramitacao']","[1, 1, 1, 1, 1, 2, 2, 1, 1, 1]","[]","[]",10,0,10,1
4710,"['calendario', 'competicao', 'competicao', 'competicao', 'competicao', 'competicao', 'europeu', 'europeu', 'opcao', 'paralisar', 'suspenso', 'suspenso']","[1, 5, 5, 5, 5, 5, 2, 2, 1, 1, 2, 2]","[]","[]",12,0,12,1
4714,"['comorbidad', 'consorcio', 'coreia', 'destinar', 'dosar', 'esquema', 'estrategia', 'federativo', 'gestant', 'igualitario', 'intervalar', 'observar', 'orientacao', 'remessar', 'reuniao', 'revisar', 'saudar', 'saudar', 'vigilancia']","[1, 1, 1, 1, 1, 1, 1, 1, 1, 1, 1, 1, 1, 1, 1, 1, 2, 2, 1]","[]","[]",19,0,19,1
4717,"['colunista', 'internacao', 'internacao', 'internacao', 'rossi', 'souza', 'velocidad']","[1, 3, 3, 3, 1, 1, 1]","[]","[]",7,0,7,1
4718,"['consumidor', 'consumidor', 'enfrentamento', 'fluminens', 'iniciativo', 'iniciativo', 'necessidad', 'periodo', 'quarentenar']","[2, 2, 1, 1, 2, 2, 1, 1, 1]","['imagem']","[1]",9,1,10,1
4719,"['arrecadar', 'fundacao', 'parceiro', 'parceria', 'quarentenar', 'transmissao']","[1, 1, 1, 1, 1, 1]","[]","[]",6,0,6,1
4720,"['araujo', 'comissao', 'crise', 'ernesto', 'exemplo', 'insuficient', 'medida', 'necessidad', 'ultimo']","[1, 1, 1, 1, 1, 1, 1, 1, 1]","[]","[]",9,0,9,1
4721,"['atrasar', 'avancar', 'cepa', 'conformar', 'esforco', 'expressivo', 'fundacao', 'genoma', 'genoma', 'impactar', 'investigacao', 'oswaldo', 'periodo', 'quedo', 'recurso', 'reducao', 'regiao', 'sequenciamento', 'sequenciamento', 'sequenciamento']","[1, 1, 1, 1, 1, 1, 1, 2, 2, 1, 1, 1, 1, 1, 1, 1, 1, 3, 3, 3]","['verificar']","[1]",20,1,21,1
4724,"['assistencia', 'estrategico', 'medida', 'nelson', 'palacio', 'planalto', 'prazo', 'prazo', 'queiroga', 'queiroga', 'queiroga', 'reuniao', 'teich']","[1, 1, 1, 1, 1, 1, 2, 2, 3, 3, 3, 1, 1]","[]","[]",13,0,13,1
4725,"['conservacao', 'desmatamento', 'desmatamento', 'instituto', 'isolar', 'kassio', 'ministrar', 'regiao', 'supremo']","[1, 2, 2, 1, 1, 1, 1, 1, 1]","[]","[]",9,0,9,1
4726,"['carla', 'carla', 'carla', 'internar', 'internar', 'investigacao', 'investigacao', 'pslsp', 'zambelli', 'zambelli', 'zambelli']","[3, 3, 3, 2, 2, 2, 2, 1, 3, 3, 3]","[]","[]",11,0,11,1
4727,"['acumular', 'associacao', 'diagnosticar', 'infectar', 'levantamento', 'ministrar', 'quedo', 'recordar', 'recuar', 'reducao', 'subir', 'volumar', 'volumar']","[1, 1, 1, 1, 1, 1, 1, 1, 1, 1, 1, 2, 2]","['implantar']","[1]",13,1,14,1
4732,"['benjamin', 'domingo', 'primeiroministro', 'sabado', 'saudar']","[1, 1, 1, 1, 1]","[]","[]",5,0,5,1
4733,"['ambito', 'araujo', 'compromisso', 'compromisso', 'compromisso', 'compromisso', 'crise', 'despesa', 'despesa', 'despesa', 'economia', 'ernesto', 'gued', 'medida', 'medida', 'organizado', 'reafirm', 'sustentabilidad']","[1, 1, 4, 4, 4, 4, 1, 3, 3, 3, 1, 1, 1, 2, 2, 1, 1, 1]","[]","[]",18,0,18,1
4735,"['conjuntar', 'decisao', 'justicar', 'justicar', 'metropolitano', 'regiao', 'varar']","[1, 1, 2, 2, 1, 1, 1]","[]","[]",7,0,7,1
4737,"['adotada', 'anticorpo', 'disseminacao', 'estrategia', 'facilitar', 'infectar', 'inicialment', 'inquerito', 'martim', 'positivar', 'possibilidad', 'realizacao', 'saudar', 'saudar', 'testagem', 'testagem', 'triagem']","[1, 1, 1, 1, 1, 1, 1, 1, 1, 1, 1, 1, 2, 2, 2, 2, 1]","[]","[]",17,0,17,1
4738,"['epidemiar', 'folhar', 'integro', 'internacao', 'internacao', 'patamar', 'quedo', 'subir']","[1, 1, 1, 2, 2, 1, 1, 1]","[]","[]",8,0,8,1
4739,"['consorcio', 'domingo', 'folhar', 'iniciativo', 'integro', 'previsto', 'saudar', 'saudar']","[1, 1, 1, 1, 1, 1, 2, 2]","[]","[]",8,0,8,1
4743,"['adotada', 'agravamento', 'aspecto', 'cerimonia', 'crise', 'decisao', 'decisao', 'decisao', 'domingo', 'fase', 'julgamento', 'ministrar', 'ministrar', 'periodo', 'planar', 'plenario', 'plenario', 'presenciar', 'presenciar', 'realizacao', 'reuniao', 'supremo', 'supremo']","[1, 1, 1, 1, 1, 3, 3, 3, 1, 1, 1, 2, 2, 1, 1, 2, 2, 2, 2, 1, 1, 2, 2]","[]","[]",23,0,23,1
4744,"['calamidad', 'calamidad', 'circulacao', 'contemplar', 'emergenciai', 'funcionamento', 'manutencao', 'possibilidad', 'recurso', 'saudar', 'tramitacao']","[2, 2, 1, 1, 1, 1, 1, 1, 1, 1, 1]","['sacar', 'sacar']","[2, 2]",11,2,13,1
4746,"['acordo', 'aurelio', 'contabilizar', 'decisao', 'delacao', 'inicialment', 'justicar', 'lorenzoni', 'mello', 'ministrar', 'ministrar', 'ministrar', 'onyx', 'onyx', 'onyx', 'plenario', 'plenario', 'pratico', 'privilegiar', 'republico', 'secretariager', 'supremo', 'supremo', 'turma']","[1, 1, 1, 1, 1, 1, 1, 1, 1, 3, 3, 3, 3, 3, 3, 2, 2, 1, 1, 1, 1, 2, 2, 1]","[]","[]",24,0,24,1
4747,"['ansiedad', 'henriqu', 'perspectivo', 'quarentenar', 'quarentenar', 'quarentenar', 'vieira']","[1, 1, 1, 3, 3, 3, 1]","[]","[]",7,0,7,1
4748,"['aplicacao', 'fase', 'folhar', 'folhar', 'integro', 'suspeito']","[1, 1, 2, 2, 1, 1]","[]","[]",6,0,6,1
4750,"['adotada', 'aplicacao', 'bolsonarista', 'dosar', 'estrategia', 'intervalar', 'intervalar', 'orientacao']","[1, 1, 1, 1, 1, 2, 2, 1]","[]","[]",8,0,8,1
4756,"['advocaciager', 'advocaciager', 'araujo', 'assintomatico', 'carla', 'colunista', 'conformar', 'deteccao', 'deteccao', 'justicar', 'justicar', 'negativar', 'negativar', 'republico', 'republico', 'republico', 'saudar']","[2, 2, 1, 1, 1, 1, 1, 2, 2, 2, 2, 2, 2, 3, 3, 3, 1]","[]","[]",17,0,17,1
4757,"['dedicar', 'instituto', 'instituto', 'internar', 'presidir', 'ricardo', 'ricardo', 'ricardo']","[1, 2, 2, 1, 1, 3, 3, 3]","[]","[]",8,0,8,1
4760,"['dedicar', 'desenvolvimento', 'epidemiar', 'fabricacao', 'fundacao', 'infeccioso', 'inovacao', 'saudar', 'sigla', 'taxar']","[1, 1, 1, 1, 1, 1, 1, 1, 1, 1]","['circular']","[1]",10,1,11,1
4762,"['exministro', 'pslsp']","[1, 1]","['compartilhar']","[1]",2,1,3,1
4763,"['descumprimento', 'destacar', 'fundamentar', 'regrar']","[1, 1, 1, 1]","[]","[]",4,0,4,1
4766,"['quilometro']","[1]","['ganhar']","[1]",1,1,2,1
4769,"['apurar', 'barroso', 'barroso', 'converso', 'iniciativo', 'jurista', 'ministrar', 'privar', 'realizacao']","[1, 2, 2, 1, 1, 1, 1, 1, 1]","['mesario']","[1]",9,1,10,1
4772,"['adotada', 'anvisa', 'anvisa', 'anvisa', 'atuam', 'companhia', 'contabilizar', 'contemplar', 'implementacao', 'infraestrutura', 'orientacao', 'planar', 'previsto', 'reforcar', 'respostar', 'reuniao', 'reuniao', 'reuniao', 'saudar', 'saudar', 'surtir', 'suspeito', 'transmissao', 'vigilancia']","[1, 3, 3, 3, 1, 1, 1, 1, 1, 1, 1, 1, 1, 1, 1, 3, 3, 3, 2, 2, 1, 1, 1, 1]","[]","[]",24,0,24,1
4774,"['pastar', 'planar', 'saudar', 'saudar', 'saudar']","[1, 1, 3, 3, 3]","['enderecar', 'vazar']","[1, 1]",5,2,7,1
4776,"[]","[]","[]","[]",0,0,0,1
4777,"['companhia', 'demandar', 'desafio', 'periodo', 'quedo']","[1, 1, 1, 1, 1]","['parir']","[1]",5,1,6,1
4778,"[]","[]","['invadir', 'privacidad']","[1, 1]",0,2,2,1
4779,"['capitar', 'companhia', 'companhia', 'epidemiar', 'esforco', 'estimativo', 'impacto', 'impacto', 'incerteza', 'monetario', 'necessario', 'oficio', 'orientacao', 'projeco', 'reportar', 'reuter', 'risco', 'risco']","[1, 2, 2, 1, 1, 1, 2, 2, 1, 1, 1, 1, 1, 1, 1, 1, 2, 2]","['auditoria', 'circular']","[1, 1]",18,2,20,1
4782,"['calendario', 'conformar', 'decisao', 'decisao', 'fundacao', 'henriqu', 'hospitalizar', 'hospitalizar', 'inclusao', 'integro', 'justicar', 'mudanca', 'oswaldo', 'posicionamento', 'prioritario', 'submetido', 'suspenso']","[1, 1, 2, 2, 1, 1, 2, 2, 1, 1, 1, 1, 1, 1, 1, 1, 1]","[]","[]",17,0,17,1
4783,"['apurar', 'cenario', 'consumidor', 'consumidor', 'consumidor', 'consumidor', 'economia', 'extraordinario', 'funcao', 'fundacao', 'incerteza', 'instituto', 'patamar', 'periodo', 'previo', 'previo', 'previo', 'quedo', 'recuperacao', 'recuperacao', 'ritmar', 'subir', 'tendencia', 'varga']","[1, 1, 4, 4, 4, 4, 1, 1, 1, 1, 1, 1, 1, 1, 3, 3, 3, 1, 2, 2, 1, 1, 1, 1]","[]","[]",24,0,24,1
4784,"['anticorpo', 'autoridad', 'inglaterra', 'inglaterra', 'ministrar', 'primario', 'reabrir', 'reportar', 'saudar', 'saudar', 'totalizar']","[1, 1, 2, 2, 1, 1, 1, 1, 2, 2, 1]","[]","[]",11,0,11,1
4785,"['decisao', 'distrito', 'instaurar', 'magistrado', 'medeiro', 'varar']","[1, 1, 1, 1, 1, 1]","['arquivar']","[1]",6,1,7,1
4787,"['adversario', 'alcolumbr']","[1, 1]","[]","[]",2,0,2,1
4788,"['alerj', 'flavio', 'legislativo', 'rachadinha', 'republicanosrj']","[1, 1, 1, 1, 1]","[]","[]",5,0,5,1
4790,"['ambientar', 'ambientar', 'concorrent', 'especializar', 'europeu', 'observar', 'preservacao']","[2, 2, 1, 1, 1, 1, 1]","['enganir', 'escutar', 'invadir']","[1, 1, 1]",7,3,10,1
4793,"['biliao', 'biliao', 'biliao', 'biliao', 'biliao', 'comissao', 'congresso', 'destinar', 'destinar', 'domingo', 'emendar', 'emendar', 'henriqu', 'inicialment', 'legislativo', 'ministrar', 'ministrar', 'montant', 'necessidad', 'pastar', 'recurso', 'saudar', 'saudar', 'situacao']","[5, 5, 5, 5, 5, 1, 1, 2, 2, 1, 2, 2, 1, 1, 1, 2, 2, 1, 1, 1, 1, 2, 2, 1]","[]","[]",24,0,24,1
4794,"['desenvolvido', 'extensao', 'funcao', 'queixar']","[1, 1, 1, 1]","[]","[]",4,0,4,1
4796,"['agravamento', 'atendido', 'distrito', 'distrito', 'internar', 'internar', 'positivar', 'positivar', 'positivar', 'saudar', 'transferir', 'viagem']","[1, 1, 2, 2, 2, 2, 3, 3, 3, 1, 1, 1]","[]","[]",12,0,12,1
4797,"['circulacao', 'companhia', 'conjuntar', 'planalto', 'transmissao']","[1, 1, 1, 1, 1]","['soldar', 'vc']","[1, 1]",5,2,7,1
4798,"['aglomeracao', 'ansiedad', 'ansiedad', 'client', 'crise', 'henriqu', 'instituto', 'mello', 'preparacao']","[1, 2, 2, 1, 1, 1, 1, 1, 1]","[]","[]",9,0,9,1
4799,"['alvorar', 'exministro', 'inquerito', 'investigacao', 'palacio', 'reuniao', 'reuniao', 'reuniao', 'supremo']","[1, 1, 1, 1, 1, 3, 3, 3, 1]","['versao']","[1]",9,1,10,1
4802,"['agravamento', 'agravar', 'cenario', 'crise', 'fundacao', 'orientacao', 'oswaldo']","[1, 1, 1, 1, 1, 1, 1]","[]","[]",7,0,7,1
4804,"['complicacao', 'destacar', 'extraordinari', 'help', 'help', 'positivar']","[1, 1, 1, 2, 2, 1]","[]","[]",6,0,6,1
4806,"['sociai']","[1]","[]","[]",1,0,1,1
4808,"['augusto', 'colunista', 'colunista', 'depoimento', 'exministro', 'inquerito', 'ministrar', 'ministrar', 'ministrar', 'republico', 'saudar', 'saudar', 'saudar', 'supremo']","[1, 2, 2, 1, 1, 1, 3, 3, 3, 1, 3, 3, 3, 1]","[]","[]",14,0,14,1
4809,"['ambientar', 'ministrar', 'ministrar', 'recurso', 'regrar', 'rejeicao', 'rejeitar', 'sigla', 'supremo', 'supremo']","[1, 2, 2, 1, 1, 1, 1, 1, 2, 2]","[]","[]",10,0,10,1
4810,"['decorrencia', 'desempenhar', 'diagnosticar', 'funcao', 'realizacao', 'respirador', 'saudar']","[1, 1, 1, 1, 1, 1, 1]","['circular']","[1]",7,1,8,1
4814,"['ambientar', 'ambito', 'apurar', 'araujo', 'argumentar', 'argumentar', 'atuacao', 'condenacao', 'condenacao', 'condenacao', 'conservacao', 'decisao', 'decisao', 'decisao', 'destinar', 'distrito', 'edson', 'especifico', 'esquema', 'esquema', 'fachin', 'fachin', 'funcionamento', 'fux', 'guaruja', 'instituto', 'justicar', 'manutencao', 'ministrar', 'ministrar', 'ministrar', 'plenario', 'proferir', 'proferir', 'proferir', 'reconhecimento', 'recurso', 'recurso', 'recurso', 'recurso', 'regrar', 'rejeitar', 'republico', 'republico', 'supremo', 'supremo', 'supremo', 'supremo', 'triplex', 'triplex', 'varar', 'varar', 'varar']","[1, 1, 1, 1, 2, 2, 1, 3, 3, 3, 1, 3, 3, 3, 1, 1, 1, 1, 2, 2, 2, 2, 1, 1, 1, 1, 1, 1, 3, 3, 3, 1, 3, 3, 3, 1, 4, 4, 4, 4, 1, 1, 2, 2, 4, 4, 4, 4, 2, 2, 3, 3, 3]","[]","[]",53,0,53,1
4820,"['avancar', 'avancar', 'infectar', 'investigacao', 'investigacao', 'portavoz', 'portavoz', 'saudar', 'saudar']","[2, 2, 1, 2, 2, 2, 2, 2, 2]","[]","[]",9,0,9,1
4821,"['associacao', 'coletivo', 'decisao', 'desafio', 'enfrentamento', 'flavio', 'individuar', 'justicar', 'magistrado', 'magistrado', 'monitoramento', 'necessario', 'renata', 'renata', 'situacao']","[1, 1, 1, 1, 1, 1, 1, 1, 2, 2, 1, 1, 2, 2, 1]","[]","[]",15,0,15,1
4825,"['adversario', 'arrecadar', 'justicar', 'martim', 'pratico', 'respectivament']","[1, 1, 1, 1, 1, 1]","['mencao', 'menino']","[1, 1]",6,2,8,1
4826,"['internar', 'internar', 'notificar', 'notificar', 'notificar', 'saudar', 'saudar', 'suspeito', 'suspeito']","[2, 2, 3, 3, 3, 2, 2, 2, 2]","[]","[]",9,0,9,1
4827,"['apurar', 'biliao', 'desenvolvido', 'destinar', 'estimativo', 'fundacao', 'imunizacao', 'medeiro', 'medeiro', 'oswaldo', 'prever', 'provisorio', 'saudar', 'saudar', 'transferencia', 'vigilancia']","[1, 1, 1, 1, 1, 1, 1, 2, 2, 1, 1, 1, 2, 2, 1, 1]","[]","[]",16,0,16,1
4829,"['epicentro', 'florido', 'florido', 'intensivo', 'internar', 'notificar', 'positivar', 'reabertura', 'reclamacao', 'saudar', 'sudest', 'taxar']","[1, 2, 2, 1, 1, 1, 1, 1, 1, 1, 1, 1]","[]","[]",12,0,12,1
4830,"['arrecadar', 'distrito', 'folhar', 'jorg', 'necessidad']","[1, 1, 1, 1, 1]","['ganhar', 'menino', 'menino']","[1, 2, 2]",5,3,8,1
4832,"['alvaro', 'antonio', 'antonio', 'exministro', 'machadar', 'nomeacao']","[1, 2, 2, 1, 1, 1]","[]","[]",6,0,6,1
4833,"['comparacao', 'consolidar', 'consorcio', 'domingo', 'estabilidad', 'levantamento', 'quedo', 'saudar', 'significativo', 'situacao', 'tendencia', 'tendencia', 'variacao', 'variacao']","[1, 1, 1, 1, 1, 1, 1, 1, 1, 1, 2, 2, 2, 2]","[]","[]",14,0,14,1
4836,"['atuam', 'cenario', 'cirurgico', 'enfrentamento', 'equipamento', 'escassez', 'reforcar', 'saudar', 'saudar', 'saudar', 'saudar', 'saudar', 'saudar', 'saudar']","[1, 1, 1, 1, 1, 1, 1, 7, 7, 7, 7, 7, 7, 7]","[]","[]",14,0,14,1
4839,"['congresso', 'demmg', 'desenvolvimento', 'destacar', 'economia', 'epidemiar', 'imunizacao', 'inovacao', 'legislativo', 'pacheco', 'plenario', 'preparacao', 'presidir', 'provisorio', 'provisorio', 'saudar', 'saudar', 'semestr', 'sessao', 'sessao']","[1, 1, 1, 1, 1, 1, 1, 1, 1, 1, 1, 1, 1, 2, 2, 2, 2, 1, 2, 2]","[]","[]",20,0,20,1
4843,"['confirmado', 'demandar', 'porqu', 'sobretudo', 'sociai']","[1, 1, 1, 1, 1]","['sequer']","[1]",5,1,6,1
4844,"['coletivo', 'coletivo', 'decisao', 'decisao', 'domingo', 'profissionai', 'sindicato', 'sindicato', 'treinamento', 'treino', 'treino']","[2, 2, 2, 2, 1, 1, 2, 2, 1, 2, 2]","[]","[]",11,0,11,1
4845,"['consumidor', 'espanha', 'habito', 'oferecido', 'rotina', 'situacao']","[1, 1, 1, 1, 1, 1]","[]","[]",6,0,6,1
4846,"['desafiar', 'europeu', 'infancia', 'inglaterra', 'inglaterra', 'regrar']","[1, 1, 1, 2, 2, 1]","['estampar']","[1]",6,1,7,1
4847,"['destacar']","[1]","[]","[]",1,0,1,1
4848,"['desafio', 'desafio', 'motivacao', 'motivacao', 'possibilidad', 'prtb', 'superar', 'superar']","[2, 2, 2, 2, 1, 1, 2, 2]","[]","[]",8,0,8,1
4851,"['decisao', 'investigacao', 'regrar', 'saudar']","[1, 1, 1, 1]","['acidentar']","[1]",4,1,5,1
4853,"['alunar', 'autorizacao', 'contrato', 'desenvolvimento', 'desenvolvimento', 'heleno', 'heleno', 'investigacao', 'justicar', 'pagamento', 'pagamento', 'republico', 'wilson', 'wilson', 'witzel', 'witzel', 'witzel', 'witzel', 'witzel']","[1, 1, 1, 2, 2, 2, 2, 1, 1, 2, 2, 1, 2, 2, 5, 5, 5, 5, 5]","['imagem']","[1]",19,1,20,1
4855,"['araujo', 'calheiro', 'calheiro', 'comportamento', 'depoimento', 'equilibrio', 'ernesto', 'exministro', 'exministro', 'mdbal', 'saudar', 'temor', 'temor']","[1, 2, 2, 1, 1, 1, 1, 2, 2, 1, 1, 2, 2]","[]","[]",13,0,13,1
4856,"['anticorpo', 'dedicar', 'economia', 'folhar', 'implementar', 'painel', 'saudar', 'spaulo']","[1, 1, 1, 1, 1, 1, 1, 1]","[]","[]",8,0,8,1
4857,"['balancar', 'balancar', 'balancar', 'balancar', 'balancar', 'condicao', 'contabilizar', 'federar', 'henriqu', 'letalidad', 'ministrar', 'ministrar', 'pastar', 'saudar', 'suspeito', 'suspeito']","[5, 5, 5, 5, 5, 1, 1, 1, 1, 1, 2, 2, 1, 1, 2, 2]","[]","[]",16,0,16,1
4859,"['colegiado', 'constituicao', 'demrj', 'reabertura', 'reabrir', 'suspenso']","[1, 1, 1, 1, 1, 1]","[]","[]",6,0,6,1
4860,"['alteracao', 'anuncio', 'broadcast', 'despesa', 'destinar', 'exercicio', 'legislativo', 'legislativo', 'periodo', 'periodo', 'recurso', 'ribeiro', 'transferencia']","[1, 1, 1, 1, 1, 1, 2, 2, 2, 2, 1, 1, 1]","['renunciar']","[1]",13,1,14,1
4861,"['companhia', 'disseminacao', 'quarentenar', 'quarentenar']","[1, 1, 2, 2]","['pego', 'pego', 'pego']","[3, 3, 3]",4,3,7,1
4862,"['autoridad', 'confederacao', 'esperancar', 'superar', 'superar', 'superar']","[1, 1, 1, 3, 3, 3]","[]","[]",6,0,6,1
4864,"['assintomatico', 'autoridad', 'epidemiar', 'regiao', 'regiao', 'relaxamento', 'saudar']","[1, 1, 1, 2, 2, 1, 1]","[]","[]",7,0,7,1
4869,"['colaborar', 'demandar', 'discussao', 'gripezinha', 'gripezinha', 'gripezinha', 'impactar', 'infectar', 'posturar', 'republico', 'saudar', 'saudar', 'wilson', 'witzel', 'witzel']","[1, 1, 1, 3, 3, 3, 1, 1, 1, 1, 2, 2, 1, 2, 2]","[]","[]",15,0,15,1
4871,"['calendario', 'calendario', 'conformar', 'destinar', 'individuar', 'pagamento', 'pagamento', 'pagamento', 'parcelar']","[2, 2, 1, 1, 1, 3, 3, 3, 1]","['inscricao', 'sacar']","[1, 1]",9,2,11,1
4874,"['decisao', 'decisao', 'fase', 'geraldo', 'infraestrutura', 'integro', 'interrupcao', 'justicar', 'justicar', 'planar', 'presenciar', 'prioridad', 'sentenca', 'sindicato', 'sindicato']","[2, 2, 1, 1, 1, 1, 1, 2, 2, 1, 1, 1, 1, 2, 2]","['greve']","[1]",15,1,16,1
4875,"['argumentar', 'avancar', 'avancar', 'letalidad', 'mutacao', 'recurso', 'recurso', 'ritmar', 'saudar']","[1, 2, 2, 1, 1, 2, 2, 1, 1]","[]","[]",9,0,9,1
4876,"['aprovacao', 'argumentar', 'comissao', 'jorg', 'ministrar', 'ministrar', 'oficialment', 'oliveira', 'oliveira', 'republico', 'reuniao', 'sabatino', 'sabatino', 'sabatino', 'secretariager', 'supremo', 'tcu', 'tcu', 'vieira']","[1, 1, 1, 1, 2, 2, 1, 2, 2, 1, 1, 3, 3, 3, 1, 1, 2, 2, 1]","[]","[]",19,0,19,1
4877,"['coletivo', 'comportamento', 'comportamento', 'comportamento', 'congresso', 'cupula', 'henriqu', 'ministrar', 'ministrar', 'orientacao', 'reuniao', 'saudar', 'saudar', 'supremo']","[1, 3, 3, 3, 1, 1, 1, 2, 2, 1, 1, 2, 2, 1]","[]","[]",14,0,14,1
4878,"['apurar', 'autoridad', 'bolsonarista', 'congresso', 'inquerito', 'inquerito', 'inquerito', 'inquerito', 'integro', 'ministrar', 'ministrar', 'ministrar', 'ministrar', 'organizador', 'oswaldo', 'supremo']","[1, 1, 1, 1, 4, 4, 4, 4, 1, 4, 4, 4, 4, 1, 1, 1]","['ganhar']","[1]",16,1,17,1
4879,"['aplicacao', 'atuam', 'destinar', 'destinar', 'distrito', 'dosar', 'federativo', 'fundacao', 'igualitario', 'instituto', 'materiaprima', 'oswaldo', 'parcelar', 'recebido', 'remessar', 'saudar', 'saudar', 'saudar', 'vigilancia']","[1, 1, 2, 2, 1, 1, 1, 1, 1, 1, 1, 1, 1, 1, 1, 3, 3, 3, 1]","[]","[]",19,0,19,1
4880,"['contagioso', 'decisao', 'estatistico', 'liderar', 'ministrar', 'ministrar', 'pastar', 'preocupacao', 'primeiroministro', 'saudar']","[1, 1, 1, 1, 2, 2, 1, 1, 1, 1]","[]","[]",10,0,10,1
4884,"['belgica', 'companhia', 'escalar', 'expectativa', 'santiago', 'santiago', 'saudar']","[1, 1, 1, 1, 2, 2, 1]","[]","[]",7,0,7,1
4885,"['alteracao', 'alteracao', 'argumentar', 'congresso', 'constituicao', 'decisao', 'justificativo', 'recurso', 'recurso', 'regrar', 'regrar', 'regrar', 'supremo']","[2, 2, 1, 1, 1, 1, 1, 2, 2, 3, 3, 3, 1]","[]","[]",13,0,13,1
4886,"['almeida', 'alteracao', 'arrecadacao', 'arrecadacao', 'biliao', 'calamidad', 'conformar', 'crise', 'despesa', 'despesa', 'despesa', 'economia', 'incerteza', 'primario', 'tesourar', 'tesourar']","[1, 1, 2, 2, 1, 1, 1, 1, 3, 3, 3, 1, 1, 1, 2, 2]","[]","[]",16,0,16,1
4887,"['observar', 'oferecido', 'particularment', 'respiratorio', 'respostar']","[1, 1, 1, 1, 1]","[]","[]",5,0,5,1
4889,"['andrea', 'crise', 'diagnosticar', 'internar', 'periodo', 'recuperacao']","[1, 1, 1, 1, 1, 1]","['manobrar']","[1]",6,1,7,1
4892,"['calamidad', 'calamidad', 'consumidor', 'consumidor', 'consumidor', 'consumidor', 'consumidor', 'prazo', 'prazo', 'provisorio', 'taxar']","[2, 2, 5, 5, 5, 5, 5, 2, 2, 1, 1]","[]","[]",11,0,11,1
4893,"['anvisa', 'autorizacao', 'autorizacao', 'definitivo', 'definitivo', 'desenvolvido', 'etapa', 'fabricacao', 'fundacao', 'instituto', 'oswaldo', 'vigilancia']","[1, 2, 2, 2, 2, 1, 1, 1, 1, 1, 1, 1]","[]","[]",12,0,12,1
4896,"['aplicacao', 'autoridad', 'conduta', 'constituicao', 'constituicao', 'distrito', 'iniciativo', 'investigacao', 'republico', 'republico', 'republico', 'supremo', 'supremo', 'supremo', 'supremo']","[1, 1, 1, 2, 2, 1, 1, 1, 3, 3, 3, 4, 4, 4, 4]","['cartaz', 'verdadeiro']","[1, 1]",15,2,17,1
4899,"['balancar', 'comparacao', 'consolidar', 'consorcio', 'estabilidad', 'levantamento', 'saudar', 'situacao', 'subir', 'tendencia', 'totalizar', 'variacao']","[1, 1, 1, 1, 1, 1, 1, 1, 1, 1, 1, 1]","[]","[]",12,0,12,1
4900,"['periodo', 'pratico', 'processo']","[1, 1, 1]","[]","[]",3,0,3,1
4903,"['possibilidad', 'recuperacao', 'resultado', 'tambem']","[1, 1, 1, 1]","[]","[]",4,0,4,1
4904,"['constituicao', 'desigualdad', 'equivalent', 'estimular', 'guaruja', 'justicar', 'justicar', 'ministrar', 'reducao', 'triplex']","[1, 1, 1, 1, 1, 2, 2, 1, 1, 1]","['inocentar', 'parir', 'parir', 'parir', 'parir', 'parir']","[1, 5, 5, 5, 5, 5]",10,6,16,1
4906,"['aglomeracao', 'republico']","[1, 1]","[]","[]",2,0,2,1
4907,"['circulacao', 'distant', 'folhar', 'inedito', 'integro', 'isolar', 'metropolitano', 'mutacao', 'presenca', 'regiao', 'regiao']","[1, 1, 1, 1, 1, 1, 1, 1, 1, 2, 2]","[]","[]",11,0,11,1
4909,"['adversario', 'apurar', 'desvio', 'desvio', 'desvio', 'desvio', 'exministro', 'expectativa', 'fluminens', 'governista', 'inquerito', 'integrant', 'interferencia', 'investigacao', 'justicar', 'palacio', 'planalto', 'saudar', 'saudar', 'suspeito', 'wilson', 'witzel', 'witzel']","[1, 1, 4, 4, 4, 4, 1, 1, 1, 1, 1, 1, 1, 1, 1, 1, 1, 2, 2, 1, 1, 2, 2]","[]","[]",23,0,23,1
4910,"['biliao', 'curvo', 'estrategico', 'interino', 'martim', 'ministrar', 'pastar', 'planar', 'proliferacao', 'saudar', 'saudar', 'saudar', 'testagem']","[1, 1, 1, 1, 1, 1, 1, 1, 1, 3, 3, 3, 1]","[]","[]",13,0,13,1
4912,"['arthur', 'arthur', 'comissao', 'funcionamento', 'lira', 'lira', 'mantido', 'plenario', 'ppal', 'presenca', 'presenciar', 'servidor', 'sessao']","[2, 2, 1, 1, 2, 2, 1, 1, 1, 1, 1, 1, 1]","[]","[]",13,0,13,1
4913,"['apreensao', 'augusto', 'celso', 'consenso', 'consequencia', 'estabilidad', 'exministro', 'gabinet', 'heleno', 'heleno', 'heleno', 'mello', 'ministrar', 'ministrar', 'palacio', 'palacio', 'planalto', 'planalto', 'preocupacao', 'reuniao', 'reuniao', 'supremo', 'supremo']","[1, 1, 1, 1, 1, 1, 1, 1, 3, 3, 3, 1, 2, 2, 2, 2, 2, 2, 1, 2, 2, 2, 2]","[]","[]",23,0,23,1
4914,"['ausencia', 'justificativo', 'justificativo', 'prazo', 'requerimento']","[1, 2, 2, 1, 1]","['preencher']","[1]",5,1,6,1
4915,"['comissao', 'comissao', 'destacar', 'emendar', 'imunizacao', 'iniciativo', 'plenario', 'prioridad', 'privar', 'proposto', 'proposto', 'proposto', 'provisorio', 'realizacao', 'rejeitar', 'relativo', 'sancao', 'toquio']","[2, 2, 1, 1, 1, 1, 1, 1, 1, 3, 3, 3, 1, 1, 1, 1, 1, 1]","[]","[]",18,0,18,1
4916,"['alternativo', 'avancar', 'cenario', 'consequencia', 'inovacao', 'precedent', 'reuniao', 'saudar', 'situacao', 'situacao']","[1, 1, 1, 1, 1, 1, 1, 1, 2, 2]","['parir']","[1]",10,1,11,1
4917,"['afastamento', 'desenvolvimento', 'economia', 'economia', 'exonerar', 'gued', 'ministrar', 'republico']","[1, 1, 2, 2, 1, 1, 1, 1]","[]","[]",8,0,8,1
4919,"['adotada', 'elaborar', 'expressar', 'expressar', 'inglaterra', 'organizador', 'previsto', 'reuniao', 'saudar', 'sessao', 'treinamento', 'treino', 'videoconferencia']","[1, 1, 2, 2, 1, 1, 1, 1, 1, 1, 1, 1, 1]","[]","[]",13,0,13,1
4920,"['anteontem', 'anuncio', 'anvisa', 'desenvolvido', 'gabbardo', 'imunizacao', 'instituto', 'ministrar', 'parceria', 'pastar', 'planar', 'planar', 'prever', 'saudar', 'saudar', 'secretarioexecutivo', 'vigilancia']","[1, 1, 1, 1, 1, 1, 1, 1, 1, 1, 2, 2, 1, 2, 2, 1, 1]","[]","[]",17,0,17,1
4921,"['liderar', 'montant', 'periodo', 'periodo', 'trimestr']","[1, 1, 2, 2, 1]","['usuario', 'usuario']","[2, 2]",5,2,7,1
4922,"['decisao', 'demmg', 'jorg', 'kassio', 'ministrar', 'ministrar', 'ministrar', 'pacheco', 'pacheco', 'plenario', 'requerimento', 'supremo']","[1, 1, 1, 1, 3, 3, 3, 2, 2, 1, 1, 1]","['ganhar', 'sortear']","[1, 1]",12,2,14,1
4923,"['apurar', 'autorizacao', 'discussao', 'folhar', 'inquerito', 'integro', 'ministrar', 'necessidad', 'pslsp', 'realizacao', 'republicanosrj', 'republico', 'supremo']","[1, 1, 1, 1, 1, 1, 1, 1, 1, 1, 1, 1, 1]","[]","[]",13,0,13,1
4924,"['confederacao', 'globonew', 'tornear']","[1, 1, 1]","[]","[]",3,0,3,1
4925,"['claudio', 'elaborar', 'empatar', 'instaurar', 'justicar', 'mello', 'posicionamento', 'previo', 'sessao', 'wilson', 'witzel', 'witzel', 'witzel']","[1, 1, 1, 1, 1, 1, 1, 1, 1, 1, 3, 3, 3]","['arquivar']","[1]",13,1,14,1
4926,"['coordenar', 'martim']","[1, 1]","[]","[]",2,0,2,1
4928,"['concorrent', 'etapa', 'excecao', 'exministro', 'tatto']","[1, 1, 1, 1, 1]","[]","[]",5,0,5,1
4930,"['augusto', 'bancada', 'bancada', 'demrj', 'integro', 'manutencao', 'reajustar', 'servidor', 'vetar', 'vetar', 'vetar']","[1, 2, 2, 1, 1, 1, 1, 1, 3, 3, 3]","[]","[]",11,0,11,1
4931,"['calamidad', 'calamidad', 'calamidad', 'crise', 'crise', 'emprestimo', 'federativo', 'pagamento', 'prorrogar', 'reconhecimento', 'recurso', 'situacao']","[3, 3, 3, 2, 2, 1, 1, 1, 1, 1, 1, 1]","[]","[]",12,0,12,1
4932,"['reforcar', 'saudar', 'saudar']","[1, 2, 2]","[]","[]",3,0,3,1
4933,"['condicao', 'instituto', 'mantido', 'saudar']","[1, 1, 1, 1]","[]","[]",4,0,4,1
4935,"['bandeirant', 'palacio', 'precandidato', 'previo', 'previo', 'previo', 'realizacao', 'realizacao', 'regulamentar', 'tucano']","[1, 1, 1, 3, 3, 3, 2, 2, 1, 1]","[]","[]",10,0,10,1
4939,"['habito', 'isolar', 'parcelar', 'privilegiar']","[1, 1, 1, 1]","['estranhar', 'estranhar', 'indignacao', 'protestar']","[2, 2, 1, 1]",4,4,8,1
4940,"['comparacao', 'domingo', 'instituto', 'positivar', 'quedo', 'quedo', 'reuter', 'sabado', 'taxar', 'tendencia']","[1, 1, 1, 1, 2, 2, 1, 1, 1, 1]","[]","[]",10,0,10,1
4942,"['dificuldad', 'equipamento', 'equipamento', 'henriqu', 'ministrar', 'ministrar', 'ministrar', 'possibilidad', 'proposto', 'respirador', 'respirador', 'respirador', 'saudar']","[1, 2, 2, 1, 3, 3, 3, 1, 1, 3, 3, 3, 1]","[]","[]",13,0,13,1
4943,"['alcolumbr', 'arthur', 'converso', 'demap', 'demmg', 'lira', 'pacheco', 'pacheco', 'planalto', 'ppal', 'proposto', 'reforcar', 'republico']","[1, 1, 1, 1, 1, 1, 2, 2, 1, 1, 1, 1, 1]","[]","[]",13,0,13,1
4946,"['administrativo', 'afetado', 'congresso', 'estabilidad', 'legislativo', 'proposto', 'proposto', 'regrar', 'regrar', 'servidor', 'servidor']","[1, 1, 1, 1, 1, 2, 2, 2, 2, 2, 2]","[]","[]",11,0,11,1
4947,"['autoridad', 'crise', 'fase', 'orientacao', 'saudar', 'sindicato', 'surto']","[1, 1, 1, 1, 1, 1, 1]","['abusar', 'filmar']","[1, 1]",7,2,9,1
4949,"['condicao', 'resultado', 'resultado', 'sigla', 'sigla', 'tambem', 'tambem']","[1, 2, 2, 2, 2, 2, 2]","[]","[]",7,0,7,1
4950,"['arthur', 'concorrent', 'congresso', 'destacar', 'favorito', 'lira', 'ppal', 'ricardo']","[1, 1, 1, 1, 1, 1, 1, 1]","[]","[]",8,0,8,1
4954,"['crise', 'diagnosticar', 'diagnosticar', 'gabinet', 'gabinet', 'hospitalizar', 'internar', 'internar', 'pslsp']","[1, 2, 2, 2, 2, 1, 2, 2, 1]","[]","[]",9,0,9,1
4955,"['consecutivo', 'consecutivo', 'epidemiar', 'espanha', 'intensivo', 'oficialment', 'subir', 'subir', 'surtir']","[2, 2, 1, 1, 1, 1, 2, 2, 1]","[]","[]",9,0,9,1
4961,"['desenvolvido', 'dosar', 'imunizacao', 'infectar', 'instituto', 'intensivo', 'internar', 'parceria', 'taxar']","[1, 1, 1, 1, 1, 1, 1, 1, 1]","[]","[]",9,0,9,1
4966,"['acordo', 'decisao', 'desvio', 'desvio', 'inicialment', 'irregularidad', 'lavagem', 'lavagem', 'milho', 'recurso', 'recurso', 'recurso', 'reuniao', 'sabado', 'sigla', 'sigla', 'sigla']","[1, 1, 2, 2, 1, 1, 2, 2, 1, 3, 3, 3, 1, 1, 3, 3, 3]","[]","[]",17,0,17,1
4970,"['antonio', 'exonerar', 'exonerar', 'exportacao', 'fabricio', 'folhar', 'integro', 'realizacao', 'servidor', 'vieira', 'volumar']","[1, 2, 2, 1, 1, 1, 1, 1, 1, 1, 1]","[]","[]",11,0,11,1
4971,"['anvisa', 'anvisa', 'autorizacao', 'autorizacao', 'autorizacao', 'desenvolvido', 'importacao', 'saudar', 'sputnik', 'sputnik', 'supremo', 'vigilancia']","[2, 2, 3, 3, 3, 1, 1, 1, 2, 2, 1, 1]","['nordestino']","[1]",12,1,13,1
4972,"['proprio']","[1]","[]","[]",1,0,1,1
4978,"['autoridad', 'balancar', 'comissao', 'coreia', 'diagnosticar', 'diagnosticar', 'fronteiro', 'fronteiro', 'provincia', 'saudar']","[1, 1, 1, 1, 2, 2, 2, 2, 1, 1]","[]","[]",10,0,10,1
4979,"['companhia', 'epidemiologico', 'habitant', 'iniciativo', 'mexico', 'saudar', 'situacao', 'voo']","[1, 1, 1, 1, 1, 1, 1, 1]","[]","[]",8,0,8,1
4982,"['diagnosticar', 'independentement', 'infectar', 'planar', 'proposto', 'saudar', 'substituicao', 'taxar']","[1, 1, 1, 1, 1, 1, 1, 1]","[]","[]",8,0,8,1
4986,"['celebrar', 'colaboracao', 'colaboracao', 'delacao', 'enxergar', 'fux', 'fux', 'importancia', 'instituto', 'investigacao', 'obtido', 'possibilidad', 'realizacao', 'recuar', 'saudad', 'supremo']","[1, 2, 2, 1, 1, 2, 2, 1, 1, 1, 1, 1, 1, 1, 1, 1]","[]","[]",16,0,16,1
4987,"['alternativo', 'deflagrar', 'estrategia', 'flavio', 'governista', 'iniciativo', 'inquerito', 'instalacao', 'internar', 'investigacao', 'investigacao', 'legislativo', 'necessario', 'planalto', 'planar', 'randolf', 'randolf', 'republicanosrj', 'requerimento', 'requerimento']","[1, 1, 1, 1, 1, 1, 1, 1, 1, 2, 2, 1, 1, 1, 1, 2, 2, 1, 2, 2]","['amigar']","[1]",20,1,21,1
4989,"['abordagem', 'aliquota', 'alteracao', 'calamidad', 'conjuntar', 'crise', 'destinar', 'dificuldad', 'economia', 'emendar', 'exercicio', 'instituto', 'necessidad', 'preservacao', 'previsto', 'provisorio', 'situacao', 'tributario']","[1, 1, 1, 1, 1, 1, 1, 1, 1, 1, 1, 1, 1, 1, 1, 1, 1, 1]","[]","[]",18,0,18,1
4994,"['calendario', 'compromisso', 'medeiro', 'oferecido', 'publicoalvo', 'reafirmar', 'realizacao', 'rotina', 'saudar', 'saudar', 'situacao', 'vigilancia']","[1, 1, 1, 1, 1, 1, 1, 1, 2, 2, 1, 1]","[]","[]",12,0,12,1
4998,"['articulacao', 'discussao', 'fase', 'proposto', 'reuter']","[1, 1, 1, 1, 1]","['privaci']","[1]",5,1,6,1
5001,"['diagnosticar', 'diagnosticar', 'infancia', 'respectivament']","[2, 2, 1, 1]","[]","[]",4,0,4,1
5002,"['afp', 'afp', 'biliao', 'biliao', 'condicao', 'deteccao', 'monetario', 'reconhecimento', 'recurso', 'respostar']","[2, 2, 2, 2, 1, 1, 1, 1, 1, 1]","['venezuelano']","[1]",10,1,11,1
5006,"['ambientar', 'circulacao', 'deslocamento', 'extraordinario', 'inovacao', 'julgamento', 'justicar', 'plenario', 'plenario', 'resolucao', 'resolucao', 'resolucao', 'sessao', 'sessao', 'sessao', 'supremo', 'supremo', 'transferir', 'turma', 'videoconferencia', 'videoconferencia', 'videoconferencia']","[1, 1, 1, 1, 1, 1, 1, 2, 2, 3, 3, 3, 3, 3, 3, 2, 2, 1, 1, 3, 3, 3]","[]","[]",22,0,22,1
5011,"['administrativo', 'administrativo', 'adulto', 'advocaciager', 'ambito', 'ampliacao', 'amplo', 'amplo', 'amplo', 'aplicacao', 'apurar', 'argumentar', 'argumentar', 'barroso', 'colegiado', 'colegiado', 'comissao', 'comissao', 'comissao', 'comissao', 'comissao', 'comissao', 'comissao', 'comissao', 'comissao', 'comissao', 'comissao', 'comissao', 'comissao', 'comissao', 'comissao', 'condicao', 'conduta', 'conduta', 'congresso', 'congresso', 'constituicao', 'contemplar', 'decisao', 'decisao', 'demmg', 'destacar', 'destacar', 'determinacao', 'determinacao', 'distrito', 'distrito', 'distrito', 'especifico', 'federar', 'federar', 'federar', 'federar', 'funcionamento', 'inquerito', 'inquerito', 'inquerito', 'inquerito', 'inquerito', 'inquerito', 'instalacao', 'instalacao', 'instalacao', 'instalacao', 'instalacao', 'integrant', 'integrant', 'internar', 'investigacao', 'investigacao', 'investigacao', 'investigacao', 'investigacao', 'investigacao', 'investigacao', 'legislativo', 'legislativo', 'ministrar', 'minoria', 'necessario', 'nomeacao', 'observar', 'pacheco', 'pacheco', 'pacheco', 'pacheco', 'plenario', 'pratico', 'prazo', 'presenca', 'previsto', 'proposto', 'proposto', 'randolf', 'randolf', 'randolf', 'randolf', 'randolf', 'randolf', 'realizacao', 'recurso', 'recurso', 'recurso', 'requerimento', 'requerimento', 'requerimento', 'requerimento', 'requerimento', 'secretariager', 'sessao', 'supremo', 'supremo', 'supremo', 'supremo', 'suspensao', 'velocidad']","[2, 2, 1, 1, 1, 1, 3, 3, 3, 1, 1, 2, 2, 1, 2, 2, 15, 15, 15, 15, 15, 15, 15, 15, 15, 15, 15, 15, 15, 15, 15, 1, 2, 2, 2, 2, 1, 1, 2, 2, 1, 2, 2, 2, 2, 3, 3, 3, 1, 4, 4, 4, 4, 1, 6, 6, 6, 6, 6, 6, 5, 5, 5, 5, 5, 2, 2, 1, 7, 7, 7, 7, 7, 7, 7, 2, 2, 1, 1, 1, 1, 1, 4, 4, 4, 4, 1, 1, 1, 1, 1, 2, 2, 6, 6, 6, 6, 6, 6, 1, 3, 3, 3, 5, 5, 5, 5, 5, 1, 1, 4, 4, 4, 4, 1, 1]","['atribuir']","[1]",116,1,117,1
5012,"['autoridad', 'autoridad', 'autoridad', 'autoridad', 'condicao', 'cupula', 'deslocamento', 'exercicio', 'henriqu', 'interino', 'ministrar', 'mudanca', 'planalto', 'regrar', 'regrar', 'secretarioexecutivo', 'substituto', 'viagem']","[4, 4, 4, 4, 1, 1, 1, 1, 1, 1, 1, 1, 1, 2, 2, 1, 1, 1]","[]","[]",18,0,18,1
5013,"['abba', 'abba', 'abba', 'epicentro', 'epidemiar', 'situacao', 'transferir']","[3, 3, 3, 1, 1, 1, 1]","[]","[]",7,0,7,1
5016,"['disseminacao', 'esforco', 'estrategia', 'estrategia', 'importancia', 'orientacao', 'parceria', 'preliminar', 'publicoalvo', 'publicoalvo', 'rotina', 'sarampo', 'sarampo', 'sarampo', 'sarampo', 'sarampo', 'saudar', 'saudar', 'saudar', 'transmissao']","[1, 1, 2, 2, 1, 1, 1, 1, 2, 2, 1, 5, 5, 5, 5, 5, 3, 3, 3, 1]","[]","[]",20,0,20,1
5017,"['apreensao', 'cenario', 'cenario', 'cenario', 'cepa', 'colaboracao', 'colaboracao', 'desenvolvido', 'disseminacao', 'enxergar', 'enxergar', 'epicentro', 'equivalent', 'excecao', 'exemplo', 'genoma', 'genoma', 'genoma', 'genoma', 'medida', 'molecular', 'molecular', 'necessario', 'necessario', 'none', 'none', 'none', 'none', 'none', 'none', 'none', 'none', 'none', 'none', 'none', 'quatro', 'rastreamento', 'rastreamento', 'rastreamento', 'rastreamento', 'regiao', 'risco', 'sequenciamento', 'sequenciamento', 'sequenciamento', 'sequenciamento', 'sequenciamento', 'sequenciamento', 'sequenciamento', 'sequenciamento', 'sequenciamento', 'serao', 'serao', 'serao', 'situacao', 'situacao', 'testagem', 'transmissao', 'ufrj', 'visitant', 'visitant']","[1, 3, 3, 3, 1, 2, 2, 1, 1, 2, 2, 1, 1, 1, 1, 4, 4, 4, 4, 1, 2, 2, 2, 2, 11, 11, 11, 11, 11, 11, 11, 11, 11, 11, 11, 1, 4, 4, 4, 4, 1, 1, 9, 9, 9, 9, 9, 9, 9, 9, 9, 3, 3, 3, 2, 2, 1, 1, 1, 2, 2]","[]","[]",61,0,61,1
5018,"['associacao', 'consorcio', 'consorcio', 'cooperacao', 'desenvolvimento', 'desenvolvimento', 'desenvolvimento', 'esforco', 'infraestrutura', 'justicar', 'palacio', 'planalto', 'planalto', 'planar', 'regiao']","[1, 2, 2, 1, 3, 3, 3, 1, 1, 1, 1, 2, 2, 1, 1]","[]","[]",15,0,15,1
5019,"['acordo', 'medida', 'medida', 'observar', 'recurso', 'recurso', 'regiao', 'sancao', 'serao', 'serao', 'transferencia']","[1, 2, 2, 1, 2, 2, 1, 1, 2, 2, 1]","[]","[]",11,0,11,1
5020,"['aglomeracao', 'associacao', 'carat', 'circulacao', 'consecutivo', 'decisao', 'funcionamento', 'justicar', 'propagacao', 'quedo', 'recurso', 'varar']","[1, 1, 1, 1, 1, 1, 1, 1, 1, 1, 1, 1]","[]","[]",12,0,12,1
5021,"['balancar', 'balancar', 'balancar', 'consorcio', 'consorcio', 'levantamento', 'saudar']","[3, 3, 3, 2, 2, 1, 1]","[]","[]",7,0,7,1
5024,"['compilar', 'destacar', 'distrito', 'imunizacao', 'operacionalizacao', 'pastar', 'planar', 'saudar']","[1, 1, 1, 1, 1, 1, 1, 1]","[]","[]",8,0,8,1
5025,"['contrato', 'economia', 'funcionamento', 'gued', 'integro', 'jornada', 'ministrar', 'prorrogar']","[1, 1, 1, 1, 1, 1, 1, 1]","[]","[]",8,0,8,1
5027,"['fronteiro', 'turista', 'vespera']","[1, 1, 1]","[]","[]",3,0,3,1
5028,"['lorenzoni', 'ministrar', 'ministrar', 'onyx', 'onyx', 'pagamento', 'reforcar', 'suspenso', 'suspenso', 'visitant']","[1, 2, 2, 2, 2, 1, 1, 2, 2, 1]","[]","[]",10,0,10,1
5031,"['ambientar', 'crise', 'crise', 'crise', 'desafio', 'enfatizar', 'surtir', 'surtir']","[1, 3, 3, 3, 1, 1, 2, 2]","['carbono', 'gretar', 'protestar']","[1, 1, 1]",8,3,11,1
5032,"['articulacao', 'contrato', 'iniciativo', 'iniciativo', 'possibilidad', 'previsto', 'privar', 'privar', 'privar', 'privilegiar', 'regrar']","[1, 1, 2, 2, 1, 1, 3, 3, 3, 1, 1]","[]","[]",11,0,11,1
5033,"['avancar', 'calamidad', 'desenvolvimento', 'determinacao', 'marinhar', 'minimizar', 'ministrar', 'prever', 'situacao', 'situacao']","[1, 1, 1, 1, 1, 1, 1, 1, 2, 2]","[]","[]",10,0,10,1
5034,"['aglomeracao', 'conformar', 'consumidor', 'fase', 'fase', 'mudanca', 'planar', 'presenciar']","[1, 1, 1, 2, 2, 1, 1, 1]","[]","[]",8,0,8,1
5036,"['adicionar', 'autoridad', 'logistico', 'moderno', 'recurso', 'respiratorio', 'suportar']","[1, 1, 1, 1, 1, 1, 1]","[]","[]",7,0,7,1
5038,"['adotada', 'curvo', 'decisao', 'deslocamento', 'estrategico', 'exercicio', 'feriar', 'individuar', 'limitacao', 'ministrar', 'oficialment', 'previsto', 'prorrogar', 'prorrogar', 'saudar', 'saudar']","[1, 1, 1, 1, 1, 1, 1, 1, 1, 1, 1, 1, 2, 2, 2, 2]","[]","[]",16,0,16,1
5039,"['oliveira', 'pastar', 'pastar', 'pastar', 'saudar', 'saudar', 'subir', 'triagem', 'triagem', 'triagem', 'triagem', 'vigilancia']","[1, 3, 3, 3, 2, 2, 1, 4, 4, 4, 4, 1]","[]","[]",12,0,12,1
5040,"['ambientar', 'ambientar', 'ansiedad', 'comportamento', 'comportamento', 'crescimento', 'crescimento', 'dedicar', 'desenvolvimento', 'desenvolvimento', 'fase', 'impactar', 'preparacao', 'regrar', 'rotina', 'rotina', 'rotina', 'rotina', 'rotina', 'rotina', 'rotina', 'volumar']","[2, 2, 1, 2, 2, 2, 2, 1, 2, 2, 1, 1, 1, 1, 7, 7, 7, 7, 7, 7, 7, 1]","[]","[]",22,0,22,1
5043,"['acordo', 'afastamento', 'afastamento', 'afastamento', 'calheiro', 'cnmp', 'colunista', 'conselho', 'conselho', 'deltan', 'forcatarefa', 'fundacao', 'irregularidad', 'mdbal', 'precedent', 'processo', 'processo', 'processo', 'sendo', 'serao']","[1, 3, 3, 3, 1, 1, 1, 2, 2, 1, 1, 1, 1, 1, 1, 3, 3, 3, 1, 1]","[]","[]",20,0,20,1
5044,"['ambito', 'cenario', 'diminuicao', 'diminuicao', 'diminuicao', 'federar', 'intensivo', 'intervalar', 'justicar', 'ministrar', 'palacio', 'planalto', 'positivar', 'positivar', 'quedo', 'quedo', 'reducao', 'trafego', 'trafego']","[1, 1, 3, 3, 3, 1, 1, 1, 1, 1, 1, 1, 2, 2, 2, 2, 1, 2, 2]","[]","[]",19,0,19,1
5050,"['academiar', 'academiar', 'fase', 'fase', 'reabrir', 'regrar']","[2, 2, 2, 2, 1, 1]","[]","[]",6,0,6,1
5051,"['flexibilizar', 'infectar', 'intubacao', 'liderar', 'necessidad', 'panamericana', 'reforcar', 'reforcar', 'regiao', 'saudar', 'taxar']","[1, 1, 1, 1, 1, 1, 2, 2, 1, 1, 1]","[]","[]",11,0,11,1
5052,"['arthur', 'consequencia', 'mudanca']","[1, 1, 1]","['ganhar', 'gretar', 'gretar', 'gretar']","[1, 3, 3, 3]",3,4,7,1
5053,"['apreensao', 'bolsonarista', 'decisao', 'descumprir', 'inquerito', 'magistrado', 'ministrar', 'organizador', 'oswaldo', 'supremo', 'suspeito', 'temporariament']","[1, 1, 1, 1, 1, 1, 1, 1, 1, 1, 1, 1]","['soltura']","[1]",12,1,13,1
5054,"['aliviar', 'celebrar', 'comparacao', 'destacar', 'estimular', 'organizador', 'volumar']","[1, 1, 1, 1, 1, 1, 1]","['nobel', 'nobel']","[2, 2]",7,2,9,1
5057,"['complicacao', 'consecutivo', 'consorcio', 'diagnosticar', 'notificar', 'saudar']","[1, 1, 1, 1, 1, 1]","[]","[]",6,0,6,1
5058,"['circulacao', 'desenvolvido', 'desenvolvimento', 'orientacao', 'presenca', 'reforcar', 'respiratorio', 'saudar', 'silveiro', 'transmissao']","[1, 1, 1, 1, 1, 1, 1, 1, 1, 1]","['espalhar']","[1]",10,1,11,1
5059,"['colunista']","[1]","['legendar']","[1]",1,1,2,1
5060,"['avancar', 'avancar', 'crise', 'crise', 'diariament', 'economia', 'epidemiar', 'minimizar', 'risco']","[2, 2, 2, 2, 1, 1, 1, 1, 1]","['indignar', 'supostament']","[1, 1]",9,2,11,1
5061,"['distrito', 'equipamento', 'fluxo', 'mudanca', 'reclamacao', 'regiao', 'saudar', 'situacao', 'situacao']","[1, 1, 1, 1, 1, 1, 1, 2, 2]","['bandeiro', 'estampar', 'imagem', 'revoltar']","[1, 1, 1, 1]",9,4,13,1
5063,"['autoridad', 'cerimonia', 'gorinchteyn', 'imunizacao', 'imunizacao', 'instituto', 'instituto', 'saudar']","[1, 1, 1, 2, 2, 2, 2, 1]","[]","[]",8,0,8,1
5070,"['adicionar', 'conjuntar', 'especifico', 'opcao']","[1, 1, 1, 1]","[]","[]",4,0,4,1
5071,"['economia', 'federar', 'folhar', 'integro', 'liderar', 'saudar']","[1, 1, 1, 1, 1, 1]","[]","[]",6,0,6,1
5072,"['campino', 'folhar', 'integro', 'periodo']","[1, 1, 1, 1]","['cristao', 'padrar']","[1, 1]",4,2,6,1
5073,"['ansiedad', 'associacao', 'atrasar', 'atrasar', 'consequencia', 'depressao', 'desenvolvimento', 'infancia', 'infancia', 'observar', 'prazo', 'queixar', 'respostar', 'risco', 'saudar', 'saudar', 'situacao', 'suspensao', 'transmissao']","[1, 1, 2, 2, 1, 1, 1, 2, 2, 1, 1, 1, 1, 1, 2, 2, 1, 1, 1]","[]","[]",19,0,19,1
5077,"['folhar', 'integro', 'jornada', 'jornada', 'prazo', 'prorrogacao', 'suspensao', 'suspensao']","[1, 1, 2, 2, 1, 1, 2, 2]","[]","[]",8,0,8,1
5080,"['administrativo', 'ambientar', 'associacao', 'barroso', 'constituicao', 'decisao', 'epidemiar', 'ministrar', 'plenario', 'plenario', 'provisorio', 'supremo', 'transmissao']","[1, 1, 1, 1, 1, 1, 1, 1, 2, 2, 1, 1, 1]","['supostament']","[1]",13,1,14,1
5082,"['antonio', 'colegiado', 'comissao', 'comissao', 'enfrentamento', 'informaco', 'pedido', 'requerimento', 'requerimento', 'situacao', 'videoconferencia', 'wellington']","[1, 1, 2, 2, 1, 1, 1, 2, 2, 1, 1, 1]","['incendio']","[1]",12,1,13,1
5087,"['saudar']","[1]","[]","[]",1,0,1,1
5088,"['anvisa', 'anvisa', 'anvisa', 'aprovacao', 'autorizacao', 'importacao', 'prazo', 'previsao', 'reuniao', 'saudar', 'sputnik', 'sputnik', 'sputnik', 'suspenso', 'vigilancia']","[3, 3, 3, 1, 1, 1, 1, 1, 1, 1, 3, 3, 3, 1, 1]","[]","[]",15,0,15,1
5093,"['expansao', 'facilitar', 'vigilancia']","[1, 1, 1]","[]","[]",3,0,3,1
5098,"['aliviar', 'dosar', 'enfermagem', 'esperancar', 'esperancar', 'jornada', 'necessidad', 'oswaldo', 'precaucao', 'saudar', 'universitario']","[1, 1, 1, 2, 2, 1, 1, 1, 1, 1, 1]","[]","[]",11,0,11,1
5100,"['regiao']","[1]","['compartilhar']","[1]",1,1,2,1
5101,"[]","[]","['puro']","[1]",0,1,1,1
5103,"['quarentenar', 'quarentenar']","[2, 2]","[]","[]",2,0,2,1
5105,"['amplo', 'araujo', 'cenario', 'converso', 'enfrentamento', 'escalar', 'habitant', 'imunizacao', 'infectar', 'marinhar', 'periodo', 'preventivo', 'primario', 'rastreamento', 'rastreamento', 'recurso', 'renata', 'renata', 'sudest', 'tendencia', 'testagem']","[1, 1, 1, 1, 1, 1, 1, 1, 1, 1, 1, 1, 1, 2, 2, 1, 2, 2, 1, 1, 1]","['disseminar', 'ganhar']","[1, 1]",21,2,23,1
5106,"['consumidor', 'quarentenar', 'regiao']","[1, 1, 1]","[]","[]",3,0,3,1
5107,"['despesa', 'instituto', 'republico', 'supremo']","[1, 1, 1, 1]","[]","[]",4,0,4,1
5108,"['avancar', 'crescimento', 'crescimento', 'inclusao', 'parceria', 'prioridad', 'prioritario', 'xinhua']","[1, 2, 2, 1, 1, 1, 1, 1]","[]","[]",8,0,8,1
5109,"['desafio']","[1]","[]","[]",1,0,1,1
5110,"['anuncio', 'companhia', 'companhia', 'companhia', 'crise', 'emprestimo', 'periodo', 'planar', 'prever', 'previsao', 'reducao', 'reuniao']","[1, 3, 3, 3, 1, 1, 1, 1, 1, 1, 1, 1]","[]","[]",12,0,12,1
5111,"['anuncio', 'apurar', 'expectativa', 'igualitario', 'importancia', 'ministrar', 'pastar', 'posicionamento', 'provisorio', 'provisorio', 'reafirmar', 'recurso', 'requerimento', 'saudar', 'saudar']","[1, 1, 1, 1, 1, 1, 1, 1, 2, 2, 1, 1, 1, 2, 2]","[]","[]",15,0,15,1
5113,"['adversario', 'constituicao', 'corpu', 'folhar', 'habea', 'integro', 'julgamento', 'vespera']","[1, 1, 1, 1, 1, 1, 1, 1]","['compartilhar']","[1]",8,1,9,1
5114,"['estatistico', 'infectar', 'mexico', 'mexico', 'mexico', 'suspeito', 'suspeito']","[1, 1, 3, 3, 3, 2, 2]","[]","[]",7,0,7,1
5116,"['avancar', 'comunitario', 'decisao', 'economia', 'impactar', 'impacto', 'periodo', 'publicitario', 'suspenso']","[1, 1, 1, 1, 1, 1, 1, 1, 1]","[]","[]",9,0,9,1
5117,"['campino', 'campino', 'companhia', 'distrito', 'infectar', 'intubacao', 'previsto', 'saudar', 'voo', 'voo', 'voo']","[2, 2, 1, 1, 1, 1, 1, 1, 3, 3, 3]","[]","[]",11,0,11,1
5118,"['aplicacao', 'circulacao', 'circulacao', 'fundacao', 'fundacao', 'inovacao', 'molecular', 'oswaldo', 'parceria', 'sequenciamento', 'sequenciamento', 'ufrj']","[1, 2, 2, 2, 2, 1, 1, 1, 1, 2, 2, 1]","[]","[]",12,0,12,1
5119,"['aprovacao', 'avancar', 'avancar', 'bancada', 'bancada', 'congresso', 'economia', 'economia', 'gued', 'gued', 'proposta', 'servidor']","[1, 2, 2, 2, 2, 1, 2, 2, 2, 2, 1, 1]","[]","[]",12,0,12,1
5120,"['adulto', 'adulto', 'dosar', 'etapa', 'etapa', 'planar']","[2, 2, 1, 2, 2, 1]","[]","[]",6,0,6,1
5121,"['decisao', 'decisao', 'decisao', 'dedicar', 'deltan', 'desenvolvimento', 'forcatarefa', 'republico', 'republico', 'suspeito']","[3, 3, 3, 1, 1, 1, 1, 2, 2, 1]","[]","[]",10,0,10,1
5122,"['painel', 'preocupacao', 'regiao', 'taxar']","[1, 1, 1, 1]","[]","[]",4,0,4,1
5125,"['anuncio', 'assintomatico', 'assintomatico', 'assintomatico', 'crise', 'epidemiar', 'espanha', 'fase', 'hospitalizacao', 'infectar', 'infraestrutura', 'infraestrutura', 'instalacao', 'necessario', 'piorar', 'preparacao', 'prever', 'prever', 'quarentenar', 'quarentenar', 'saudar']","[1, 3, 3, 3, 1, 1, 1, 1, 1, 1, 2, 2, 1, 1, 1, 1, 2, 2, 2, 2, 1]","[]","[]",21,0,21,1
5127,"['comissao', 'comissao', 'desenvolvido', 'desenvolvimento', 'etapa', 'europeu', 'europeu', 'europeu', 'fase', 'fase', 'ministrar', 'obtido', 'opcao', 'previsto', 'saudar']","[2, 2, 1, 1, 1, 3, 3, 3, 2, 2, 1, 1, 1, 1, 1]","[]","[]",15,0,15,1
5128,"['biliao', 'destinar', 'levantamento', 'recurso', 'recurso', 'republico', 'sancao', 'saudar', 'saudar', 'transferir']","[1, 1, 1, 2, 2, 1, 1, 2, 2, 1]","[]","[]",10,0,10,1
5129,"['condicao', 'distrito', 'investigacao', 'mudanca', 'mudanca']","[1, 1, 1, 2, 2]","[]","[]",5,0,5,1
5130,"['adotada', 'bbc', 'bbc', 'dialogo', 'estrategia', 'regrar', 'respostar', 'reuniao']","[1, 2, 2, 1, 1, 1, 1, 1]","[]","[]",8,0,8,1
5132,"['aglomeracao', 'previsto']","[1, 1]","[]","[]",2,0,2,1
5136,"['comissao', 'estrategia', 'estrategico', 'medida', 'parceiro', 'reuniao', 'ricardo', 'sall']","[1, 1, 1, 1, 1, 1, 1, 1]","[]","[]",8,0,8,1
5137,"['destinar', 'disseminacao', 'equipamento', 'justicar', 'ministrar']","[1, 1, 1, 1, 1]","[]","[]",5,0,5,1
5139,"['balancar', 'chefiar', 'decisao', 'domingo', 'exministro', 'henriqu', 'levantamento', 'pastar', 'ritmar', 'saudar', 'saudar', 'saudar']","[1, 1, 1, 1, 1, 1, 1, 1, 1, 3, 3, 3]","[]","[]",12,0,12,1
5141,"['apurar', 'autorizacao', 'decisao', 'entendimento', 'henriqu', 'ministrar', 'ministrar', 'nelson', 'pastar', 'saudar', 'saudar', 'saudar', 'teich', 'teich']","[1, 1, 1, 1, 1, 2, 2, 1, 1, 3, 3, 3, 2, 2]","[]","[]",14,0,14,1
5142,"['anticorpo', 'anticorpo', 'anticorpo', 'epicentro', 'journal', 'transferir']","[3, 3, 3, 1, 1, 1]","['parir', 'pelar', 'pelar', 'quantum']","[1, 2, 2, 1]",6,4,10,1
5143,"['avancar', 'consequencia', 'converso', 'deflagrar', 'deltan', 'equivalent', 'forcatarefa', 'fux', 'investigacao', 'investigacao', 'parceiro', 'varar', 'varar']","[1, 1, 1, 1, 1, 1, 1, 1, 2, 2, 1, 2, 2]","['compartilhar', 'telegram', 'telegram']","[1, 2, 2]",13,3,16,1
5144,"['acordo', 'acordo', 'acordo', 'acordo', 'anuncio', 'inicialment', 'journal', 'medida', 'milho', 'prazo', 'proprio', 'tambem']","[4, 4, 4, 4, 1, 1, 1, 1, 1, 1, 1, 1]","[]","[]",12,0,12,1
5145,"['instituto', 'instituto', 'sputnik']","[2, 2, 1]","[]","[]",3,0,3,1
5151,"['epidemiar', 'saudar']","[1, 1]","[]","[]",2,0,2,1
5152,"['apurar', 'biliao', 'biliao', 'biliao', 'cenario', 'condicao', 'externo', 'impactar', 'incerteza', 'juro', 'normalidad', 'recuar', 'subir', 'tesourar', 'tesourar', 'volumar']","[1, 3, 3, 3, 1, 1, 1, 1, 1, 1, 1, 1, 1, 2, 2, 1]","[]","[]",16,0,16,1
5154,"['justicar', 'martim', 'preconceito', 'queixar']","[1, 1, 1, 1]","['compartilhar', 'postagen']","[1, 1]",4,2,6,1
5155,"['ministrar', 'nelson', 'saudar', 'teich']","[1, 1, 1, 1]","[]","[]",4,0,4,1
5156,"['academico', 'californio', 'compilar', 'compilar', 'disseminacao', 'federar', 'reportar']","[1, 1, 2, 2, 1, 1, 1]","[]","[]",7,0,7,1
5159,"['circulacao', 'circulacao', 'disseminacao', 'recuar']","[2, 2, 1, 1]","[]","[]",4,0,4,1
5165,"['equipamento', 'orientacao', 'situacao']","[1, 1, 1]","[]","[]",3,0,3,1
5168,"['apurar', 'apurar', 'cupula', 'deflagrar', 'deflagrar', 'destinar', 'destinar', 'desvio', 'desvio', 'esquema', 'federar', 'palacio', 'recurso', 'recurso', 'saudar', 'saudar', 'servidor', 'wilson', 'witzel']","[2, 2, 1, 2, 2, 2, 2, 2, 2, 1, 1, 1, 2, 2, 2, 2, 1, 1, 1]","['imagem']","[1]",19,1,20,1
5169,"['atalhar', 'campino', 'capitar', 'colaboracao', 'desempenhar', 'epidemiar', 'estrategico', 'fluxo', 'importancia', 'monitoramento', 'propagacao', 'propagacao']","[1, 1, 1, 1, 1, 1, 1, 1, 1, 1, 2, 2]","['parir']","[1]",12,1,13,1
5170,"['treinar']","[1]","['compartilhar', 'usuario']","[1, 1]",1,2,3,1
5171,"['autoridad', 'equipamento', 'infectar', 'infectar']","[1, 1, 2, 2]","['amigar', 'curioso']","[1, 1]",4,2,6,1
5172,"['provincia', 'regrar', 'regrar', 'turista', 'turista']","[1, 2, 2, 2, 2]","[]","[]",5,0,5,1
5173,"['autoridad', 'deslocamento', 'domingo', 'efetividad', 'impactar', 'infectar', 'pastar', 'rastreamento', 'reforcar', 'saudar', 'saudar', 'saudar', 'viajant', 'viajant', 'vigilancia']","[1, 1, 1, 1, 1, 1, 1, 1, 1, 3, 3, 3, 2, 2, 1]","['disseminar']","[1]",15,1,16,1
5174,"['argumentar', 'corpu', 'esquema', 'estrategia', 'exgovernador', 'exgovernador', 'exgovernador', 'exgovernador', 'exgovernador', 'habea', 'justicar', 'manutencao', 'periodo', 'relaxar', 'ricardo', 'ricardo', 'saudar', 'supremo']","[1, 1, 1, 1, 5, 5, 5, 5, 5, 1, 1, 1, 1, 1, 2, 2, 1, 1]","[]","[]",18,0,18,1
5175,"['associacao', 'comissao', 'comissao', 'consenso', 'discussao', 'elaborar', 'exministro', 'integrant', 'jurista', 'justicar', 'periodo', 'pslsp', 'republico', 'sigla']","[1, 2, 2, 1, 1, 1, 1, 1, 1, 1, 1, 1, 1, 1]","[]","[]",14,0,14,1
5178,"['crise', 'decisao', 'determinacao', 'periodo', 'periodo', 'revogar', 'saudar']","[1, 1, 1, 2, 2, 1, 1]","[]","[]",7,0,7,1
5179,"['bbc', 'destacar', 'presenca']","[1, 1, 1]","['autopsia']","[1]",3,1,4,1
5180,"['afp', 'bruto', 'calculo', 'conformar', 'economia', 'economia', 'estatistico', 'instituto', 'internar', 'paralisar', 'pib', 'pib', 'trimestr', 'trimestr', 'trimestr']","[1, 1, 1, 1, 2, 2, 1, 1, 1, 1, 2, 2, 3, 3, 3]","['parir']","[1]",15,1,16,1
5181,"['crise', 'exjuiz', 'exministro', 'exministro', 'justicar', 'republico']","[1, 1, 2, 2, 1, 1]","['compartilhar', 'mencao']","[1, 1]",6,2,8,1
5183,"['ambientar', 'ambientar', 'colunista', 'conflito', 'congresso', 'converso', 'demrj', 'especifico', 'ministrar', 'ricardo', 'sall']","[2, 2, 1, 1, 1, 1, 1, 1, 1, 1, 1]","['imagem', 'imagem']","[2, 2]",11,2,13,1
5184,"['anuncio', 'bandeirant', 'diminuicao', 'epidemiologico', 'fase', 'gorinchteyn', 'gorinchteyn', 'palacio', 'periodo', 'planar', 'quedo', 'quedo', 'reducao', 'saudar', 'taxar']","[1, 1, 1, 1, 1, 2, 2, 1, 1, 1, 2, 2, 1, 1, 1]","[]","[]",15,0,15,1
5186,"['dengu', 'dengu', 'dengu', 'dificultar', 'saudar', 'saudar', 'triagem']","[3, 3, 3, 1, 2, 2, 1]","[]","[]",7,0,7,1
5192,"['companhia', 'decisao', 'decisao', 'emergenciai', 'fundacao', 'justicar', 'justicar', 'situacao']","[1, 2, 2, 1, 1, 2, 2, 1]","[]","[]",8,0,8,1
5193,"['colaborar', 'dificuldad', 'estimativo', 'exportacao', 'fundacao', 'fundacao', 'fundacao', 'inicialment', 'instituto', 'oswaldo', 'prazo', 'respostar']","[1, 1, 1, 1, 3, 3, 3, 1, 1, 1, 1, 1]","[]","[]",12,0,12,1
5195,"['aglomeracao', 'autoridad', 'concreto', 'decorrencia', 'demandar', 'desenvolvimento', 'dialogo', 'dialogo', 'indicador', 'iniciativo', 'parceria', 'periodo', 'realizacao', 'regiao', 'regiao', 'regiao', 'respostar', 'saudar', 'taxar']","[1, 1, 1, 1, 1, 1, 2, 2, 1, 1, 1, 1, 1, 3, 3, 3, 1, 1, 1]","['bispar', 'bispar', 'bispar', 'bispar', 'catolico', 'estranhar', 'humanar']","[4, 4, 4, 4, 1, 1, 1]",19,7,26,1
5196,"['ausencia', 'compromisso', 'demandar', 'demandar', 'imunizacao', 'ministrar', 'ministrar', 'necessario', 'pastar', 'reuniao', 'reuniao', 'saudar', 'saudar', 'wellington']","[1, 1, 2, 2, 1, 2, 2, 1, 1, 2, 2, 2, 2, 1]","[]","[]",14,0,14,1
5197,"['balancar', 'consorcio', 'distrito', 'dosar', 'dosar', 'folhar', 'parceria', 'spaulo', 'spaulo']","[1, 1, 1, 2, 2, 1, 1, 2, 2]","[]","[]",9,0,9,1
5198,"['assistencia', 'lancamento']","[1, 1]","['macho', 'macho']","[2, 2]",2,2,4,1
5202,"['decisao', 'dosar', 'imunizacao', 'intervalar', 'orientacao', 'saudar']","[1, 1, 1, 1, 1, 1]","[]","[]",6,0,6,1
5203,"['comportamento', 'consumidor', 'economia', 'observar', 'respostar']","[1, 1, 1, 1, 1]","['ganhar']","[1]",5,1,6,1
5204,"['anvisa', 'cenario', 'condicao', 'consenso', 'decisao', 'demandar', 'diretoria', 'extraordinario', 'flexibilizar', 'plano', 'prazo', 'prazo', 'prazo', 'prazo', 'resolucao', 'reuniao', 'reuniao', 'saudar', 'saudar', 'saudar', 'saudar', 'substituto', 'vigilancia']","[1, 1, 1, 1, 1, 1, 1, 1, 1, 1, 4, 4, 4, 4, 1, 2, 2, 4, 4, 4, 4, 1, 1]","[]","[]",23,0,23,1
5205,"['apurar', 'domingo', 'folhar', 'inquerito', 'spaulo', 'suspeito', 'suspeito', 'suspenso']","[1, 1, 1, 1, 1, 2, 2, 1]","['fraudar', 'fraudar', 'invadir', 'vazar']","[2, 2, 1, 1]",8,4,12,1
5206,"['anteontem', 'conflito', 'conflito', 'desvio', 'divergencia', 'imunizacao', 'imunizacao', 'milho', 'milho', 'milho', 'permanencia', 'plano', 'prioritario', 'profissionai', 'profissionai', 'publicoalvo', 'remessa', 'tambem']","[1, 2, 2, 1, 1, 2, 2, 3, 3, 3, 1, 1, 1, 2, 2, 1, 1, 1]","[]","[]",18,0,18,1
5207,"['argumentar', 'curvo', 'curvo', 'diariament', 'domingo', 'estatistico', 'exministro', 'fase', 'integrant', 'mantido', 'periodo', 'reducao', 'revisar', 'saudar', 'situacao', 'superar', 'superar']","[1, 2, 2, 1, 1, 1, 1, 1, 1, 1, 1, 1, 1, 1, 1, 2, 2]","['postagen', 'realment']","[1, 1]",17,2,19,1
5213,"['exjuiz', 'folhar', 'integro', 'interlocutor']","[1, 1, 1, 1]","[]","[]",4,0,4,1
5214,"['acompanhamento', 'autoridad', 'diagnosticar', 'exgovernador', 'negativar', 'positivar', 'sabado']","[1, 1, 1, 1, 1, 1, 1]","[]","[]",7,0,7,1
5215,"['afetado', 'afetado', 'belgica', 'client', 'espanha', 'expressar', 'mexico', 'notificar']","[2, 2, 1, 1, 1, 1, 1, 1]","[]","[]",8,0,8,1
5218,"['crise', 'estimular']","[1, 1]","[]","[]",2,0,2,1
5219,"['contagioso', 'infectar']","[1, 1]","[]","[]",2,0,2,1
5220,"['adiamento', 'claudio', 'condicao', 'desvio', 'discussao', 'inquerito', 'justicar', 'mello', 'plenario', 'saudar', 'sessao', 'sessao', 'suspensao', 'wilson', 'witzel', 'witzel', 'witzel']","[1, 1, 1, 1, 1, 1, 1, 1, 1, 1, 2, 2, 1, 1, 3, 3, 3]","['protestar']","[1]",17,1,18,1
5222,"['integro', 'justicar', 'mprj']","[1, 1, 1]","['chorar', 'inocentar']","[1, 1]",3,2,5,1
5224,"['bandeirant', 'belgica', 'embora', 'epicentro', 'epicentro', 'epidemia', 'epidemia', 'epidemia', 'europeu', 'fase', 'importancia', 'instituto', 'palacio']","[1, 1, 1, 2, 2, 3, 3, 3, 1, 1, 1, 1, 1]","[]","[]",13,0,13,1
5227,"['crescimento', 'crescimento', 'crescimento', 'crescimento', 'crise', 'crise', 'economia', 'equilibrio', 'estimativo', 'expectativa', 'pib', 'pib', 'pib', 'pib', 'previsao', 'projecao', 'reducao', 'risco']","[4, 4, 4, 4, 2, 2, 1, 1, 1, 1, 4, 4, 4, 4, 1, 1, 1, 1]","[]","[]",18,0,18,1
5228,"['adhanom', 'adotada', 'avancar', 'coreia', 'enfrentamento', 'epidemiar', 'estrategia', 'infectar', 'insuficient', 'oliveira', 'oliveira', 'possibilidad', 'realizacao', 'realizacao', 'saudar', 'saudar', 'saudar', 'saudar', 'suspeito', 'suspeito', 'suspeito', 'tedro', 'vigilancia']","[1, 1, 1, 1, 1, 1, 1, 1, 1, 2, 2, 1, 2, 2, 4, 4, 4, 4, 3, 3, 3, 1, 1]","['estranhar']","[1]",23,1,24,1
5229,"['arrecadacao', 'biliao', 'biliao', 'biliao', 'biliao', 'biliao', 'biliao', 'calculo', 'calculo', 'congresso', 'economia', 'gued', 'gued', 'impactar', 'impactar', 'ministrar']","[1, 6, 6, 6, 6, 6, 6, 2, 2, 1, 1, 2, 2, 2, 2, 1]","['versao']","[1]",16,1,17,1
5232,"['externo', 'treinar']","[1, 1]","['legendar']","[1]",2,1,3,1
5233,"['colaboracao', 'comportamento', 'conduta', 'fundacao', 'fundacao', 'regrar', 'reuter']","[1, 1, 1, 2, 2, 1, 1]","['idioma', 'usuario']","[1, 1]",7,2,9,1
5237,"['consorcio', 'notificar']","[1, 1]","[]","[]",2,0,2,1
5240,"['acordo', 'argumentar', 'autorizacao', 'biliao', 'contrato', 'crise', 'destinar', 'dificuldad', 'economia', 'extensao', 'fase', 'instituto', 'jornada', 'jornada', 'jornada', 'jornada', 'pagamento', 'pastar', 'preocupacao', 'preservacao', 'recurso', 'reducao', 'reducao', 'situacao', 'sugestao', 'suspensao', 'temporario']","[1, 1, 1, 1, 1, 1, 1, 1, 1, 1, 1, 1, 4, 4, 4, 4, 1, 1, 1, 1, 1, 2, 2, 1, 1, 1, 1]","[]","[]",27,0,27,1
5242,"['alcolumbr', 'amplo', 'congresso', 'congresso', 'demap', 'demrj', 'discussao', 'economia', 'elaborar', 'federar', 'federar', 'gued', 'importancia', 'ministrar', 'proposto', 'proposto', 'proposto', 'proposto', 'superar', 'tramitacao', 'tributario', 'tributario']","[1, 1, 2, 2, 1, 1, 1, 1, 1, 2, 2, 1, 1, 1, 4, 4, 4, 4, 1, 1, 2, 2]","[]","[]",22,0,22,1
5243,"['bolsonarista', 'bolsonarista', 'colegiado', 'favorito', 'governista', 'ministrar', 'nomeacao', 'palacio', 'pastar', 'planalto', 'planar', 'rejeitar']","[2, 2, 1, 1, 1, 1, 1, 1, 1, 1, 1, 1]","['amigar']","[1]",12,1,13,1
5245,"['bbc', 'domingo', 'epidemiar', 'gabinet', 'gabinet', 'infectar', 'michael', 'ministrar', 'periodo', 'periodo', 'previsao', 'propagacao']","[1, 1, 1, 2, 2, 1, 1, 1, 2, 2, 1, 1]","[]","[]",12,0,12,1
5246,"['amplo', 'aprovacao', 'consecutivo', 'economia', 'epidemiar', 'espanha', 'exercicio', 'extensao', 'extensao', 'normalidad', 'primeiroministro', 'quarentenar', 'recordar', 'rigoroso', 'sabado']","[1, 1, 1, 1, 1, 1, 1, 2, 2, 1, 1, 1, 1, 1, 1]","['reivindicar']","[1]",15,1,16,1
5247,"['aprovacao', 'aprovacao', 'avancar', 'avancar', 'condicao', 'congresso', 'decisao', 'dialogo', 'economia', 'economia', 'economia', 'emendar', 'estrategia', 'gued', 'integrant', 'ministrar', 'ministrar', 'plano', 'proposto', 'realizacao', 'resistencia', 'sabado', 'servidor']","[2, 2, 2, 2, 1, 1, 1, 1, 3, 3, 3, 1, 1, 1, 1, 2, 2, 1, 1, 1, 1, 1, 1]","['limao']","[1]",23,1,24,1
5249,"[]","[]","[]","[]",0,0,0,1
5251,"['celebrar', 'comissao', 'consecutivo', 'consecutivo', 'constatar', 'crise', 'domingo', 'domingo', 'epidemiar', 'epidemiar', 'epidemiar', 'infectar', 'portavoz', 'prever', 'recuar', 'saudar', 'saudar']","[1, 1, 2, 2, 1, 1, 2, 2, 3, 3, 3, 1, 1, 1, 1, 2, 2]","[]","[]",17,0,17,1
5252,"['equipamento', 'equipamento', 'justicar', 'servidor', 'substituicao']","[2, 2, 1, 1, 1]","['gravacao']","[1]",5,1,6,1
5253,"['bruto', 'impacto', 'internar', 'pib', 'reuter', 'subir']","[1, 1, 1, 1, 1, 1]","[]","[]",6,0,6,1
5254,"['agravamento', 'antonio', 'compromisso', 'funcao', 'internar']","[1, 1, 1, 1, 1]","['acidentar']","[1]",5,1,6,1
5257,"['comportamento', 'consecutivo', 'crescimento', 'crise', 'curvo', 'quedo', 'relativo', 'respectivament', 'significativo']","[1, 1, 1, 1, 1, 1, 1, 1, 1]","['ganhar', 'verificar']","[1, 1]",9,2,11,1
5261,"['feriar', 'justicar', 'orientacao', 'republico']","[1, 1, 1, 1]","[]","[]",4,0,4,1
5265,"['cenario', 'demandar', 'diariament', 'fabricacao', 'respirador', 'respiratorio', 'rotina', 'ventilador']","[1, 1, 1, 1, 1, 1, 1, 1]","['protestar']","[1]",8,1,9,1
5269,"['anteriorment', 'associacao', 'decisao', 'fase', 'flavio', 'ideologico', 'investigacao', 'justicar', 'magistrado', 'metropolitano', 'preventivo', 'preventivo', 'processo', 'regiao', 'varar']","[1, 1, 1, 1, 1, 1, 1, 1, 1, 1, 2, 2, 1, 1, 1]","['falsar', 'fraudar', 'instrucao', 'versao']","[1, 1, 1, 1]",15,4,19,1
5271,"['destinar', 'flavio', 'flavio', 'flavio', 'recurso', 'republico']","[1, 3, 3, 3, 1, 1]","['misturar']","[1]",6,1,7,1
5274,"['consorcio', 'distrito', 'domingo', 'entregu', 'expectativa', 'fundacao', 'igualitario', 'imunizacao', 'instituto', 'instituto', 'logistico', 'oswaldo', 'prever', 'previsao', 'remessar', 'saudar', 'saudar']","[1, 1, 1, 1, 1, 1, 1, 1, 2, 2, 1, 1, 1, 1, 1, 2, 2]","[]","[]",17,0,17,1
5282,"['atrasar', 'balancar', 'boletim', 'compilar', 'comunitario', 'comunitario', 'notificar', 'pastar', 'saudar', 'saudar', 'saudar', 'transmissao', 'transmissao']","[1, 1, 1, 1, 2, 2, 1, 1, 3, 3, 3, 2, 2]","[]","[]",13,0,13,1
5283,"['agravamento', 'agravamento', 'argumentar', 'ausencia', 'ausencia', 'autoridad', 'autoridad', 'autorizacao', 'cenario', 'cepa', 'circulacao', 'coletivo', 'congresso', 'congresso', 'congresso', 'conjuntar', 'crise', 'determinacao', 'determinacao', 'dificultar', 'epidemiologico', 'extraordinario', 'fluxo', 'implementacao', 'implementacao', 'legislativo', 'legislativo', 'levantamento', 'necessidad', 'periodo', 'planar', 'presenciar', 'presenciar', 'proposto', 'recurso', 'reducao', 'regiao', 'regiao', 'regiao', 'relaxamento', 'saudar', 'saudar', 'saudar', 'situacao', 'suspensao', 'suspensao']","[2, 2, 1, 2, 2, 2, 2, 1, 1, 1, 1, 1, 3, 3, 3, 1, 1, 2, 2, 1, 1, 1, 1, 2, 2, 2, 2, 1, 1, 1, 1, 2, 2, 1, 1, 1, 3, 3, 3, 1, 3, 3, 3, 1, 2, 2]","['interaco']","[1]",46,1,47,1
5287,"['ausencia', 'autoridad', 'avancar', 'cometido', 'cupula', 'desmatamento', 'dificultar', 'exportacao', 'funcao', 'henriqu', 'iniciativo', 'privar', 'regiao', 'vespera']","[1, 1, 1, 1, 1, 1, 1, 1, 1, 1, 1, 1, 1, 1]","[]","[]",14,0,14,1
5290,"['apurar', 'argumentar', 'crescimento', 'desmatamento', 'desmatamento', 'escalar', 'integro', 'regiao', 'regiao', 'respostar', 'situacao']","[1, 1, 1, 2, 2, 1, 1, 2, 2, 1, 1]","['ganhar']","[1]",11,1,12,1
5293,"['adhanom', 'balancar', 'consorcio', 'contabilizar', 'coreia', 'infectar', 'levantamento', 'reuter', 'saudar', 'saudar', 'saudar', 'subir', 'surto', 'tedro']","[1, 1, 1, 1, 1, 1, 1, 1, 3, 3, 3, 1, 1, 1]","[]","[]",14,0,14,1
5300,"['decisao', 'fundacao', 'fundacao', 'justicar', 'justicar', 'ministrar', 'nomeacao', 'nomeacao', 'pratico', 'provisorio', 'recurso']","[1, 2, 2, 2, 2, 1, 2, 2, 1, 1, 1]","['enderecar']","[1]",11,1,12,1
5301,"['domingo', 'dosar']","[1, 1]","[]","[]",2,0,2,1
5302,"['cirurgico', 'necessidad', 'obesidad']","[1, 1, 1]","[]","[]",3,0,3,1
5304,"['desempenhar', 'servidor', 'servidor', 'taxar']","[1, 2, 2, 1]","[]","[]",4,0,4,1
5305,"['aprovacao', 'aprovacao', 'confederacao', 'instituto', 'margem', 'subir']","[2, 2, 1, 1, 1, 1]","[]","[]",6,0,6,1
5310,"['balancar', 'boletim', 'calculo', 'consorcio', 'consorcio', 'contabilizar', 'coordenar', 'diariament', 'enxergar', 'escassez', 'estabilidad', 'estatistico', 'folhar', 'inconsistencia', 'infectar', 'infectar', 'iniciativo', 'notificar', 'pastar', 'plantao', 'quedo', 'recurso', 'saudar', 'saudar', 'sigla', 'spaulo', 'sputnik', 'tendencia', 'tendencia', 'totalizar']","[1, 1, 1, 2, 2, 1, 1, 1, 1, 1, 1, 1, 1, 1, 2, 2, 1, 1, 1, 1, 1, 1, 2, 2, 1, 1, 1, 2, 2, 1]","[]","[]",30,0,30,1
5311,"['ambientar', 'conjuntar', 'conjuntar', 'desmatamento', 'desmatamento', 'iniciativo', 'ministrar']","[1, 2, 2, 2, 2, 1, 1]","[]","[]",7,0,7,1
5313,"['ampliacao', 'associacao', 'decisao', 'dificultar', 'diminuicao', 'economia', 'folhar', 'iniciativo', 'jornada', 'necessidad', 'pagamento', 'prorrogacao', 'prorrogacao', 'provisorio', 'reducao', 'tesourar', 'vetar']","[1, 1, 1, 1, 1, 1, 1, 1, 1, 1, 1, 2, 2, 1, 1, 1, 1]","[]","[]",17,0,17,1
5315,"['desmatamento', 'journal', 'parceria', 'quatro']","[1, 1, 1, 1]","[]","[]",4,0,4,1
5318,"['aspecto', 'esperancar', 'pratico', 'proposto', 'republico']","[1, 1, 1, 1, 1]","[]","[]",5,0,5,1
5320,"['gabbardo', 'gabbardo', 'gabbardo', 'opcao', 'secretarioexecutivo', 'secretarioexecutivo']","[3, 3, 3, 1, 2, 2]","[]","[]",6,0,6,1
5323,"['alcolumbr', 'alcolumbr', 'argumentar', 'constituicao', 'demap', 'demrj', 'internar', 'julgamento', 'legislativo', 'ministrar', 'possibilidad', 'supremo']","[2, 2, 1, 1, 1, 1, 1, 1, 1, 1, 1, 1]","[]","[]",12,0,12,1
5325,"['alckmin', 'antonio', 'geraldo', 'logistico', 'nogueira', 'nogueira', 'nogueira', 'tucano']","[1, 1, 1, 1, 3, 3, 3, 1]","[]","[]",8,0,8,1
5328,"['journal']","[1]","['garganta', 'garganta']","[2, 2]",1,2,3,1
5330,"['afp', 'autoridad', 'autoridad', 'recordar', 'recordar', 'regiao', 'reuniao', 'sabado', 'saudar']","[1, 2, 2, 2, 2, 1, 1, 1, 1]","[]","[]",9,0,9,1
5331,"['acompanhamento', 'ausencia', 'desenvolvido', 'desenvolvimento', 'estrategico', 'gabinet', 'inovacao', 'ministrar', 'prever', 'saudar', 'saudar', 'saudar', 'saudar', 'saudar', 'transferencia', 'vigilancia']","[1, 1, 1, 1, 1, 1, 1, 1, 1, 5, 5, 5, 5, 5, 1, 1]","['quinzen']","[1]",16,1,17,1
5333,"['companhia', 'desafio', 'embora', 'fez', 'primeiroministro', 'prioridad', 'servido', 'situacao', 'suprimento', 'surto']","[1, 1, 1, 1, 1, 1, 1, 1, 1, 1]","['canadens', 'canadens']","[2, 2]",10,2,12,1
5335,"['fase', 'infectar', 'instituto', 'internacao', 'necessidad', 'parceria', 'situacao']","[1, 1, 1, 1, 1, 1, 1]","[]","[]",7,0,7,1
5336,"['imunizacao', 'orientacao', 'sabado']","[1, 1, 1]","[]","[]",3,0,3,1
5337,"[]","[]","['desfilar', 'parir']","[1, 1]",0,2,2,1
5338,"['domingo', 'totalizar']","[1, 1]","[]","[]",2,0,2,1
5339,"['autoridad', 'crise', 'decisao', 'decisao', 'decisao', 'decisao', 'decisao', 'emergenciai', 'emergenciai', 'equipamento', 'supremo', 'supremo', 'supremo']","[1, 1, 5, 5, 5, 5, 5, 2, 2, 1, 3, 3, 3]","['abortar', 'abortar']","[2, 2]",13,2,15,1
5340,"['assistencia', 'jorg', 'wellington']","[1, 1, 1]","[]","[]",3,0,3,1
5341,"['ampliacao', 'circulacao', 'claudio', 'conjuntar', 'exercicio', 'fluminens', 'importancia', 'metropolitano', 'propagacao', 'restritivo', 'restritivo']","[1, 1, 1, 1, 1, 1, 1, 1, 1, 2, 2]","[]","[]",11,0,11,1
5347,"['batalhar', 'enfrentamento', 'enfrentamento', 'flexibilizar', 'regrar', 'saudar', 'saudar']","[1, 2, 2, 1, 1, 2, 2]","['inscricao']","[1]",7,1,8,1
5348,"['epidemiar', 'implementacao', 'importancia', 'infectar', 'observar', 'passageiro', 'quarentenar', 'saudar', 'surtir', 'suspenso', 'taxar', 'transmissao', 'transmissao', 'transmissao']","[1, 1, 1, 1, 1, 1, 1, 1, 1, 1, 1, 3, 3, 3]","[]","[]",14,0,14,1
5350,"['atuacao', 'biliao', 'biliao', 'biliao', 'comissao', 'congresso', 'contrato', 'destacar', 'enfrentamento', 'irregularidad', 'ministrar', 'ministrar', 'orcamentaria', 'pastar', 'previo', 'prioridad', 'provisorio', 'saudar', 'saudar', 'temporario']","[1, 3, 3, 3, 1, 1, 1, 1, 1, 1, 2, 2, 1, 1, 1, 1, 1, 2, 2, 1]","['rosario', 'rosario', 'wagner']","[2, 2, 1]",20,3,23,1
5354,"['flexibilizar']","[1]","[]","[]",1,0,1,1
5358,"['atuam', 'ausencia', 'dificuldad', 'equipamento', 'estagio', 'fase', 'fase', 'infraestrutura', 'instituto', 'instituto', 'percepcao']","[1, 1, 1, 1, 1, 2, 2, 1, 2, 2, 1]","['verificar']","[1]",11,1,12,1
5360,"['antonio', 'anvisa', 'depoimento', 'depoimento', 'depoimento', 'gabinet', 'gabinet', 'mudanca', 'paralelo', 'paralelo', 'vigilancia']","[1, 1, 3, 3, 3, 2, 2, 1, 2, 2, 1]","['versao']","[1]",11,1,12,1
5363,"['acompanhamento', 'acompanhamento', 'acumular', 'diagnosticar', 'saudar']","[2, 2, 1, 1, 1]","[]","[]",5,0,5,1
5364,"['acordo', 'anteontem', 'anteontem', 'aumento', 'aumento', 'confirmado', 'confirmado', 'crescimento', 'crescimento', 'relacao', 'relacao', 'sigla', 'tambem', 'ultimo']","[1, 2, 2, 2, 2, 2, 2, 2, 2, 2, 2, 1, 1, 1]","[]","[]",14,0,14,1
5366,"['boletim', 'crise', 'destacar', 'importancia', 'infectar', 'intensivo', 'internar', 'observar', 'quedo', 'reducao']","[1, 1, 1, 1, 1, 1, 1, 1, 1, 1]","[]","[]",10,0,10,1
5367,"['anteontem', 'contrato', 'diretoria', 'duqu', 'duqu', 'duqu', 'duqu', 'esforco', 'exministro', 'funcionamento', 'investigacao', 'investigacao', 'lavagem', 'ministrar', 'nomeacao', 'nomeacao']","[1, 1, 1, 4, 4, 4, 4, 1, 1, 1, 2, 2, 1, 1, 2, 2]","['compartilhar']","[1]",16,1,17,1
5371,"['acumular', 'adhanom', 'saudar', 'saudar', 'tedro', 'tedro']","[1, 1, 2, 2, 2, 2]","[]","[]",6,0,6,1
5372,"['augusto', 'calamidad', 'investigacao', 'julgamento', 'jurista', 'jurista', 'justicar', 'legislativo', 'legislativo', 'republico', 'republico']","[1, 1, 1, 1, 2, 2, 1, 2, 2, 2, 2]","['fingir']","[1]",11,1,12,1
5377,"['alternativo', 'desempenhar', 'determinacao', 'funcionamento', 'instalacao', 'instalacao', 'rigoroso']","[1, 1, 1, 1, 2, 2, 1]","['usuario', 'verificacao', 'versao', 'versao']","[1, 1, 2, 2]",7,4,11,1
5381,"['autorizacao', 'carat', 'correspondent', 'destinar', 'especializar', 'pulmonar', 'pulmonar', 'reforcar', 'saudar', 'saudar', 'suportar', 'suportar', 'suportar', 'suspeito', 'temporario', 'ventilatorio', 'ventilatorio']","[1, 1, 1, 1, 1, 2, 2, 1, 2, 2, 3, 3, 3, 1, 1, 2, 2]","[]","[]",17,0,17,1
5383,"['acordo', 'andrew', 'aplicacao', 'aplicacao', 'desenvolvimento', 'embora', 'fase', 'fase', 'impacto', 'inclusao', 'parceria', 'proximo', 'sabado']","[1, 1, 2, 2, 1, 1, 2, 2, 1, 1, 1, 1, 1]","[]","[]",13,0,13,1
5385,"['apurar', 'arthur', 'inquerito', 'investigacao', 'metropolitano', 'regiao', 'regiao']","[1, 1, 1, 1, 1, 2, 2]","['catolico', 'fraudar', 'padrar', 'padrar', 'padrar', 'trafico']","[1, 1, 3, 3, 3, 1]",7,6,13,1
5392,"['distrito', 'dosar', 'esquema', 'fase', 'igualitario', 'instituto', 'necessario', 'operacionalizacao', 'pastar', 'pastar', 'periodo', 'planar', 'publicoalvo', 'remessar', 'saudar', 'saudar', 'vigilancia']","[1, 1, 1, 1, 1, 1, 1, 1, 2, 2, 1, 1, 1, 1, 2, 2, 1]","[]","[]",17,0,17,1
5394,"['adhanom', 'desenvolvimento', 'esforco', 'fronteiro', 'palacio', 'saudar', 'saudar', 'tedro', 'videoconferencia']","[1, 1, 1, 1, 1, 2, 2, 1, 1]","[]","[]",9,0,9,1
5395,"['associacao', 'ausencia', 'desafiar', 'destacar', 'equipamento', 'equivalent', 'estatistico', 'estatistico', 'extensao', 'flavio', 'impactar', 'importancia', 'internar', 'passageiro', 'preservar', 'quilometro', 'quilometro', 'reducao', 'taxar', 'trafego', 'velocidad', 'velocidad', 'vulneravel']","[1, 1, 1, 1, 1, 1, 2, 2, 1, 1, 1, 1, 1, 1, 1, 2, 2, 1, 1, 1, 2, 2, 1]","['humanar', 'motorista']","[1, 1]",23,2,25,1
5396,"['argumentar', 'cnmp', 'cnmp', 'deltan', 'deltan', 'forcatarefa', 'guaruja', 'instaurar', 'julgamento', 'prescricao', 'prescricao', 'prescricao', 'punicao', 'punicao', 'regrar', 'rejeitar', 'republico', 'triplex']","[1, 2, 2, 2, 2, 1, 1, 1, 1, 3, 3, 3, 2, 2, 1, 1, 1, 1]","['arquivar']","[1]",18,1,19,1
5397,"['contencao', 'europeu', 'europeu', 'infeccioso', 'letalidad', 'preocupacao', 'republico']","[1, 2, 2, 1, 1, 1, 1]","['realment']","[1]",7,1,8,1
5400,"['ambito', 'arrecadar', 'concedido', 'congresso', 'congresso', 'despesa', 'discussao', 'economia', 'economia', 'economia', 'economia', 'estimativo', 'estrategico', 'pastar', 'pastar', 'pratico', 'previsao', 'prioridad', 'proposto', 'saudar', 'situacao', 'tesourar']","[1, 1, 1, 2, 2, 1, 1, 4, 4, 4, 4, 1, 1, 2, 2, 1, 1, 1, 1, 1, 1, 1]","[]","[]",22,0,22,1
5402,"['capitar', 'folhar', 'integro', 'nogueira', 'testagem', 'vulneravel']","[1, 1, 1, 1, 1, 1]","['gravacao', 'legendar']","[1, 1]",6,2,8,1
5403,"['autoridad', 'californio', 'disseminacao', 'regiao', 'regiao', 'regrar', 'relaxar', 'situacao']","[1, 1, 1, 2, 2, 1, 1, 1]","[]","[]",8,0,8,1
5406,"['alteracao', 'deteccao', 'dificuldad', 'internacao', 'observar', 'respiratorio', 'respiratorio', 'respiratorio', 'saudar', 'sigla', 'triagem']","[1, 1, 1, 1, 1, 3, 3, 3, 1, 1, 1]","[]","[]",11,0,11,1
5407,"[]","[]","[]","[]",0,0,0,1
5408,"['conformar', 'congresso', 'destinar', 'emendar', 'emendar', 'emendar', 'recordar', 'superar', 'transferir', 'vespera', 'volumar']","[1, 1, 1, 3, 3, 3, 1, 1, 1, 1, 1]","[]","[]",11,0,11,1
5409,"['antecipar', 'autonomia', 'bandeirant', 'calendario', 'imunizacao', 'imunizacao', 'inicialment', 'palacio', 'pratico', 'previsto']","[1, 1, 1, 1, 2, 2, 1, 1, 1, 1]","[]","[]",10,0,10,1
5411,"['balancar', 'decisao', 'distrito', 'domingo', 'henriqu', 'justicar', 'previsao', 'quarentenar', 'reabertura', 'reabertura', 'rocha', 'saudar', 'saudar', 'saudar']","[1, 1, 1, 1, 1, 1, 1, 1, 2, 2, 1, 3, 3, 3]","[]","[]",14,0,14,1
5413,"['comorbidad', 'domingo', 'internar', 'republico', 'santiago', 'saudar']","[1, 1, 1, 1, 1, 1]","['disfarcar']","[1]",6,1,7,1
5414,"['atuacao', 'atuacao', 'cnmp', 'cnmp', 'concedido', 'decisao', 'deltan', 'desgastar', 'forcatarefa', 'guaruja', 'julgamento', 'julgamento', 'martim', 'prescricao', 'prescricao', 'punicao', 'punicao', 'punicao', 'punicao', 'reforcar', 'regrar', 'republico', 'triplex']","[2, 2, 2, 2, 1, 1, 1, 1, 1, 1, 2, 2, 1, 2, 2, 4, 4, 4, 4, 1, 1, 1, 1]","['imagem']","[1]",23,1,24,1
5415,"['aglomeracao', 'saudar', 'situacao']","[1, 1, 1]","[]","[]",3,0,3,1
5418,"['comissao', 'demandar', 'enfatizar', 'fornecimento', 'insuficient', 'lavagem', 'lavagem', 'regiao', 'regiao']","[1, 1, 1, 1, 1, 2, 2, 2, 2]","[]","[]",9,0,9,1
5419,"['deflagrar', 'fase', 'infectar', 'presidir', 'sabado']","[1, 1, 1, 1, 1]","['camiseta', 'verificar']","[1, 1]",5,2,7,1
5421,"['adulto', 'atrasar', 'atrasar', 'avancar', 'decisao', 'estagio', 'fase', 'insuficient', 'insuficient', 'saudar', 'trimestr']","[1, 2, 2, 1, 1, 1, 1, 2, 2, 1, 1]","[]","[]",11,0,11,1
5424,"['ausencia', 'ausencia', 'escalar', 'imunizacao', 'lancamento', 'operacionalizacao', 'planar', 'pslsp', 'publicitario', 'saudar']","[2, 2, 1, 1, 1, 1, 1, 1, 1, 1]","['ganhar', 'imagem']","[1, 1]",10,2,12,1
5426,"['converso', 'pslsp', 'respostar']","[1, 1, 1]","[]","[]",3,0,3,1
5427,"['client', 'gestant', 'pagamento']","[1, 1, 1]","['privacidad']","[1]",3,1,4,1
5430,"['associacao', 'ausencia', 'ausencia', 'cenario', 'cenario', 'cenario', 'cenario', 'cenario', 'cenario', 'consequencia', 'demandar', 'demandar', 'distant', 'entendimento', 'europeu', 'expansao', 'impactar', 'impactar', 'importancia', 'iniciativo', 'internar', 'lesao', 'ministrar', 'necessidad', 'necessidad', 'necessidad', 'orientacao', 'possibilidad', 'posturar', 'preocupacao', 'previsao', 'privar', 'privar', 'propagacao', 'pulmonar', 'pulmonar', 'recurso', 'redondo', 'regiao', 'respirador', 'respirador', 'respirador', 'respirador', 'respirador', 'respirador', 'respirador', 'respirador', 'respiratorio', 'respiratorio', 'saudar', 'saudar', 'saudar', 'saudar', 'saudar', 'saudar', 'saudar', 'saudar', 'situacao', 'situacao', 'suportar', 'taxar', 'tendencia', 'transmissao', 'treinamento', 'universitario']","[1, 2, 2, 6, 6, 6, 6, 6, 6, 1, 2, 2, 1, 1, 1, 1, 2, 2, 1, 1, 1, 1, 1, 3, 3, 3, 1, 1, 1, 1, 1, 2, 2, 1, 2, 2, 1, 1, 1, 8, 8, 8, 8, 8, 8, 8, 8, 2, 2, 8, 8, 8, 8, 8, 8, 8, 8, 2, 2, 1, 1, 1, 1, 1, 1]","[]","[]",65,0,65,1
5432,"['anvisa', 'anvisa', 'autoridad', 'autorizacao', 'autorizacao', 'contrato', 'demmg', 'enfrentamento', 'importacao', 'imunizacao', 'pacheco', 'precedent', 'previo', 'temporario', 'vigilancia']","[2, 2, 1, 2, 2, 1, 1, 1, 1, 1, 1, 1, 1, 1, 1]","[]","[]",15,0,15,1
5435,"['batalhar', 'decisao', 'dialogo', 'dialogo', 'dialogo', 'especifico', 'exjuiz', 'integrant', 'julgamento', 'lewandowski', 'ministrar', 'necessario', 'obtido', 'ricardo', 'supremo', 'supremo']","[1, 1, 3, 3, 3, 1, 1, 1, 1, 1, 1, 1, 1, 1, 2, 2]","['telegram']","[1]",16,1,17,1
5436,"['desafiar', 'primeiroministro', 'recordar']","[1, 1, 1]","[]","[]",3,0,3,1
5437,"['administrativo', 'pagamento', 'pagamento', 'previsto', 'previsto', 'taxar', 'taxar', 'taxar', 'transferencia']","[1, 2, 2, 2, 2, 3, 3, 3, 1]","[]","[]",9,0,9,1
5438,"['abordagem', 'atuam', 'coletivo', 'coletivo', 'cometido', 'presenca', 'relativo']","[1, 1, 2, 2, 1, 1, 1]","[]","[]",7,0,7,1
5439,"['afetado', 'aplicacao', 'atrasar', 'atrasar', 'contrato', 'excecao', 'pagamento', 'pagamento', 'parcelar', 'parcelar', 'relativo', 'suspenso', 'vencimento', 'vencimento', 'vencimento', 'vencimento']","[1, 1, 2, 2, 1, 1, 2, 2, 2, 2, 1, 1, 4, 4, 4, 4]","['ganhar', 'ganhar']","[2, 2]",16,2,18,1
5442,"['administrativo', 'alternativo', 'arrecadacao', 'articulacao', 'articulacao', 'congresso', 'congresso', 'contribuicao', 'dificultar', 'economia', 'economia', 'economia', 'economia', 'economia', 'federativo', 'gued', 'gued', 'gued', 'interlocutor', 'ministrar', 'ministrar', 'prioridad', 'proposto', 'proposto', 'quedo', 'regrar', 'situacao', 'tramitacao']","[1, 1, 1, 2, 2, 2, 2, 1, 1, 5, 5, 5, 5, 5, 1, 3, 3, 3, 1, 2, 2, 1, 2, 2, 1, 1, 1, 1]","[]","[]",28,0,28,1
5443,"['alvorar', 'avancar', 'equipamento', 'importancia', 'palacio']","[1, 1, 1, 1, 1]","[]","[]",5,0,5,1
5444,"['converso', 'equipamento', 'parcelar', 'posturar', 'quarentenar', 'regrar', 'respirador', 'situacao', 'taxar', 'tucano']","[1, 1, 1, 1, 1, 1, 1, 1, 1, 1]","[]","[]",10,0,10,1
5448,"['acordo', 'colombio', 'crescimento', 'duqu', 'duqu', 'especialment', 'fronteiro', 'fronteiro', 'fronteiro', 'fronteiro', 'implementar', 'monitoramento', 'presenca', 'saudar']","[1, 1, 1, 2, 2, 1, 4, 4, 4, 4, 1, 1, 1, 1]","[]","[]",14,0,14,1
5450,"['exministro', 'henriqu', 'precandidato']","[1, 1, 1]","[]","[]",3,0,3,1
5453,"['ampliacao', 'articulacao', 'atuacao', 'atuacao', 'atuacao', 'companhia', 'desenvolvimento', 'desenvolvimento', 'desenvolvimento', 'distrito', 'roraima']","[1, 1, 3, 3, 3, 1, 3, 3, 3, 1, 1]","[]","[]",11,0,11,1
5456,"['belgica', 'belgica', 'dosar', 'europeu', 'respectivament']","[2, 2, 1, 1, 1]","[]","[]",5,0,5,1
5458,"['isolar', 'oficialment', 'regiao', 'saudar', 'saudar', 'saudar', 'viagem', 'viagem']","[1, 1, 1, 3, 3, 3, 2, 2]","[]","[]",8,0,8,1
5460,"['balancar', 'reuniao']","[1, 1]","['versao']","[1]",2,1,3,1
5461,"['boletim', 'calendario', 'periodo', 'prioritario', 'suspeito']","[1, 1, 1, 1, 1]","[]","[]",5,0,5,1
5464,"['adicionar', 'adicionar', 'flexibilizacao', 'infectar', 'mexico', 'observar', 'preocupacao', 'regiao', 'sabado', 'sabado', 'surtir']","[2, 2, 1, 1, 1, 1, 1, 1, 2, 2, 1]","[]","[]",11,0,11,1
5469,"[]","[]","[]","[]",0,0,0,1
5472,"['alternativo', 'aprovacao', 'perspectivo', 'rejeicao']","[1, 1, 1, 1]","[]","[]",4,0,4,1
5473,"['conformar', 'sudest']","[1, 1]","['arvor']","[1]",2,1,3,1
5474,"['acordo', 'assistencia', 'fabricacao', 'normalment', 'serao', 'serao', 'tambem']","[1, 1, 1, 1, 2, 2, 1]","[]","[]",7,0,7,1
5479,"['ampliacao', 'avancar', 'avancar', 'avancar', 'broadcast', 'demrj', 'despesa', 'emendar', 'entendimento', 'possibilidad', 'previsto', 'prioridad', 'resistencia', 'tesourar', 'tramitacao']","[1, 3, 3, 3, 1, 1, 1, 1, 1, 1, 1, 1, 1, 1, 1]","[]","[]",15,0,15,1
5481,"['folhar', 'integro']","[1, 1]","[]","[]",2,0,2,1
5482,"['academiar', 'academiar', 'crise', 'crise', 'escassez', 'estatistico', 'reforcar', 'situacao', 'suspeito']","[2, 2, 2, 2, 1, 1, 1, 1, 1]","[]","[]",9,0,9,1
5486,"['alternativo', 'anteriorment', 'condicao', 'conformar', 'consumidor', 'consumidor', 'deteccao', 'elaborar', 'espirito', 'fabricacao', 'inedito', 'instalacao', 'isolar', 'lesao', 'pastar', 'possibilidad', 'pratico', 'presenca', 'presenca', 'risco', 'risco', 'risco', 'suspenso', 'totalizar']","[1, 1, 1, 1, 2, 2, 1, 1, 1, 1, 1, 1, 1, 1, 1, 1, 1, 2, 2, 3, 3, 3, 1, 1]","['falsar']","[1]",24,1,25,1
5487,"['ambientar', 'rocha', 'saudar']","[1, 1, 1]","[]","[]",3,0,3,1
5490,"['adotada', 'calendario', 'enfatizar', 'fase', 'flexibilizacao', 'infectar', 'internar', 'planar', 'planar', 'planar', 'possibilidad', 'previsao', 'previsto', 'primeiroministro', 'reabertura', 'reabertura', 'reabertura', 'realizacao', 'saudar']","[1, 1, 1, 1, 1, 1, 1, 3, 3, 3, 1, 1, 1, 1, 3, 3, 3, 1, 1]","['boatar']","[1]",19,1,20,1
5493,"['acompanhamento', 'diagnosticar', 'domingo', 'internacao', 'internar', 'martim', 'positivar', 'pslsp', 'reuniao', 'situacao', 'vieira', 'vieira', 'vieira']","[1, 1, 1, 1, 1, 1, 1, 1, 1, 1, 3, 3, 3]","[]","[]",13,0,13,1
5495,"['acumular', 'advocaciager', 'curvo', 'decisao', 'decisao', 'infectar', 'ministrar', 'ministrar', 'necessario', 'prazo', 'regiao', 'saudar', 'saudar', 'saudar', 'supremo', 'sustentabilidad']","[1, 1, 1, 2, 2, 1, 2, 2, 1, 1, 1, 3, 3, 3, 1, 1]","[]","[]",16,0,16,1
5496,"['infectar', 'infectar', 'negativar', 'positivar', 'positivar']","[2, 2, 1, 2, 2]","[]","[]",5,0,5,1
5498,"['desenvolvido', 'interferencia', 'investigacao', 'justicar', 'justicar', 'pratico', 'republicanosrj', 'vieira']","[1, 1, 1, 2, 2, 1, 1, 1]","[]","[]",8,0,8,1
5499,"['florido', 'trimestr']","[1, 1]","[]","[]",2,0,2,1
5500,"['adotada', 'antonio', 'economia', 'estrategia', 'fase', 'planar', 'pratico', 'presenca', 'primeiroministro', 'reabertura', 'suspenso']","[1, 1, 1, 1, 1, 1, 1, 1, 1, 1, 1]","[]","[]",11,0,11,1
5501,"['complicacao', 'determinacao', 'prioritario', 'publicoalvo', 'publicoalvo', 'saudar', 'saudar']","[1, 1, 1, 2, 2, 2, 2]","['circular']","[1]",7,1,8,1
5503,"['crise']","[1]","[]","[]",1,0,1,1
5504,"['ambientar', 'contabilizar', 'crescimento', 'implementar', 'periodo', 'possibilidad', 'quarentenar', 'reforcar']","[1, 1, 1, 1, 1, 1, 1, 1]","['basto', 'botao', 'botao', 'clicar']","[1, 2, 2, 1]",8,4,12,1
5505,"['arthur', 'flavio', 'integrant', 'rachadinha', 'rachadinha', 'regiao', 'suspeito']","[1, 1, 1, 2, 2, 1, 1]","['expulsar']","[1]",7,1,8,1
5506,"['atendido', 'celebrar', 'despesa', 'levantamento', 'pagamento', 'reclamacao', 'recurso', 'respostar', 'situacao']","[1, 1, 1, 1, 1, 1, 1, 1, 1]","[]","[]",9,0,9,1
5508,"['anteontem', 'boletim', 'complicacao', 'conformar', 'contabilizar', 'estatistico', 'pastar', 'regiao', 'saudar', 'suspeito', 'suspeito', 'suspeito', 'suspeito']","[1, 1, 1, 1, 1, 1, 1, 1, 1, 4, 4, 4, 4]","['imagem']","[1]",13,1,14,1
5509,"['condicao', 'crise', 'deslocamento', 'espanha', 'fase', 'flexibilizar', 'funcao', 'milho', 'monitoramento', 'plano', 'primeiroministro', 'reabertura', 'reabertura', 'regiao']","[1, 1, 1, 1, 1, 1, 1, 1, 1, 1, 1, 2, 2, 1]","[]","[]",14,0,14,1
5510,"['entregu', 'fundacao', 'imunizacao', 'instituto', 'oswaldo', 'prever', 'prever', 'previsao', 'saudar']","[1, 1, 1, 1, 1, 2, 2, 1, 1]","[]","[]",9,0,9,1
5511,"['adicionar', 'aprovacao', 'autorizacao', 'autorizacao', 'conformar', 'converso', 'destinar', 'entendimento', 'europeu', 'europeu', 'fase', 'fornecimento', 'fornecimento', 'possibilidad', 'preliminar', 'previo', 'prioridad', 'proposto', 'saudar']","[1, 1, 2, 2, 1, 1, 1, 1, 2, 2, 1, 2, 2, 1, 1, 1, 1, 1, 1]","[]","[]",19,0,19,1
5513,"['adotada', 'bolsonarista', 'folhar', 'integro', 'supremo']","[1, 1, 1, 1, 1]","['agredir', 'protestar']","[1, 1]",5,2,7,1
5516,"['batalhar', 'facilitar', 'mutacao', 'possibilidad', 'prever', 'velocidad']","[1, 1, 1, 1, 1, 1]","[]","[]",6,0,6,1
5517,"['alerj', 'esquema', 'fabricio', 'flavio', 'flavio', 'fluminens', 'investigacao', 'legislativo', 'queiroz', 'queiroz', 'queiroz', 'queiroz', 'queiroz', 'rachadinha', 'republicanosrj']","[1, 1, 1, 2, 2, 1, 1, 1, 5, 5, 5, 5, 5, 1, 1]","['filmar', 'imagem']","[1, 1]",15,2,17,1
5519,"['antonio', 'anvisa', 'anvisa', 'autorizacao', 'carat', 'comportamento', 'comportamento', 'consorcio', 'fundacao', 'instituto', 'mudanca', 'oswaldo', 'parceiro', 'parceria', 'requerimento', 'reuniao', 'reuniao', 'vigilancia']","[1, 2, 2, 1, 1, 2, 2, 1, 1, 1, 1, 1, 1, 1, 1, 2, 2, 1]","[]","[]",18,0,18,1
5523,"['demandar', 'demandar', 'demandar', 'estimular', 'exportacao', 'importacao', 'justificativo', 'reducao', 'reducao', 'variacao']","[3, 3, 3, 1, 1, 1, 1, 2, 2, 1]","[]","[]",10,0,10,1
5525,"['acordo', 'consorcio', 'entregu', 'instituto', 'pastar', 'pastar', 'prever', 'prever', 'saudar', 'sputnik']","[1, 1, 1, 1, 2, 2, 2, 2, 1, 1]","[]","[]",10,0,10,1
5528,"['correspondent', 'crise', 'cronica', 'epicentro', 'situacao']","[1, 1, 1, 1, 1]","['imagem', 'intitular', 'legendar', 'parir', 'parir']","[1, 1, 1, 2, 2]",5,5,10,1
5529,"['bandeirant', 'crescimento', 'definitivo', 'fase', 'flexibilizacao', 'indicador', 'internacao', 'palacio', 'planar', 'planar', 'quedo', 'quedo', 'relativo', 'restritivo', 'saudar', 'subir']","[1, 1, 1, 1, 1, 1, 1, 1, 2, 2, 2, 2, 1, 1, 1, 1]","[]","[]",16,0,16,1
5531,"['autoridad', 'margem', 'rotina']","[1, 1, 1]","[]","[]",3,0,3,1
5532,"['anvisa', 'instituto', 'milho', 'pedido', 'sendo', 'serao', 'sigla', 'sputnik', 'trimestr', 'vigilancia']","[1, 1, 1, 1, 1, 1, 1, 1, 1, 1]","[]","[]",10,0,10,1
5533,"['adicionar', 'agravar', 'anteriorment', 'biliao', 'biliao', 'biliao', 'desigualdad', 'impactar', 'realizacao', 'regrar', 'tendencia']","[1, 1, 1, 3, 3, 3, 1, 1, 1, 1, 1]","['sacar']","[1]",11,1,12,1
5535,"['agravar', 'assistencia', 'contrato', 'crise', 'quarentenar', 'situacao', 'situacao']","[1, 1, 1, 1, 1, 2, 2]","[]","[]",7,0,7,1
5536,"['autorizacao', 'consorcio', 'converso', 'decisao', 'dificultar', 'escassez', 'flavio', 'iniciativo', 'prazo', 'recurso', 'reuniao', 'reuter', 'saudar', 'supremo']","[1, 1, 1, 1, 1, 1, 1, 1, 1, 1, 1, 1, 1, 1]","[]","[]",14,0,14,1
5537,"['colegiado', 'comissao', 'coordenar', 'economia', 'enfrentamento', 'justificativo', 'regiao', 'relativo', 'requerimento', 'wellington']","[1, 1, 1, 1, 1, 1, 1, 1, 1, 1]","['incendio', 'incendio']","[2, 2]",10,2,12,1
5539,"['exministro', 'exministro', 'integro', 'saudar', 'saudar']","[2, 2, 1, 2, 2]","[]","[]",5,0,5,1
5540,"['associacao', 'celebrar', 'decisao', 'suspensao', 'temporada', 'tornear']","[1, 1, 1, 1, 1, 1]","[]","[]",6,0,6,1
5543,"[]","[]","[]","[]",0,0,0,1
5544,"['assistencia', 'avancar', 'avancar', 'biliao', 'broadcast', 'crise', 'dedicar', 'economia', 'economia', 'economia', 'gued', 'impacto', 'iniciativo', 'ministrar', 'montant', 'oficio', 'pastar', 'pastar', 'prioridad', 'prioridad', 'respostar', 'saudar', 'situacao']","[1, 2, 2, 1, 1, 1, 1, 3, 3, 3, 1, 1, 1, 1, 1, 1, 2, 2, 2, 2, 1, 1, 1]","[]","[]",23,0,23,1
5545,"['alerj', 'comissao', 'comissao', 'comissao', 'comissao', 'comissao', 'conjuntar', 'contrato', 'discussao', 'emendar', 'esquema', 'inquerito', 'instalacao', 'integrant', 'investigacao', 'irregularidad', 'legislativo', 'mudanca', 'orcamentaria', 'plenario', 'prazo', 'proposto', 'proposto', 'proposto', 'recurso', 'saudar', 'saudar', 'sugestao']","[1, 5, 5, 5, 5, 5, 1, 1, 1, 1, 1, 1, 1, 1, 1, 1, 1, 1, 1, 1, 1, 3, 3, 3, 1, 2, 2, 1]","['versao']","[1]",28,1,29,1
5546,"['habitant', 'indicador', 'taxar']","[1, 1, 1]","[]","[]",3,0,3,1
5547,"['desenvolvido', 'entregu', 'especifico', 'genoma', 'genoma', 'genoma', 'infeccioso', 'molecular']","[1, 1, 1, 3, 3, 3, 1, 1]","['replicar']","[1]",8,1,9,1
5548,"['cenario', 'destinar', 'distrito', 'epidemiologico', 'estrategico', 'estrategico', 'fase', 'fase', 'igualitario', 'imunizacao', 'instituto', 'instituto', 'operacionalizacao', 'planar', 'publicoalvo', 'regiao', 'saudar']","[1, 1, 1, 1, 2, 2, 2, 2, 1, 1, 2, 2, 1, 1, 1, 1, 1]","[]","[]",17,0,17,1
5551,"['instituto', 'patamar', 'recordar', 'situacao']","[1, 1, 1, 1]","[]","[]",4,0,4,1
5552,"['colunista', 'congresso', 'decisao', 'manutencao', 'necessario', 'silveiro', 'supremo']","[1, 1, 1, 1, 1, 1, 1]","['invadir']","[1]",7,1,8,1
5554,"['conformar', 'distrito', 'funcionamento', 'negativar', 'positivar', 'saudar', 'saudar', 'saudar', 'saudar', 'suspeito', 'suspeito', 'suspeito']","[1, 1, 1, 1, 1, 4, 4, 4, 4, 3, 3, 3]","['circular', 'imagem']","[1, 1]",12,2,14,1
5555,"['alcolumbr', 'ausencia', 'demap', 'demmg', 'destacar', 'pacheco', 'pacheco', 'pacheco', 'saudar']","[1, 1, 1, 1, 1, 3, 3, 3, 1]","['cedula', 'wagner']","[1, 1]",9,2,11,1
5556,"['destinar', 'exportacao', 'fabricacao', 'federar', 'pagamento', 'possibilidad', 'previsto', 'prorrogacao', 'provisorio', 'provisorio', 'provisorio', 'sancao', 'suspensao', 'suspensao']","[1, 1, 1, 1, 1, 1, 1, 1, 3, 3, 3, 1, 2, 2]","[]","[]",14,0,14,1
5559,"['conflito', 'exercicio', 'henriqu', 'itamar', 'ministrar', 'necessario', 'planalto', 'planar', 'planar', 'privatizacao']","[1, 1, 1, 1, 1, 1, 1, 2, 2, 1]","['rompimento']","[1]",10,1,11,1
5560,"['bolsonarista', 'exministro', 'folhar', 'iniciativo', 'ministrar', 'saudar', 'saudar']","[1, 1, 1, 1, 1, 2, 2]","[]","[]",7,0,7,1
5562,"['complicacao', 'privar']","[1, 1]","[]","[]",2,0,2,1
5567,"['cenario', 'estimular', 'estimular', 'europeu', 'europeu', 'fase', 'normalidad', 'treinar']","[1, 2, 2, 2, 2, 1, 1, 1]","['basto']","[1]",8,1,9,1
5568,"['autoridad', 'diagnosticar', 'disseminacao', 'epicentro', 'hubei', 'inglaterra', 'normalment', 'provincia', 'provincia', 'regiao', 'saudar', 'saudar', 'saudar']","[1, 1, 1, 1, 1, 1, 1, 2, 2, 1, 3, 3, 3]","[]","[]",13,0,13,1
5573,"['apostar', 'competicao', 'converso', 'fluminens', 'medeiro', 'normalment', 'previsao', 'proposto', 'quadro']","[1, 1, 1, 1, 1, 1, 1, 1, 1]","['gravacao']","[1]",9,1,10,1
5574,"['coordenar', 'desempenhar', 'estrategia', 'estrategico', 'fronteiro', 'gripezinha', 'henriqu', 'mantido', 'ministrar', 'normalidad', 'preparacao', 'preservar', 'quarentenar', 'rotina', 'saudar', 'saudar']","[1, 1, 1, 1, 1, 1, 1, 1, 1, 1, 1, 1, 1, 1, 2, 2]","['espalhar']","[1]",16,1,17,1
5575,"['campino', 'concessionario', 'concessionario', 'coreia', 'desembarcar', 'enfatizar', 'equipamento', 'instituto', 'necessario', 'respiratorio', 'suprimento']","[1, 2, 2, 1, 1, 1, 1, 1, 1, 1, 1]","[]","[]",11,0,11,1
5576,"['acumular', 'quarentenar']","[1, 1]","['incendio', 'incendio']","[2, 2]",2,2,4,1
5580,"['anuncio', 'comissao', 'europeu', 'europeu']","[1, 1, 2, 2]","['compartilhar']","[1]",4,1,5,1
5583,"['colegio']","[1]","[]","[]",1,0,1,1
5584,"['autoridad', 'autoridad', 'constituicao', 'domingo', 'funcao', 'jurista', 'jurista', 'lancamento', 'rigoroso', 'sabado', 'supremo', 'supremo']","[2, 2, 1, 1, 1, 2, 2, 1, 1, 1, 2, 2]","[]","[]",12,0,12,1
5587,"['antonio', 'apurar', 'apurar', 'colaboracao', 'contrato', 'decisao', 'deflagrar', 'exministro', 'exministro', 'investigacao', 'investigacao', 'justicar', 'justicar', 'justicar', 'lavagem', 'ministrar', 'ministrar', 'paralisar', 'paralisar', 'rocha', 'rocha', 'rocha', 'rocha', 'rocha', 'suspenso']","[1, 2, 2, 1, 1, 1, 1, 2, 2, 2, 2, 3, 3, 3, 1, 2, 2, 2, 2, 5, 5, 5, 5, 5, 1]","['fraudar']","[1]",25,1,26,1
5588,"['aurelio', 'aurelio', 'julgamento', 'manutencao', 'manutencao', 'mello', 'mello', 'mello', 'pslrj', 'sessao', 'supremo', 'unanimidad']","[2, 2, 1, 2, 2, 3, 3, 3, 1, 1, 1, 1]","[]","[]",12,0,12,1
5589,"['apurar', 'apurar', 'desenvolvimento', 'equipamento', 'nogueira', 'respostar']","[2, 2, 1, 1, 1, 1]","['barragem', 'barragem', 'barragem', 'checagem', 'compartilhar', 'imagem', 'imagem', 'postagen', 'postagen', 'rompimento', 'transposicao', 'verificar']","[3, 3, 3, 1, 1, 2, 2, 2, 2, 1, 1, 1]",6,12,18,1
5590,"['florido', 'gabinet']","[1, 1]","['agredir', 'agredir', 'supostament']","[2, 2, 1]",2,3,5,1
5591,"['alteracao', 'calamidad', 'calamidad', 'decorrent', 'economia', 'economia', 'espanha', 'juro', 'juro', 'juro', 'juro', 'juro', 'limitacao', 'limitacao', 'martim', 'monetario', 'patamar', 'periodo', 'proposto', 'proposto', 'regulamentar', 'sancao', 'taxar', 'taxar']","[1, 2, 2, 1, 2, 2, 1, 5, 5, 5, 5, 5, 2, 2, 1, 1, 1, 1, 2, 2, 1, 1, 2, 2]","['checar', 'checar']","[2, 2]",24,2,26,1
5593,"['adulto', 'anuncio', 'autonomia', 'autorizacao', 'cenario', 'decorrencia', 'enfrentamento', 'espirito', 'intensivo', 'necessario', 'recurso', 'reforcar', 'saudar']","[1, 1, 1, 1, 1, 1, 1, 1, 1, 1, 1, 1, 1]","[]","[]",13,0,13,1
5594,"['advocaciager', 'condenacao', 'destinar', 'edson', 'equipamento', 'exministro', 'fachin', 'ministrar', 'ministrar', 'possibilidad', 'prazo', 'proposto', 'recurso', 'republico', 'supremo', 'vieira', 'vieira']","[1, 1, 1, 1, 1, 1, 1, 2, 2, 1, 1, 1, 1, 1, 1, 2, 2]","['imagem']","[1]",17,1,18,1
5596,"['carla', 'carla', 'carla', 'diminuicao', 'imunizacao', 'planar', 'reforcar']","[3, 3, 3, 1, 1, 1, 1]","[]","[]",7,0,7,1
5598,"['administrativo', 'associacao', 'atuacao', 'augusto', 'autonomia', 'cnmp', 'cnmp', 'consenso', 'destinar', 'proposto', 'rejeitar', 'republico', 'sessao']","[1, 1, 1, 1, 1, 2, 2, 1, 1, 1, 1, 1, 1]","['supostament']","[1]",13,1,14,1
5600,"['crise', 'economia', 'manutencao', 'penso', 'situacao', 'tambem']","[1, 1, 1, 1, 1, 1]","[]","[]",6,0,6,1
5601,"['globonew', 'investigacao', 'suspeito']","[1, 1, 1]","['compartilhar']","[1]",3,1,4,1
5602,"['gripezinha', 'gripezinha', 'passageiro', 'transmissao']","[2, 2, 1, 1]","['circular']","[1]",4,1,5,1
5603,"['alerj', 'alerj', 'comissao', 'comissao', 'comissao', 'decisao', 'decisao', 'fux', 'integrant', 'legislativo', 'mantido', 'ministrar', 'palacio', 'permanencia', 'prazo', 'prazo', 'recurso', 'sessao', 'supremo', 'wilson', 'witzel', 'witzel', 'witzel']","[2, 2, 3, 3, 3, 2, 2, 1, 1, 1, 1, 1, 1, 1, 2, 2, 1, 1, 1, 1, 3, 3, 3]","['ganhar']","[1]",23,1,24,1
5604,"['alvorar', 'antecipar', 'broadcast', 'colunista', 'conformar', 'decisao', 'domingo', 'economia', 'gued', 'gued', 'gued', 'ministrar', 'palacio']","[1, 1, 1, 1, 1, 1, 1, 1, 3, 3, 3, 1, 1]","[]","[]",13,0,13,1
5605,"['anvisa', 'aprovacao', 'autoridad', 'autoridad', 'desenvolvimento', 'diretoria', 'necessario', 'presenca', 'saneamento', 'servidor', 'sessao', 'vigilancia']","[1, 1, 2, 2, 1, 1, 1, 1, 1, 1, 1, 1]","['secreto']","[1]",12,1,13,1
5610,"['anvisa', 'calendario', 'flavio', 'imunizacao', 'iniciativo', 'instituto', 'instituto', 'ministrar', 'ministrar', 'parceria', 'planar', 'reuniao', 'reuniao', 'reuter', 'saudar', 'saudar', 'saudar', 'saudar', 'vigilancia']","[1, 1, 1, 1, 1, 2, 2, 2, 2, 1, 1, 2, 2, 1, 4, 4, 4, 4, 1]","[]","[]",19,0,19,1
5611,"['confederacao', 'desenvolvimento', 'economia', 'especialment', 'exercicio', 'federar', 'federar', 'federar', 'mudanca', 'orcamentaria', 'prazo', 'prazo', 'prazo', 'recurso', 'relativo', 'saudar', 'saudar', 'saudar', 'saudar', 'saudar', 'saudar', 'situacao', 'situacao', 'suspensao', 'transferencia', 'transferencia']","[1, 1, 1, 1, 1, 3, 3, 3, 1, 1, 3, 3, 3, 1, 1, 6, 6, 6, 6, 6, 6, 2, 2, 1, 2, 2]","[]","[]",26,0,26,1
5613,"['aglomeracao', 'etapa', 'expansao', 'expectativa', 'facilitar', 'facilitar', 'reconhecimento', 'recurso']","[1, 1, 1, 1, 2, 2, 1, 1]","['ganhar']","[1]",8,1,9,1
5617,"['ausencia', 'colegio', 'inicialment', 'minimizar', 'presenca', 'prever']","[1, 1, 1, 1, 1, 1]","[]","[]",6,0,6,1
5619,"['anvisa', 'aprovacao', 'desenvolvido', 'etapa', 'imunizacao', 'instituto', 'saudar', 'saudar', 'saudar', 'sputnik', 'sputnik', 'vigilancia', 'vigilancia']","[1, 1, 1, 1, 1, 1, 3, 3, 3, 2, 2, 2, 2]","[]","[]",13,0,13,1
5622,"['expressivo', 'normalment', 'plano', 'reajust', 'reajustar', 'reflexo', 'saudar', 'subir']","[1, 1, 1, 1, 1, 1, 1, 1]","[]","[]",8,0,8,1
5624,"['afp', 'avancar', 'bruto', 'destacar', 'destinar', 'estrategia', 'exportacao', 'extensao', 'fronteiro', 'normalment', 'parceiro']","[1, 1, 1, 1, 1, 1, 1, 1, 1, 1, 1]","['compartilhar']","[1]",11,1,12,1
5625,"['planar']","[1]","['ideologia']","[1]",1,1,2,1
5626,"['espanha', 'funcao', 'saudad', 'saudar', 'suportar']","[1, 1, 1, 1, 1]","['imagem', 'invadir']","[1, 1]",5,2,7,1
5627,"['californio', 'equipamento', 'iniciativo']","[1, 1, 1]","['imagem']","[1]",3,1,4,1
5628,"['administrativo', 'arthur', 'desvio', 'esquema', 'esquema', 'improbidad', 'investigacao', 'justicar', 'justicar', 'legislativo', 'lira', 'lira', 'pagamento', 'palacio', 'planalto', 'rachadinha', 'republico', 'sigla', 'tramitar']","[1, 1, 1, 2, 2, 1, 1, 2, 2, 1, 2, 2, 1, 1, 1, 1, 1, 1, 1]","[]","[]",19,0,19,1
5632,"['ampliacao', 'destinar', 'discussao', 'pagamento', 'pagamento', 'prazo', 'proposto', 'proposto', 'proposto', 'recuperacao', 'recurso', 'supremo']","[1, 1, 1, 2, 2, 1, 3, 3, 3, 1, 1, 1]","[]","[]",12,0,12,1
5635,"['crise', 'crise', 'funcionamento', 'informaco', 'none', 'randolf', 'recurso', 'regiao', 'risco', 'transferencia']","[2, 2, 1, 1, 1, 1, 1, 1, 1, 1]","[]","[]",10,0,10,1
5638,"['administrativo', 'correspondent', 'itamarati', 'itamarati', 'itamarati']","[1, 1, 3, 3, 3]","['amplament', 'venezuelano']","[1, 1]",5,2,7,1
5640,"['anuncio', 'decisao', 'deltan', 'deltan', 'fase', 'forcatarefa', 'forcatarefa', 'importancia', 'ministrar', 'necessidad', 'obtido', 'prioridad', 'prioridad', 'processo', 'substituto', 'supremo', 'varar']","[1, 1, 2, 2, 1, 2, 2, 1, 1, 1, 1, 2, 2, 1, 1, 1, 1]","[]","[]",17,0,17,1
5644,"['adulto', 'autonomia', 'autorizacao', 'carat', 'demandar', 'distrito', 'enfrentamento', 'infraestrutura', 'necessario', 'pastar', 'reforcar', 'saudar', 'saudar', 'temporario']","[1, 1, 1, 1, 1, 1, 1, 1, 1, 1, 1, 2, 2, 1]","[]","[]",14,0,14,1
5645,"['congresso', 'desenvolvimento', 'destinar', 'impacto', 'minimizar', 'montant', 'proliferacao', 'provisorio', 'provisorio', 'publicitario', 'regrar']","[1, 1, 1, 1, 1, 1, 1, 2, 2, 1, 1]","[]","[]",11,0,11,1
5648,"['afetado', 'contabiliza', 'epicentro', 'respectivament']","[1, 1, 1, 1]","[]","[]",4,0,4,1
5649,"['alcolumbr', 'ambito', 'decorrent', 'diagnosticar', 'enfrentamento', 'funcao', 'importancia', 'justicar', 'justicar', 'justicar', 'necessario', 'saudar']","[1, 1, 1, 1, 1, 1, 1, 3, 3, 3, 1, 1]","[]","[]",12,0,12,1
5651,"['afetado', 'desafio', 'domingo', 'ultimo', 'ultimo']","[1, 1, 1, 2, 2]","[]","[]",5,0,5,1
5655,"['arthur', 'gabinet', 'lira', 'lira', 'plenario', 'transferir']","[1, 1, 2, 2, 1, 1]","['disfarcar']","[1]",6,1,7,1
5656,"['biliao', 'biliao', 'biliao', 'comprometido', 'crise', 'demandar', 'demandar', 'demrj', 'emprestimo', 'emprestimo', 'expectativa', 'folhar', 'funcao', 'pagamento']","[3, 3, 3, 1, 1, 2, 2, 1, 2, 2, 1, 1, 1, 1]","[]","[]",14,0,14,1
5657,"['aurelio', 'aurelio', 'decisao', 'destacar', 'federar', 'inquerito', 'mello', 'mello', 'ministrar', 'ministrar', 'ministrar', 'posturar', 'supremo']","[2, 2, 1, 1, 1, 1, 2, 2, 3, 3, 3, 1, 1]","[]","[]",13,0,13,1
5659,"['assistenci', 'biliao', 'congresso', 'decisao', 'demrj', 'desenvolvimento', 'desgastar', 'economia', 'emendar', 'estrategia', 'eventualment', 'fundeb', 'governista', 'impactar', 'impactar', 'manutencao', 'pagamento', 'parcelar', 'possibilidad', 'possibilidad', 'prazo', 'prorrogacao', 'prorrogacao', 'prorrogacao', 'prorrogacao', 'prorrogar', 'reajustar', 'reajustar', 'recurso', 'recurso', 'recurso', 'ricardo', 'servidor', 'servidor', 'urbano', 'vetar', 'vetar']","[1, 1, 1, 1, 1, 1, 1, 1, 1, 1, 1, 1, 1, 2, 2, 1, 1, 1, 2, 2, 1, 4, 4, 4, 4, 1, 2, 2, 3, 3, 3, 1, 2, 2, 1, 2, 2]","[]","[]",37,0,37,1
5661,"['augusto', 'avancar', 'condenacao', 'condenacao', 'desafiar', 'extensao', 'republico', 'sentenca', 'sentenca', 'tucano']","[1, 1, 2, 2, 1, 1, 1, 2, 2, 1]","['verificar', 'verificar']","[2, 2]",10,2,12,1
5665,"['biliao', 'cerimonia', 'machadar', 'ministrar', 'provisorio']","[1, 1, 1, 1, 1]","[]","[]",5,0,5,1
5667,"['associacao', 'bbc', 'bbc', 'condicao', 'contencao', 'contrato', 'enfrentamento', 'exigencia', 'obtido', 'presidir', 'previsao', 'previsto', 'reforcar', 'saudar']","[1, 2, 2, 1, 1, 1, 1, 1, 1, 1, 1, 1, 1, 1]","['imenso']","[1]",14,1,15,1
5668,"['especialment', 'preocupacao', 'preocupacao', 'transmissao']","[1, 2, 2, 1]","['gravacao']","[1]",4,1,5,1
5669,"['atuacao', 'crise', 'embora', 'informaco', 'milho', 'milho', 'porqu', 'previsto', 'resultado', 'sendo']","[1, 1, 1, 1, 2, 2, 1, 1, 1, 1]","['imagem']","[1]",10,1,11,1
5672,"['avancar', 'coletivo', 'conjuntar', 'desigualdad', 'diariament', 'dificuldad', 'necessidad', 'parcelar', 'preocupacao', 'santiago', 'santiago']","[1, 1, 1, 1, 1, 1, 1, 1, 1, 2, 2]","['amplament']","[1]",11,1,12,1
5675,"['comissao', 'decisao', 'decisao', 'elaborar', 'estrategico', 'folhar', 'globonew', 'justicar', 'mendonca', 'ministrar', 'pastar', 'planar', 'provisorio']","[1, 2, 2, 1, 1, 1, 1, 1, 1, 1, 1, 1, 1]","[]","[]",13,0,13,1
5676,"['batalhar', 'decisao', 'necessario', 'prorrogar', 'taxar']","[1, 1, 1, 1, 1]","[]","[]",5,0,5,1
5678,"['autoridad', 'autoridad', 'biliao', 'companhia', 'companhia', 'desafiar', 'destacar', 'destacar', 'diagnosticar', 'domingo', 'fronteiro', 'infectar', 'infectar', 'kong', 'kong', 'kong', 'passageiro', 'passageiro', 'passageiro', 'reabrir', 'ritmar', 'saudar', 'voo', 'voo']","[2, 2, 1, 2, 2, 1, 2, 2, 1, 1, 1, 2, 2, 3, 3, 3, 3, 3, 3, 1, 1, 1, 2, 2]","['amplament', 'dubai']","[1, 1]",24,2,26,1
5679,"['colegiado', 'conselho', 'conselho', 'processo', 'pslrj', 'relacao']","[1, 2, 2, 1, 1, 1]","[]","[]",6,0,6,1
5680,"['diminuicao', 'domingo', 'estabilidad', 'globonew', 'positivar', 'quedo', 'recordar']","[1, 1, 1, 1, 1, 1, 1]","[]","[]",7,0,7,1
5681,"['acumular', 'crise', 'investigacao', 'saudar', 'surtir']","[1, 1, 1, 1, 1]","[]","[]",5,0,5,1
5687,"['bruno', 'domingo', 'espirito', 'estimativo', 'fabricio', 'levantamento', 'patamar', 'queiroz', 'respostar', 'suspeito', 'volumar']","[1, 1, 1, 1, 1, 1, 1, 1, 1, 1, 1]","['agredir', 'espalhar', 'replicar', 'replicar', 'safar']","[1, 1, 2, 2, 1]",11,5,16,1
5692,"['dengu', 'positivar', 'surto']","[1, 1, 1]","[]","[]",3,0,3,1
5694,"['cenario', 'incerteza', 'internar', 'prioritario', 'quarentenar', 'saudar', 'trimestr', 'vespera']","[1, 1, 1, 1, 1, 1, 1, 1]","[]","[]",8,0,8,1
5695,"['dosar', 'dosar', 'dosar', 'necessario', 'saudar', 'saudar']","[3, 3, 3, 1, 2, 2]","[]","[]",6,0,6,1
5696,"['augusto', 'conjuntar', 'desenvolvido', 'equipamento', 'higienizacao', 'reforcar', 'reuter', 'rotina', 'saudar', 'saudar']","[1, 1, 1, 1, 1, 1, 1, 1, 2, 2]","[]","[]",10,0,10,1
5699,"['oliveira']","[1]","[]","[]",1,0,1,1
5700,"['dificuldad', 'infeccioso', 'interpretar', 'isolar', 'respostar', 'situacao', 'surtir']","[1, 1, 1, 1, 1, 1, 1]","[]","[]",7,0,7,1
5704,"['diretoria', 'exemplo', 'milho', 'pagamento', 'profissionai', 'quatro', 'quatro', 'reducao', 'reforcar', 'sociai', 'tambem', 'tambem']","[1, 1, 1, 1, 1, 2, 2, 1, 1, 1, 2, 2]","['camisa', 'imagem', 'rosario']","[1, 1, 1]",12,3,15,1
5705,"['advocaciager', 'confederacao', 'consumidor', 'instituto', 'planar', 'plano', 'prazo', 'prever', 'supremo']","[1, 1, 1, 1, 1, 1, 1, 1, 1]","[]","[]",9,0,9,1
5709,"['advocaciager', 'armazenamento', 'assistencia', 'determinacao', 'lewandowski', 'ministrar', 'oficio', 'planar', 'planar', 'respostar', 'ricardo', 'saudar', 'situacao', 'supremo']","[1, 1, 1, 1, 1, 1, 1, 2, 2, 1, 1, 1, 1, 1]","[]","[]",14,0,14,1
5710,"['autoridad', 'extensao', 'instituto', 'legislativo', 'propagacao']","[1, 1, 1, 1, 1]","['espalhar', 'expulsar', 'intitular']","[1, 1, 1]",5,3,8,1
5711,"['alteracao', 'anuncio', 'cenario', 'condicao', 'conjuntar', 'conjuntar', 'desenvolvimento', 'desenvolvimento', 'deslocamento', 'deslocamento', 'deslocamento', 'destacar', 'estrategia', 'federar', 'flavio', 'fronteiro', 'fronteiro', 'periodo', 'possibilidad', 'preocupacao', 'previsao', 'quedo', 'risco', 'semestr', 'situacao', 'surtir', 'tendencia', 'vigilancia']","[1, 1, 1, 1, 2, 2, 2, 2, 3, 3, 3, 1, 1, 1, 1, 2, 2, 1, 1, 1, 1, 1, 1, 1, 1, 1, 1, 1]","['disfarcar', 'imagem', 'usuario']","[1, 1, 1]",28,3,31,1
5717,"['avancar', 'boletim', 'condicao', 'consequencia', 'distrito', 'distrito', 'infraestrutura', 'periferia', 'preocupacao', 'saudar', 'saudar', 'saudar', 'urbano']","[1, 1, 1, 1, 2, 2, 1, 1, 1, 3, 3, 3, 1]","['motorista', 'verificar']","[1, 1]",13,2,15,1
5719,"['almeida', 'wilson']","[1, 1]","[]","[]",2,0,2,1
5721,"['estrategico', 'federar', 'nomeacao', 'oficialment', 'pastar', 'possibilidad', 'saudar', 'saudar', 'saudar', 'saudar']","[1, 1, 1, 1, 1, 1, 4, 4, 4, 4]","[]","[]",10,0,10,1
5722,"['infectar', 'panamericana', 'saudar']","[1, 1, 1]","[]","[]",3,0,3,1
5723,"['assistencia', 'conformar', 'desembarcar', 'dificuldad', 'enfrentamento', 'equipamento', 'equipamento', 'estrategico', 'infectar', 'pulmonar', 'pulmonar', 'pulmonar', 'pulmonar', 'pulmonar', 'reforcar', 'respirador', 'respirador', 'respirador', 'respiratorio', 'saudar', 'saudar', 'saudar', 'saudar', 'saudar', 'saudar', 'suportar', 'transmissao', 'velocidad', 'ventilador', 'ventilador', 'ventilador', 'ventilatorio']","[1, 1, 1, 1, 1, 2, 2, 1, 1, 5, 5, 5, 5, 5, 1, 3, 3, 3, 1, 6, 6, 6, 6, 6, 6, 1, 1, 1, 3, 3, 3, 1]","['ganhar']","[1]",32,1,33,1
5724,"['constituicao', 'corpu', 'embora', 'esquema', 'esquema', 'funcao', 'habea', 'metropolitano', 'recebido', 'sido', 'supremo', 'turma']","[1, 1, 1, 2, 2, 1, 1, 1, 1, 1, 1, 1]","[]","[]",12,0,12,1
5726,"['preservar']","[1]","['capturar', 'capturar']","[2, 2]",1,2,3,1
5727,"['biliao', 'biliao', 'destinar', 'destinar', 'distrito', 'distrito', 'extraordinario', 'extraordinario', 'federar', 'funcionamento', 'goncalv', 'provisorio', 'provisorio', 'provisorio', 'recurso', 'saudar', 'saudar', 'saudar', 'saudar', 'vigilancia']","[2, 2, 2, 2, 2, 2, 2, 2, 1, 1, 1, 3, 3, 3, 1, 4, 4, 4, 4, 1]","[]","[]",20,0,20,1
5728,"['deltan', 'fux', 'fux', 'henriqu', 'henriqu', 'justicar', 'ministrar', 'ministrar', 'ministrar', 'ministrar', 'saudar']","[1, 2, 2, 2, 2, 1, 4, 4, 4, 4, 1]","[]","[]",11,0,11,1
5729,"['advocaciager', 'ambientar', 'atuacao', 'aurelio', 'aurelio', 'decisao', 'decisao', 'elaborar', 'forcatarefa', 'julgamento', 'julgamento', 'mello', 'ministrar', 'ministrar', 'planar', 'plenario', 'plenario', 'prazo', 'preservacao', 'regiao', 'republico', 'situacao', 'supremo', 'sustentabilidad']","[1, 1, 1, 2, 2, 2, 2, 1, 1, 2, 2, 1, 2, 2, 1, 2, 2, 1, 1, 1, 1, 1, 1, 1]","['incendio', 'incendio']","[2, 2]",24,2,26,1
5731,"['epidemiologico', 'exemplo', 'fundacao', 'fundacao', 'instituto', 'levantamento', 'levantamento', 'medida', 'oswaldo', 'tambem']","[1, 1, 2, 2, 1, 2, 2, 1, 1, 1]","[]","[]",10,0,10,1
5734,"['dificuldad', 'equipamento', 'equipamento', 'escassez', 'instituto', 'instituto', 'opcao', 'preservar', 'saudar', 'saudar', 'saudar', 'saudar', 'saudar']","[1, 2, 2, 1, 2, 2, 1, 1, 5, 5, 5, 5, 5]","[]","[]",13,0,13,1
5735,"['acordo', 'azevedo', 'esquema', 'fase', 'lavagem', 'milho', 'milho', 'sendo', 'sido']","[1, 1, 1, 1, 1, 2, 2, 1, 1]","[]","[]",9,0,9,1
5736,"['afetado', 'colaboracao', 'respirador', 'respirador', 'respirador']","[1, 1, 3, 3, 3]","[]","[]",5,0,5,1
5739,"['funcao', 'funcionamento', 'posicionamento', 'pratico', 'risco']","[1, 1, 1, 1, 1]","['imagem', 'vitaminar']","[1, 1]",5,2,7,1
5740,"['autoridad', 'epicentro', 'higienizacao', 'hubei', 'provincia', 'proximo', 'sido', 'sido']","[1, 1, 1, 1, 1, 1, 2, 2]","['drone', 'espalhar']","[1, 1]",8,2,10,1
5741,"['positivar', 'positivar', 'quarentenar', 'recuperacao', 'temporada', 'treino']","[2, 2, 1, 1, 1, 1]","['parir']","[1]",6,1,7,1
5743,"['associacao', 'atendido', 'avancar', 'campino', 'concreto', 'desenvolvimento', 'diariament', 'esperancar', 'etapa', 'pereira', 'previsao', 'previsao', 'privar', 'privar', 'respostar', 'respostar', 'semestr']","[1, 1, 1, 1, 1, 1, 1, 1, 1, 1, 2, 2, 2, 2, 2, 2, 1]","[]","[]",17,0,17,1
5744,"['adotada', 'calendario', 'crise', 'ernesto', 'imunizacao', 'necessario', 'perspectivo', 'saudar', 'situacao']","[1, 1, 1, 1, 1, 1, 1, 1, 1]","[]","[]",9,0,9,1
5748,"['crise', 'jantar', 'opcao']","[1, 1, 1]","['clicar']","[1]",3,1,4,1
5751,"['adiamento', 'condenacao', 'guaruja', 'julgamento', 'justicar', 'mudanca', 'prever', 'recurso', 'recurso', 'reducao', 'sessao', 'triplex', 'turma']","[1, 1, 1, 1, 1, 1, 1, 2, 2, 1, 1, 1, 1]","[]","[]",13,0,13,1
5755,"['assistencia', 'autoridad', 'biliao', 'cerimonia', 'compromisso', 'desenvolvimento', 'destacar', 'destinar', 'enfrentamento', 'estrategico', 'gestant', 'ministrar', 'palacio', 'planalto', 'primario', 'primario', 'queiroga', 'queiroga', 'recurso', 'republico', 'saudar', 'saudar', 'saudar', 'saudar']","[1, 1, 1, 1, 1, 1, 1, 1, 1, 1, 1, 1, 1, 1, 2, 2, 2, 2, 1, 1, 4, 4, 4, 4]","[]","[]",24,0,24,1
5760,"['afetado', 'companhia', 'conformar', 'demandar', 'demandar', 'passageiro', 'periodo', 'preliminar', 'quedo', 'reducao', 'taxar', 'taxar', 'taxar', 'trafego', 'trafego', 'voo', 'voo']","[1, 1, 1, 2, 2, 1, 1, 1, 1, 1, 3, 3, 3, 2, 2, 2, 2]","[]","[]",17,0,17,1
5762,"['almeida', 'internar', 'internar', 'oliveira', 'oliveira']","[1, 2, 2, 2, 2]","[]","[]",5,0,5,1
5764,"['autoridad', 'cepa', 'contagioso', 'europeu', 'examinar', 'ministrar', 'mutacao', 'passageiro', 'positivar', 'quarentenar', 'saudar', 'viagem', 'viajant']","[1, 1, 1, 1, 1, 1, 1, 1, 1, 1, 1, 1, 1]","[]","[]",13,0,13,1
5766,"['anvisa', 'anvisa', 'aprovacao', 'desenvolvido', 'instituto', 'justificativo', 'ministrar', 'palacio', 'parceria', 'pastar', 'planalto', 'provisorio', 'provisorio', 'reuniao', 'saudar', 'saudar', 'secretarioexecutivo', 'trimestr', 'vigilancia']","[2, 2, 1, 1, 1, 1, 1, 1, 1, 1, 1, 2, 2, 1, 2, 2, 1, 1, 1]","[]","[]",19,0,19,1
5768,"['bolsonarista', 'domingo', 'enfrentamento', 'henriqu', 'ministrar', 'ministrar', 'ministrar', 'saudar', 'saudar', 'saudar']","[1, 1, 1, 1, 3, 3, 3, 3, 3, 3]","[]","[]",10,0,10,1
5769,"['augusto', 'crise', 'desgastar', 'gabinet', 'heleno', 'instituto', 'necessidad', 'palacio', 'planalto', 'preocupacao', 'preocupacao', 'respostar', 'situacao', 'vieira', 'vieira']","[1, 1, 1, 1, 1, 1, 1, 1, 1, 2, 2, 1, 1, 2, 2]","['cbn', 'imagem']","[1, 1]",15,2,17,1
5770,"['augusto', 'augusto', 'calamidad', 'cupula', 'epidemiologico', 'expressar', 'independentement', 'inquerito', 'legislativo', 'necessario', 'possibilidad', 'possibilidad', 'preocupacao', 'republico', 'republico', 'republico']","[2, 2, 1, 1, 1, 1, 1, 1, 1, 1, 2, 2, 1, 3, 3, 3]","[]","[]",16,0,16,1
5772,"['apurar', 'integro', 'temporario', 'vieira']","[1, 1, 1, 1]","['agredir', 'carrefour', 'imagem', 'imagem']","[1, 1, 2, 2]",4,4,8,1
5773,"['anteriorment', 'autoridad', 'decisao', 'disseminacao', 'epidemiologico', 'estagio', 'estimativo', 'fundamentar', 'habitant', 'internacao', 'modelo', 'necessidad', 'necessidad', 'prever', 'previsao', 'propagacao', 'taxar', 'taxar', 'transmissao']","[1, 1, 1, 1, 1, 1, 1, 1, 1, 1, 1, 2, 2, 1, 1, 1, 2, 2, 1]","['usuario', 'usuario']","[2, 2]",19,2,21,1
5774,"['michael', 'portavoz', 'previsto', 'regrar', 'sindicato', 'sindicato']","[1, 1, 1, 1, 2, 2]","['filmar', 'filmar', 'filmar', 'filmar']","[4, 4, 4, 4]",6,4,10,1
5780,"['consultoria', 'contrato', 'depoimento', 'epidemiar', 'epidemiar', 'epidemiar', 'especifico', 'exministro', 'mantido', 'pastar', 'pastar', 'randolf', 'randolf', 'randolf', 'randolf', 'recebido', 'relativo', 'requerimento', 'requerimento', 'requerimento', 'requerimento', 'requerimento', 'saudar', 'saudar', 'saudar', 'saudar']","[1, 1, 1, 3, 3, 3, 1, 1, 1, 2, 2, 4, 4, 4, 4, 1, 1, 5, 5, 5, 5, 5, 4, 4, 4, 4]","['telegram']","[1]",26,1,27,1
5781,"['acordo', 'concedido', 'externo', 'interrupcao', 'manutencao', 'proprio', 'sabado', 'sendo']","[1, 1, 1, 1, 1, 1, 1, 1]","[]","[]",8,0,8,1
5782,"['submetido']","[1]","[]","[]",1,0,1,1
5786,"['alvaro', 'comportamento', 'conflito', 'contrato', 'desmatamento', 'exonerar', 'henriqu', 'instituto', 'ministrar', 'ministrar', 'ricardo', 'saudar', 'situacao', 'wajngarten']","[1, 1, 1, 1, 1, 1, 1, 1, 2, 2, 1, 1, 1, 1]","[]","[]",14,0,14,1
5787,"['conjuntar', 'conjunto', 'destacar', 'parceria', 'reabrir', 'sabado', 'saudar', 'visitant', 'visitant']","[1, 1, 1, 1, 1, 1, 1, 2, 2]","['padrar']","[1]",9,1,10,1
5789,"['crise', 'enxergar', 'epidemiar', 'humanitario', 'prever', 'previsao', 'punicao', 'restritivo', 'saudar']","[1, 1, 1, 1, 1, 1, 1, 1, 1]","[]","[]",9,0,9,1
5790,"['anuncio', 'broadcast', 'decisao', 'desafio', 'economia', 'pastar', 'privar', 'ricardo', 'transicao']","[1, 1, 1, 1, 1, 1, 1, 1, 1]","[]","[]",9,0,9,1
5792,"['circulacao', 'disseminacao', 'integro', 'pratico', 'pratico']","[1, 1, 1, 2, 2]","['imagem']","[1]",5,1,6,1
5793,"['capitar', 'comunitario', 'justicar', 'levantamento', 'motivacao', 'motivacao', 'periodo', 'precandidato', 'precandidato', 'processo', 'transmissao']","[1, 1, 1, 1, 2, 2, 1, 2, 2, 1, 1]","['assassinar', 'assassinar']","[2, 2]",11,2,13,1
5794,"['alteracao', 'anvisa', 'anvisa', 'armazenamento', 'armazenamento', 'conservacao', 'conservacao', 'estabilidad', 'estabilidad', 'orientacao', 'possibilidad', 'vigilancia']","[1, 2, 2, 2, 2, 2, 2, 2, 2, 1, 1, 1]","[]","[]",12,0,12,1
5797,"['barroso', 'calendario', 'condicao', 'decisao', 'decisao', 'decisao', 'decisao', 'fornecimento', 'justicar', 'ministrar', 'preservacao', 'prorrogacao', 'realizacao', 'reforcar', 'sessao']","[1, 1, 1, 4, 4, 4, 4, 1, 1, 1, 1, 1, 1, 1, 1]","[]","[]",15,0,15,1
5799,"['autonomia', 'contribuicao', 'crise', 'crise', 'crise', 'decisao', 'deteccao', 'funcionamento', 'ministrar', 'ministrar', 'normalidad', 'revisar', 'saudar', 'saudar']","[1, 1, 3, 3, 3, 1, 1, 1, 2, 2, 1, 1, 2, 2]","[]","[]",14,0,14,1
5800,"['flavio', 'nogueira']","[1, 1]","[]","[]",2,0,2,1
5801,"['apurar', 'esperancar', 'esperancar']","[1, 2, 2]","[]","[]",3,0,3,1
5804,"['autoridad', 'colaboracao', 'comissao', 'equipamento', 'equipamento', 'europeu', 'europeu', 'europeu', 'parceiro', 'possibilidad', 'respiratorio', 'situacao']","[1, 1, 1, 2, 2, 3, 3, 3, 1, 1, 1, 1]","[]","[]",12,0,12,1
5805,"['anteriorment', 'aumento', 'circulacao', 'desafio', 'enfrentamento', 'expectativa', 'medida', 'nomeacao', 'queiroga', 'queiroga', 'relacao', 'reuniao', 'sendo']","[1, 1, 1, 1, 1, 1, 1, 1, 2, 2, 1, 1, 1]","[]","[]",13,0,13,1
5806,"['anuncio', 'coordenar', 'desenvolvido', 'desenvolvimento', 'dosar', 'europeu', 'inglaterra', 'ministrar', 'ministrar']","[1, 1, 1, 1, 1, 1, 1, 2, 2]","['realment']","[1]",9,1,10,1
5810,"['comparacao', 'domicilio', 'estatistico', 'geografia', 'ibg', 'ibg', 'instituto', 'subir', 'taxar']","[1, 1, 1, 1, 2, 2, 1, 1, 1]","[]","[]",9,0,9,1
5812,"['agravamento', 'augusto', 'aurelio', 'aurelio', 'funcao', 'mello', 'ministrar', 'ministrar', 'periodo', 'previsto', 'republico', 'republico', 'supremo', 'supremo', 'supremo']","[1, 1, 2, 2, 1, 1, 2, 2, 1, 1, 2, 2, 3, 3, 3]","['bispar', 'catolico']","[1, 1]",15,2,17,1
5815,"['consorcio', 'notificar', 'quedo', 'totalizar', 'variacao']","[1, 1, 1, 1, 1]","[]","[]",5,0,5,1
5817,"['apurar', 'flavio', 'folhar', 'inquerito', 'integro', 'investigacao', 'movimentacao', 'pagamento', 'suspeito']","[1, 1, 1, 1, 1, 1, 1, 1, 1]","[]","[]",9,0,9,1
5818,"['absoluto', 'necessario', 'privar', 'quarentenar', 'quarentenar', 'regrar']","[1, 1, 1, 2, 2, 1]","['imagem', 'revoltar', 'versao']","[1, 1, 1]",6,3,9,1
5821,"['alcolumbr', 'alcolumbr', 'alcolumbr', 'alcolumbr', 'boletim', 'cardiologista', 'demap', 'diagnosticar', 'internacao', 'internar', 'internar', 'saudar', 'saudar']","[4, 4, 4, 4, 1, 1, 1, 1, 1, 2, 2, 2, 2]","[]","[]",13,0,13,1
5822,"['alteracao', 'colleg', 'genoma', 'instituto', 'mutacao', 'mutacao', 'mutacao', 'mutacao']","[1, 1, 1, 1, 4, 4, 4, 4]","['espalhar', 'espalhar']","[2, 2]",8,2,10,1
5824,"['contrato', 'desvio', 'desvio', 'esquema', 'esquema', 'iniciativo', 'integro', 'pagamento', 'suspeito']","[1, 2, 2, 2, 2, 1, 1, 1, 1]","[]","[]",9,0,9,1
5825,"['levantamento', 'patamar', 'proporcao', 'proporcao']","[1, 1, 2, 2]","[]","[]",4,0,4,1
5827,"['autoridad', 'autoridad', 'decisao', 'saudar']","[2, 2, 1, 1]","[]","[]",4,0,4,1
5832,"['absoluto', 'adversario', 'atuacao', 'conduta', 'decorrencia', 'exprefeito']","[1, 1, 1, 1, 1, 1]","[]","[]",6,0,6,1
5833,"['hospitalizacao', 'infeccioso', 'inglaterra', 'limitacao', 'ministrar', 'mutacao', 'plano', 'recordar', 'regrar', 'rigoroso', 'sabado', 'sudest']","[1, 1, 1, 1, 1, 1, 1, 1, 1, 1, 1, 1]","['disseminar']","[1]",12,1,13,1
5835,"['acumular', 'europeu', 'quedo', 'situacao', 'situacao']","[1, 1, 1, 2, 2]","[]","[]",5,0,5,1
5840,"['anuncio', 'cepa', 'colleg', 'confirmado', 'embora', 'preocupacao', 'resultado', 'sido', 'tambem']","[1, 1, 1, 1, 1, 1, 1, 1, 1]","[]","[]",9,0,9,1
5841,"['circulacao', 'levantamento', 'subir']","[1, 1, 1]","['pego']","[1]",3,1,4,1
5842,"['afetado', 'desempenhar', 'destacar', 'esforco', 'favorito', 'impactar', 'iniciativo', 'reducao']","[1, 1, 1, 1, 1, 1, 1, 1]","['logotipo']","[1]",8,1,9,1
5843,"['associacao', 'condicao', 'crise', 'destacar', 'levantamento', 'liderar', 'mudanca', 'nelson', 'positivar', 'quarentenar', 'quedo', 'regiao', 'regiao', 'situacao']","[1, 1, 1, 1, 1, 1, 1, 1, 1, 1, 1, 2, 2, 1]","['minutar']","[1]",14,1,15,1
5844,"['andrew', 'andrew', 'andrew', 'andrew', 'condicao', 'infectar', 'viagem']","[4, 4, 4, 4, 1, 1, 1]","['amplament']","[1]",7,1,8,1
5845,"['calendario', 'passageiro', 'privar', 'proposto', 'quarentenar', 'quarentenar', 'quarentenar', 'respostar', 'voo', 'voo', 'voo']","[1, 1, 1, 1, 3, 3, 3, 1, 3, 3, 3]","[]","[]",11,0,11,1
5846,"['associacao', 'colunista', 'concedido', 'justicar', 'justificativo', 'magistrado', 'proporcao', 'servidor', 'supremo']","[1, 1, 1, 1, 1, 1, 1, 1, 1]","[]","[]",9,0,9,1
5850,"['biliao', 'epicentro', 'epidemiar', 'epidemiar', 'expressivo', 'quarentenar', 'quedo', 'recuar', 'sessao']","[1, 1, 2, 2, 1, 1, 1, 1, 1]","[]","[]",9,0,9,1
5851,"['cometido', 'hospitalizar', 'iniciativo', 'proposto']","[1, 1, 1, 1]","['espancar', 'menino', 'menino']","[1, 2, 2]",4,3,7,1
5852,"['habitant', 'republico', 'republico', 'sabado', 'sabado', 'sabado', 'secom']","[1, 2, 2, 3, 3, 3, 1]","['camisa', 'imagem', 'parabem']","[1, 1, 1]",7,3,10,1
5853,"['anvisa', 'aprovacao', 'desenvolvido', 'imunizacao', 'imunizacao', 'imunizacao', 'instituto', 'paralelo', 'parceria', 'planar', 'planar', 'planar', 'planar', 'plano', 'proposto', 'reforcar', 'regiao', 'rejeicao', 'saudar', 'saudar', 'vigilancia']","[1, 1, 1, 3, 3, 3, 1, 1, 1, 4, 4, 4, 4, 1, 1, 1, 1, 1, 2, 2, 1]","[]","[]",21,0,21,1
5854,"['ambientar', 'anticorpo', 'atendido', 'decisao', 'dificuldad', 'dificuldad', 'inclusao', 'plano', 'plano', 'plano', 'quadro', 'quadro', 'resolucao', 'respiratorio', 'respiratorio', 'respiratorio', 'reuniao', 'saudar', 'saudar', 'saudar', 'saudar']","[1, 1, 1, 1, 2, 2, 1, 3, 3, 3, 2, 2, 1, 3, 3, 3, 1, 4, 4, 4, 4]","[]","[]",21,0,21,1
5856,"['anticorpo', 'anticorpo', 'aplicacao', 'domingo', 'taxar']","[2, 2, 1, 1, 1]","['amplament']","[1]",5,1,6,1
5857,"['bancada', 'converso', 'exministro', 'exministro', 'henriqu', 'ministrar', 'nogueira', 'nogueira', 'saudar', 'saudar', 'saudar']","[1, 1, 2, 2, 1, 1, 2, 2, 3, 3, 3]","[]","[]",11,0,11,1
5858,"['divergencia', 'divergencia', 'funcao', 'henriqu', 'ministrar', 'nelson', 'pastar', 'sabado', 'saudar', 'teich', 'teich', 'teich', 'teich', 'teich']","[2, 2, 1, 1, 1, 1, 1, 1, 1, 5, 5, 5, 5, 5]","[]","[]",14,0,14,1
5859,"['bbc', 'biliao', 'biliao', 'consequencia', 'genoma', 'mutacao', 'precisao', 'preocupacao', 'previsao', 'quedo', 'sequenciamento', 'sequenciamento']","[1, 2, 2, 1, 1, 1, 1, 1, 1, 1, 2, 2]","['assinalar', 'circular', 'compartilhar']","[1, 1, 1]",12,3,15,1
5860,"['consolidar', 'consorcio', 'levantamento', 'positivar', 'saudar', 'variacao']","[1, 1, 1, 1, 1, 1]","[]","[]",6,0,6,1
5861,"['alcolumbr', 'alcolumbr', 'atendido', 'atuacao', 'companhia', 'companhia', 'congresso', 'demap', 'desenvolvimento', 'distrito', 'orcamentaria', 'previo', 'sancao', 'sancao']","[2, 2, 1, 1, 2, 2, 1, 1, 1, 1, 1, 1, 2, 2]","[]","[]",14,0,14,1
5862,"['capitar', 'capitar', 'capitar', 'ribeiro']","[3, 3, 3, 1]","['ganhar']","[1]",4,1,5,1
5863,"['celso', 'empatar', 'folhar', 'margem']","[1, 1, 1, 1]","[]","[]",4,0,4,1
5868,"['alcolumbr', 'argumentar', 'associacao', 'autonomia', 'comissao', 'comissao', 'conformar', 'congresso', 'demap', 'externo', 'externo', 'federar', 'federar', 'federar', 'instituto', 'integrant', 'levantamento', 'ministrar', 'provisorio', 'universitario']","[1, 1, 1, 1, 2, 2, 1, 1, 1, 2, 2, 3, 3, 3, 1, 1, 1, 1, 1, 1]","[]","[]",20,0,20,1
5871,"['administrativo', 'condicao', 'decisao', 'gabinet', 'heleno', 'heleno', 'heleno', 'heleno', 'improbidad', 'inicialment', 'justicar', 'pratico', 'prever', 'rachadinha', 'rachadinha', 'sancao']","[1, 1, 1, 1, 4, 4, 4, 4, 1, 1, 1, 1, 1, 2, 2, 1]","[]","[]",16,0,16,1
5872,"['bandeirant', 'concedido', 'fundacao', 'fundacao', 'gabbardo', 'gabbardo', 'impactar', 'palacio', 'prever', 'previsto', 'projeco', 'propagacao', 'proposto', 'reabertura', 'transmissao', 'varga']","[1, 1, 2, 2, 2, 2, 1, 1, 1, 1, 1, 1, 1, 1, 1, 1]","[]","[]",16,0,16,1
5874,"['adulto', 'autonomia', 'autorizacao', 'carat', 'demandar', 'distrito', 'enfrentamento', 'infraestrutura', 'necessario', 'pastar', 'reforcar', 'saudar', 'saudar', 'temporario']","[1, 1, 1, 1, 1, 1, 1, 1, 1, 1, 1, 2, 2, 1]","[]","[]",14,0,14,1
5875,"['ambientar', 'autonomia', 'concorrent', 'isolar', 'reconhecimento', 'volumar']","[1, 1, 1, 1, 1, 1]","[]","[]",6,0,6,1
5877,"['ambientar', 'ambientar', 'anteriorment', 'boletim', 'boletim', 'boletim', 'coreia', 'decorrencia', 'dificuldad', 'enquadrar', 'enquadrar', 'gabbardo', 'imunizacao', 'kong', 'necessidad', 'necessidad', 'notificar', 'pastar', 'provincia', 'regiao', 'respiratorio', 'respiratorio', 'risco', 'saudar', 'saudar', 'saudar', 'saudar', 'saudar', 'saudar', 'saudar', 'saudar', 'saudar', 'saudar', 'saudar', 'saudar', 'saudar', 'secretarioexecutivo', 'suspeito', 'suspeito', 'suspeito', 'suspeito', 'transmissao', 'transmissao', 'transmissao', 'transmissao', 'transmissao', 'transmissao', 'viagem', 'viagem', 'videoconferencia']","[2, 2, 1, 3, 3, 3, 1, 1, 1, 2, 2, 1, 1, 1, 2, 2, 1, 1, 1, 1, 2, 2, 1, 13, 13, 13, 13, 13, 13, 13, 13, 13, 13, 13, 13, 13, 1, 4, 4, 4, 4, 6, 6, 6, 6, 6, 6, 2, 2, 1]","['sequer']","[1]",50,1,51,1
5878,"['agravar', 'apurar', 'condicao', 'desempenhar', 'periodo', 'periodo', 'preparacao', 'reforcar', 'rotina', 'sindicato', 'suspensao']","[1, 1, 1, 1, 2, 2, 1, 1, 1, 1, 1]","['cocaina', 'sequer']","[1, 1]",11,2,13,1
5879,"['ambientar', 'ambientar', 'cirurgico', 'condicao', 'estabilidad', 'infectar', 'kong', 'periodo', 'saudar']","[2, 2, 1, 1, 1, 1, 1, 1, 1]","['espalhar']","[1]",9,1,10,1
5882,"['ambito', 'circulacao', 'colaborar', 'concedido', 'disseminacao', 'metropolitano', 'metropolitano', 'metropolitano', 'regiao']","[1, 1, 1, 1, 1, 3, 3, 3, 1]","[]","[]",9,0,9,1
5883,"['atendido', 'crise', 'diagnosticar', 'dificuldad']","[1, 1, 1, 1]","[]","[]",4,0,4,1
5884,"['ambientar', 'autonomia', 'decisao', 'dificuldad', 'mudanca', 'mudanca', 'reafirmar', 'transmissao']","[1, 1, 1, 1, 2, 2, 1, 1]","[]","[]",8,0,8,1
5887,"['articulacao', 'biliao', 'biliao', 'congresso', 'congresso', 'constituicao', 'contribuicao', 'contribuicao', 'tributario']","[1, 2, 2, 2, 2, 1, 2, 2, 1]","['perdao']","[1]",9,1,10,1
5890,"['avancar', 'comissao', 'congresso', 'congresso', 'discussao', 'economia', 'inclusao', 'instituto', 'proposto', 'proposto', 'sessao', 'tributario', 'tributario', 'tributario', 'tributario']","[1, 1, 2, 2, 1, 1, 1, 1, 2, 2, 1, 4, 4, 4, 4]","[]","[]",15,0,15,1
5892,"['apurar', 'apurar', 'decisao', 'desenvolvimento', 'disseminacao', 'inquerito', 'integrant', 'ministrar', 'ministrar', 'notificar', 'prazo', 'prever', 'secom', 'secom', 'supremo', 'supremo']","[2, 2, 1, 1, 1, 1, 1, 2, 2, 1, 1, 1, 2, 2, 2, 2]","[]","[]",16,0,16,1
5893,"['comissao', 'inquerito', 'saudar']","[1, 1, 1]","[]","[]",3,0,3,1
5894,"['fase', 'fase', 'fase', 'fase', 'integrant', 'internacao', 'mudanca', 'pratico', 'preocupacao', 'recordar', 'relaxar', 'reuniao', 'taxar', 'vespera']","[4, 4, 4, 4, 1, 1, 1, 1, 1, 1, 1, 1, 1, 1]","[]","[]",14,0,14,1
5895,"['diariament', 'hospitalizar', 'internar', 'reducao', 'submetido', 'taxar', 'taxar', 'ventilacao', 'ventilacao', 'ventilador']","[1, 1, 1, 1, 1, 2, 2, 2, 2, 1]","[]","[]",10,0,10,1
5904,"['justicar']","[1]","[]","[]",1,0,1,1
5906,"['andrew', 'anuncio', 'infectar', 'saudar', 'saudar']","[1, 1, 1, 2, 2]","[]","[]",5,0,5,1
5911,"['articulacao', 'converso', 'converso', 'ministrar', 'ministrar', 'ministrar', 'palacio', 'planalto', 'planalto']","[1, 2, 2, 3, 3, 3, 1, 2, 2]","[]","[]",9,0,9,1
5918,"['complicacao', 'defendido', 'hospitalizar', 'intensivo', 'internacao', 'letalidad', 'revisar', 'taxar']","[1, 1, 1, 1, 1, 1, 1, 1]","[]","[]",8,0,8,1
5919,"['alckmin', 'cupula', 'divergencia', 'geraldo', 'justicar', 'presidir', 'transmissao']","[1, 1, 1, 1, 1, 1, 1]","['legendar']","[1]",7,1,8,1
5921,"['almeida', 'aprovacao', 'arthur', 'constituicao', 'converso', 'demmg', 'economia', 'economia', 'emendar', 'emendar', 'gued', 'gued', 'lira', 'ministrar', 'ministrar', 'ministrar', 'pacheco', 'pagamento', 'ppal', 'proposto', 'respectivament', 'saudar', 'tesourar']","[1, 1, 1, 1, 1, 1, 2, 2, 2, 2, 2, 2, 1, 3, 3, 3, 1, 1, 1, 1, 1, 1, 1]","['insinuar']","[1]",23,1,24,1
5922,"['autoridad', 'comparacao', 'confirmado', 'crise', 'funcionamento', 'habitant', 'habitant', 'habitant', 'porqu', 'presenca', 'regiao', 'roraima', 'sido', 'sociai']","[1, 1, 1, 1, 1, 3, 3, 3, 1, 1, 1, 1, 1, 1]","['espalh', 'espalh', 'verdadeiro']","[2, 2, 1]",14,3,17,1
5923,"['adulto', 'autonomia', 'autorizacao', 'carat', 'cenario', 'conformar', 'correspondent', 'decorrencia', 'demandar', 'distrito', 'enfrentamento', 'necessario', 'pastar', 'recurso', 'reforcar', 'saudar', 'saudar', 'temporario']","[1, 1, 1, 1, 1, 1, 1, 1, 1, 1, 1, 1, 1, 1, 1, 2, 2, 1]","[]","[]",18,0,18,1
5924,"['bbc', 'conformar', 'fundamentar', 'imunizacao', 'imunizacao', 'levantamento', 'normalidad']","[1, 1, 1, 2, 2, 1, 1]","[]","[]",7,0,7,1
5926,"['autoridad', 'implementar', 'legislativo']","[1, 1, 1]","[]","[]",3,0,3,1
5929,"['augusto', 'flavio', 'flavio', 'folhar', 'gabinet', 'heleno', 'integro', 'lewandowski', 'ministrar', 'ministrar', 'ramagem', 'republicanosrj', 'republico', 'republico', 'reuniao', 'ricardo', 'supremo']","[1, 2, 2, 1, 1, 1, 1, 1, 2, 2, 1, 1, 2, 2, 1, 1, 1]","[]","[]",17,0,17,1
5931,"['diagnosticar', 'internar', 'rocha', 'saudar']","[1, 1, 1, 1]","[]","[]",4,0,4,1
5932,"['apurar', 'constatar', 'irregularidad', 'justicar', 'necessario', 'suspeito']","[1, 1, 1, 1, 1, 1]","[]","[]",6,0,6,1
5933,"['afp', 'crise', 'habitant', 'infectar', 'necessidad', 'prever', 'previsto', 'primeiroministro', 'propagacao', 'sabado', 'toquio', 'toquio', 'toquio', 'toquio', 'visitant', 'visitant']","[1, 1, 1, 1, 1, 1, 1, 1, 1, 1, 4, 4, 4, 4, 2, 2]","[]","[]",16,0,16,1
5937,"['confederacao', 'imunizacao', 'possibilidad', 'preocupacao', 'saudar', 'saudar', 'trimestr']","[1, 1, 1, 1, 2, 2, 1]","[]","[]",7,0,7,1
5938,"['dedicar', 'destinar', 'jorg', 'proferir', 'proposto', 'realizacao']","[1, 1, 1, 1, 1, 1]","[]","[]",6,0,6,1
5940,"['desenvolvido', 'desmatamento', 'domingo', 'esforco', 'instituto', 'monitoramento', 'proprio', 'regiao', 'regiao', 'serao', 'sobretudo', 'tambem']","[1, 1, 1, 1, 1, 1, 1, 2, 2, 1, 1, 1]","[]","[]",12,0,12,1
5944,"['balancar', 'comissao', 'comunitario', 'economia', 'europeu', 'europeu', 'europeu', 'habitant', 'saudar', 'sigla']","[1, 1, 1, 1, 3, 3, 3, 1, 1, 1]","[]","[]",10,0,10,1
5946,"['acordo', 'adesao', 'articulacao', 'aumento', 'cenario', 'colegio', 'colegio', 'decisao', 'disseminacao', 'etapa', 'fase', 'fase', 'fase', 'henriqu', 'plano', 'plano', 'plano', 'previsto', 'processo', 'reabertura', 'reabertura', 'reabertura', 'resolucao', 'risco', 'sido', 'sorocaba', 'ultimo']","[1, 1, 1, 1, 1, 2, 2, 1, 1, 1, 3, 3, 3, 1, 3, 3, 3, 1, 1, 3, 3, 3, 1, 1, 1, 1, 1]","[]","[]",27,0,27,1
5949,"['ambientar', 'ambientar', 'aplicacao', 'aprovacao', 'comissao', 'congresso', 'conservacao', 'estrategia', 'externo', 'machadar', 'ministrar', 'recurso', 'regiao', 'regiao']","[2, 2, 1, 1, 1, 1, 1, 1, 1, 1, 1, 1, 2, 2]","['incendio', 'pego']","[1, 1]",14,2,16,1
5951,"['avancar', 'complicacao', 'complicacao', 'domingo', 'domingo', 'epicentro', 'levantamento', 'recordar', 'regiao', 'surtir']","[1, 2, 2, 2, 2, 1, 1, 1, 1, 1]","[]","[]",10,0,10,1
5955,"['alcolumbr', 'alcolumbr', 'alcolumbr', 'aurelio', 'aurelio', 'aurelio', 'constituicao', 'divergencia', 'legislativo', 'lewandowski', 'margem', 'mello', 'ministrar', 'ministrar', 'plenario', 'ricardo', 'supremo', 'supremo', 'vetar']","[3, 3, 3, 3, 3, 3, 1, 1, 1, 1, 1, 1, 2, 2, 1, 1, 2, 2, 1]","[]","[]",19,0,19,1
5956,"['colaborar', 'estrategia', 'estrategia', 'implementacao', 'mudanca', 'necessidad', 'prazo', 'proposto', 'revisar', 'saudar', 'saudar', 'saudar', 'saudar', 'saudar', 'saudar', 'saudar', 'saudar', 'saudar']","[1, 2, 2, 1, 1, 1, 1, 1, 1, 9, 9, 9, 9, 9, 9, 9, 9, 9]","[]","[]",18,0,18,1
5957,"['desenvolvimento', 'instituto', 'posturar', 'republico', 'saudar', 'tucano']","[1, 1, 1, 1, 1, 1]","[]","[]",6,0,6,1
5958,"['anticorpo', 'avancar', 'desenvolvimento', 'desenvolvimento', 'etapa', 'etapa', 'instituto', 'instituto', 'resultado', 'tambem']","[1, 1, 2, 2, 2, 2, 2, 2, 1, 1]","[]","[]",10,0,10,1
5959,"['amplo', 'claudio', 'integro', 'interlocutor', 'movimentacao', 'respostar']","[1, 1, 1, 1, 1, 1]","[]","[]",6,0,6,1
5960,"['airlin', 'airlin', 'airlin', 'calculo', 'companhia', 'concedido', 'condicao', 'demanda', 'passageiro', 'periodo', 'porqu', 'risco', 'suspensa', 'tripulacao', 'voo']","[3, 3, 3, 1, 1, 1, 1, 1, 1, 1, 1, 1, 1, 1, 1]","[]","[]",15,0,15,1
5962,"['atuam', 'necessario', 'planar', 'plano', 'presenca', 'preventivo', 'saudar', 'saudar', 'saudar', 'suspeito']","[1, 1, 1, 1, 1, 1, 3, 3, 3, 1]","['amplament', 'imagem', 'vitaminar', 'zincar']","[1, 1, 1, 1]",10,4,14,1
5965,"['consorcio', 'decisao', 'desgastar', 'economia', 'economia', 'gued', 'gued', 'iniciativo', 'ministrar', 'planalto', 'ribeiro']","[1, 1, 1, 2, 2, 2, 2, 1, 1, 1, 1]","[]","[]",11,0,11,1
5966,"['consorcio']","[1]","[]","[]",1,0,1,1
5967,"['convencao', 'convencao', 'planar', 'regrar', 'saudar', 'situacao', 'ventilacao']","[2, 2, 1, 1, 1, 1, 1]","['imagem', 'sequer']","[1, 1]",7,2,9,1
5968,"['definitivo', 'justicar', 'justicar', 'justicar', 'redondo', 'situacao']","[1, 3, 3, 3, 1, 1]","[]","[]",6,0,6,1
5969,"['antecipar', 'conjunto', 'discussao', 'distrito', 'economia', 'edson', 'edson', 'flexibilizacao', 'flexibilizar', 'globonew', 'metropolitano', 'normalidad', 'plano', 'reabertura', 'regiao', 'relaxamento', 'saudar', 'situacao']","[1, 1, 1, 1, 1, 2, 2, 1, 1, 1, 1, 1, 1, 1, 1, 1, 1, 1]","['dorio']","[1]",18,1,19,1
5971,"['ambito', 'aprovacao', 'pagamento', 'sancao', 'sancao', 'saudar', 'saudar', 'saudar', 'saudar', 'suspensao', 'suspensao', 'suspensao', 'suspenso', 'tributario']","[1, 1, 1, 2, 2, 4, 4, 4, 4, 3, 3, 3, 1, 1]","[]","[]",14,0,14,1
5973,"['consolidar', 'consorcio', 'curvo', 'estabilidad', 'levantamento', 'quedo', 'quedo', 'quedo', 'sabado', 'saudar', 'situacao', 'tendencia', 'variacao', 'variacao']","[1, 1, 1, 1, 1, 3, 3, 3, 1, 1, 1, 1, 2, 2]","[]","[]",14,0,14,1
5975,"['comissao', 'palacio', 'planalto', 'republicanosrj', 'reuniao', 'reuniao', 'sessao']","[1, 1, 1, 1, 2, 2, 1]","[]","[]",7,0,7,1
5976,"['airlin', 'airlin', 'airlin', 'anuncio', 'autoridad', 'companhia', 'companhia', 'decisao', 'economia', 'implementar', 'passageiro', 'quedo', 'reabertura', 'saudar', 'surtir', 'voo']","[3, 3, 3, 1, 1, 2, 2, 1, 1, 1, 1, 1, 1, 1, 1, 1]","[]","[]",16,0,16,1
5977,"['afastamento', 'araujo', 'augusto', 'desafiar', 'investigacao', 'justicar', 'legislativo', 'rejeicao']","[1, 1, 1, 1, 1, 1, 1, 1]","['gravacao', 'invadir']","[1, 1]",8,2,10,1
5978,"['decorrent', 'importancia', 'lewandowski', 'ministrar', 'ministrar', 'ministrar', 'prazo', 'prazo', 'previo', 'republico', 'reuter', 'ricardo', 'ricardo', 'saudar', 'saudar', 'supremo', 'surtir', 'sustentabilidad']","[1, 1, 1, 3, 3, 3, 2, 2, 1, 1, 1, 2, 2, 2, 2, 1, 1, 1]","[]","[]",18,0,18,1
5979,"['celso', 'comprometido', 'condicao', 'equipamento', 'fluxo', 'funcao', 'funcao', 'pulmonar', 'respirador', 'respiratorio', 'ventilador']","[1, 1, 1, 1, 1, 2, 2, 1, 1, 1, 1]","['descricao']","[1]",11,1,12,1
5980,"['ansiedad', 'ansiedad', 'depressao', 'depressao', 'espanha', 'infancia', 'piorar', 'piorar', 'regiao', 'saudar']","[2, 2, 2, 2, 1, 1, 2, 2, 1, 1]","['menino', 'menino', 'misericordia']","[2, 2, 1]",10,3,13,1
5981,"['academiar', 'atrair', 'circulacao', 'conduta', 'contagioso', 'decisao', 'destacar', 'excecao', 'fronteiro', 'fronteiro', 'fronteiro', 'individuar', 'pratico', 'presenciar', 'suspensao']","[1, 1, 1, 1, 1, 1, 1, 1, 3, 3, 3, 1, 1, 1, 1]","['compartilhar']","[1]",15,1,16,1
5983,"['afetado', 'avancar', 'disseminacao', 'economia', 'fronteiro', 'fronteiro', 'reabrir', 'saudar', 'viagem']","[1, 1, 1, 1, 2, 2, 1, 1, 1]","[]","[]",9,0,9,1
5984,"['consecutivo', 'desafiar', 'europeu', 'liderar', 'relaxar', 'resistencia', 'restritivo', 'surtir']","[1, 1, 1, 1, 1, 1, 1, 1]","[]","[]",8,0,8,1
5986,"['adotada', 'congresso', 'congresso', 'despesa', 'economia', 'economia', 'economia', 'gued', 'gued', 'integrant', 'ministrar', 'proposto', 'prorrogar', 'ritmar']","[1, 2, 2, 1, 3, 3, 3, 2, 2, 1, 1, 1, 1, 1]","[]","[]",14,0,14,1
5987,"['arthur', 'demmg', 'destacar', 'dialogo', 'dialogo', 'economia', 'lira', 'lira', 'lira', 'pacheco', 'pacheco', 'pacheco', 'palacio', 'planalto', 'ppal', 'prioridad', 'prioritario', 'respectivament', 'saudar', 'sugestao', 'sugestao']","[1, 1, 1, 2, 2, 1, 3, 3, 3, 3, 3, 3, 1, 1, 1, 1, 1, 1, 1, 2, 2]","[]","[]",21,0,21,1
5989,"['argumentar', 'biliao', 'consorcio', 'consorcio', 'decisao', 'decisao', 'despesa', 'economia', 'ministrar', 'ministrar', 'prever', 'privar', 'recurso', 'reducao', 'reducao', 'resolucao', 'supremo', 'supremo']","[1, 1, 2, 2, 2, 2, 1, 1, 2, 2, 1, 1, 1, 2, 2, 1, 2, 2]","[]","[]",18,0,18,1
5990,"['machadar', 'paralisar']","[1, 1]","['compartilhar']","[1]",2,1,3,1
5991,"['decisao', 'desafiar', 'extraordinario', 'julgamento', 'ministrar', 'ministrar', 'recurso', 'turma']","[1, 1, 1, 1, 2, 2, 1, 1]","[]","[]",8,0,8,1
5993,"['adulto', 'autonomia', 'autorizacao', 'autorizacao', 'carat', 'cenario', 'conformar', 'correspondent', 'decorrencia', 'demandar', 'enfrentamento', 'enfrentamento', 'necessario', 'pastar', 'recurso', 'saudar', 'saudar', 'saudar', 'temporario']","[1, 1, 2, 2, 1, 1, 1, 1, 1, 1, 2, 2, 1, 1, 1, 3, 3, 3, 1]","[]","[]",19,0,19,1
5994,"['colombio', 'consumidor', 'disseminacao', 'quarentenar', 'reuter', 'subir']","[1, 1, 1, 1, 1, 1]","[]","[]",6,0,6,1
5995,"['comparacao', 'diminuicao', 'domicilio', 'domicilio', 'domicilio', 'estatistico', 'geografia', 'ibg', 'impactar', 'instituto', 'instituto', 'levantamento', 'quedo', 'reducao']","[1, 1, 3, 3, 3, 1, 1, 1, 1, 2, 2, 1, 1, 1]","[]","[]",14,0,14,1
5996,"['administrativo', 'assistencia', 'client', 'condicao', 'consorcio', 'fluminens', 'jornada', 'logistico', 'necessario', 'planar', 'planar', 'prioridad', 'recurso', 'reducao', 'saudar', 'saudar', 'saudar', 'sindicato', 'suspensao', 'suspenso']","[1, 1, 1, 1, 1, 1, 1, 1, 1, 2, 2, 1, 1, 1, 3, 3, 3, 1, 1, 1]","[]","[]",20,0,20,1
5998,"['bruno', 'exgovernador', 'jorg']","[1, 1, 1]","[]","[]",3,0,3,1
6000,"['administrativo', 'ambito', 'apreensao', 'condicao', 'contrato', 'esquema', 'esquema', 'facilitar', 'improbidad', 'investigacao', 'investigacao', 'jorg', 'mandatario', 'pagamento', 'plantao', 'saudar', 'servidor', 'subordinar', 'vespera']","[1, 1, 1, 1, 1, 2, 2, 1, 1, 2, 2, 1, 1, 1, 1, 1, 1, 1, 1]","['legendar', 'supostament']","[1, 1]",19,2,21,1
6001,"['cenario', 'companhia', 'quarentenar', 'turistico', 'viagem', 'viagem']","[1, 1, 1, 1, 2, 2]","['compartilhar']","[1]",6,1,7,1
6002,"['alcolumbr', 'alcolumbr', 'bastidor', 'congresso', 'constituicao', 'constituicao', 'decisao', 'demap', 'demrj', 'possibilidad', 'possibilidad', 'previsto', 'respectivament', 'supremo', 'supremo', 'supremo']","[2, 2, 1, 1, 2, 2, 1, 1, 1, 2, 2, 1, 1, 3, 3, 3]","[]","[]",16,0,16,1
6004,"['decisao', 'espirito', 'espirito', 'folhar', 'integro', 'justicar']","[1, 2, 2, 1, 1, 1]","['estuprar', 'menino', 'menino']","[1, 2, 2]",6,3,9,1
6005,"['economia', 'impactar', 'risco']","[1, 1, 1]","[]","[]",3,0,3,1
6006,"['dinamarca', 'espanha', 'instituto', 'milho', 'mutacao', 'tambem', 'vigilancia']","[1, 1, 1, 1, 1, 1, 1]","[]","[]",7,0,7,1
6007,"['destacar', 'lavagem', 'pratico', 'republicanosrj']","[1, 1, 1, 1]","[]","[]",4,0,4,1
6008,"['avancar', 'colombio', 'conformar', 'desmatamento', 'enfrentamento', 'fronteiro', 'fronteiro', 'infectar', 'monitoramento', 'orientacao', 'preocupacao', 'presidir', 'regiao', 'reuniao', 'roraima', 'saudar']","[1, 1, 1, 1, 1, 2, 2, 1, 1, 1, 1, 1, 1, 1, 1, 1]","[]","[]",16,0,16,1
6009,"['arthur', 'carat', 'consolidar', 'decisao', 'decisao', 'domingo', 'lira', 'necessario', 'piorar', 'rossi', 'situacao']","[1, 1, 1, 2, 2, 1, 1, 1, 1, 1, 1]","[]","[]",11,0,11,1
6010,"['academiar', 'habito', 'orientacao', 'orientacao', 'orientacao', 'risco', 'saudar', 'saudar', 'ufrj', 'ufrj', 'ufrj']","[1, 1, 3, 3, 3, 1, 2, 2, 3, 3, 3]","[]","[]",11,0,11,1
6011,"['adulto', 'adulto', 'estagio', 'fase', 'instituto', 'palacio', 'palacio', 'prever', 'relacao', 'relacao', 'resultado', 'reuter', 'ricardo', 'sendo', 'serao', 'tambem']","[2, 2, 1, 1, 1, 2, 2, 1, 2, 2, 1, 1, 1, 1, 1, 1]","[]","[]",16,0,16,1
6013,"['deflagrar', 'preventivo', 'ribeiro', 'subordinar']","[1, 1, 1, 1]","['torturar']","[1]",4,1,5,1
6015,"['bbc', 'competicao', 'consorcio', 'coordenar', 'realizacao', 'realizacao']","[1, 1, 1, 1, 2, 2]","['boicotar']","[1]",6,1,7,1
6016,"['congresso', 'proposta', 'sociai']","[1, 1, 1]","[]","[]",3,0,3,1
6017,"['ambito', 'autoridad', 'complicacao', 'hipertensao', 'infectar', 'infectar', 'internar', 'orientacao', 'periodo', 'periodo', 'respiratorio']","[1, 1, 1, 1, 2, 2, 1, 1, 2, 2, 1]","[]","[]",11,0,11,1
6018,"['conformar', 'conformar', 'consorcio', 'diariament', 'epidemiar', 'levantamento', 'michael', 'monitoramento', 'saudar', 'saudar', 'situacao']","[2, 2, 1, 1, 1, 1, 1, 1, 2, 2, 1]","[]","[]",11,0,11,1
6019,"['aglomeracao', 'contemplar', 'decisao', 'presenciar', 'proposto', 'suspenso']","[1, 1, 1, 1, 1, 1]","[]","[]",6,0,6,1
6020,"['alergia', 'anvisa', 'associacao', 'diagnosticar', 'diagnosticar', 'diariament', 'fabricacao', 'fabricacao', 'internar', 'nelson', 'primario', 'quedo', 'regrar', 'regulamentar', 'saudar', 'saudar', 'saudar', 'vigilancia']","[1, 1, 1, 2, 2, 1, 2, 2, 1, 1, 1, 1, 1, 1, 3, 3, 3, 1]","['menino', 'misturar', 'misturar', 'pelar', 'supostament']","[1, 2, 2, 1, 1]",18,5,23,1
6028,"['autoridad', 'compilar', 'depoimento', 'domingo', 'possibilidad', 'propagacao']","[1, 1, 1, 1, 1, 1]","['indignar']","[1]",6,1,7,1
6029,"['agravar', 'avancar', 'discussao', 'gripezinha', 'ideologico', 'inquerito', 'ministrar', 'palacio', 'planalto', 'supremo']","[1, 1, 1, 1, 1, 1, 1, 1, 1, 1]","[]","[]",10,0,10,1
6030,"['atuam', 'dificuldad', 'fluxo', 'metropolitano', 'regiao']","[1, 1, 1, 1, 1]","[]","[]",5,0,5,1
6031,"['anteontem', 'anteontem', 'crescimento', 'crescimento', 'decorrencia', 'ritmar', 'ritmar', 'subir']","[2, 2, 2, 2, 1, 2, 2, 1]","[]","[]",8,0,8,1
6032,"['compromisso', 'previsao', 'regiao', 'regiao']","[1, 1, 2, 2]","[]","[]",4,0,4,1
6033,"['compromisso', 'exigencia', 'exigencia', 'facilitar', 'instituto', 'necessario', 'obtido', 'previsao', 'provisorio', 'risco', 'saudar']","[1, 2, 2, 1, 1, 1, 1, 1, 1, 1, 1]","['versao']","[1]",11,1,12,1
6034,"['ambientar', 'definitivo', 'deltan', 'folhar', 'folhar', 'folhar', 'magistrado', 'regrar', 'sabado', 'sentenca', 'supremo', 'suspeito']","[1, 1, 1, 3, 3, 3, 1, 1, 1, 1, 1, 1]","['amigar']","[1]",12,1,13,1
6037,"['alteracao', 'opcao', 'quarentenar', 'quarentenar', 'rotina', 'saudar', 'situacao']","[1, 1, 2, 2, 1, 1, 1]","[]","[]",7,0,7,1
6039,"['lancamento', 'lancamento', 'mudanca', 'mudanca']","[2, 2, 2, 2]","['ganhar']","[1]",4,1,5,1
6042,"['boletim', 'caxia', 'duqu', 'funcao', 'goncalo', 'periodo', 'saudar', 'suspeito']","[1, 1, 1, 1, 1, 1, 1, 1]","[]","[]",8,0,8,1
6044,"['escalar', 'iniciativo']","[1, 1]","[]","[]",2,0,2,1
6045,"['corpu', 'decisao', 'habea', 'henriqu', 'justicar', 'justicar', 'justicar', 'justicar', 'lavagem', 'lavagem', 'processo', 'recurso', 'reflexo', 'tramitar', 'turma']","[1, 1, 1, 1, 4, 4, 4, 4, 2, 2, 1, 1, 1, 1, 1]","[]","[]",15,0,15,1
6046,"['associacao', 'intensivo', 'intubacao', 'privar', 'saudar', 'saudar', 'saudar', 'saudar']","[1, 1, 1, 1, 4, 4, 4, 4]","[]","[]",8,0,8,1
6048,"['araujo', 'avancar', 'condicao', 'contagioso', 'contencao', 'destacar', 'imunizacao', 'mutacao', 'necessidad', 'presenca', 'renata', 'renata', 'respectivament', 'reuniao']","[1, 1, 1, 1, 1, 1, 1, 1, 1, 1, 2, 2, 1, 1]","['versao']","[1]",14,1,15,1
6050,"['aglomeracao', 'bbc', 'circulacao', 'importancia', 'imunizacao', 'paralelo', 'respiratorio', 'saudar', 'saudar', 'saudar', 'situacao']","[1, 1, 1, 1, 1, 1, 1, 3, 3, 3, 1]","[]","[]",11,0,11,1
6052,"['integro', 'obtido', 'oficio', 'pagamento', 'pslsp']","[1, 1, 1, 1, 1]","[]","[]",5,0,5,1
6055,"['balancar', 'balancar', 'domingo', 'globonew', 'mudanca', 'saudar', 'saudar', 'subir', 'subir', 'suspeito']","[2, 2, 1, 1, 1, 2, 2, 2, 2, 1]","[]","[]",10,0,10,1
6057,"['adulto', 'andrea', 'andrea', 'desafio', 'desafio', 'desafio', 'desafio', 'desafio', 'fase', 'infancia', 'necessidad', 'none', 'porqu', 'proprio', 'renata', 'renata', 'risco', 'risco', 'sociai', 'sociai', 'superar', 'tambem']","[1, 2, 2, 5, 5, 5, 5, 5, 1, 1, 1, 1, 1, 1, 2, 2, 2, 2, 2, 2, 1, 1]","[]","[]",22,0,22,1
6060,"['acordo', 'acordo', 'acordo', 'acordo', 'contrato', 'crise', 'jornada', 'jornada', 'preservar', 'provisorio', 'suspenso']","[4, 4, 4, 4, 1, 1, 2, 2, 1, 1, 1]","[]","[]",11,0,11,1
6061,"['autoridad', 'infectar', 'positivar', 'saudar']","[1, 1, 1, 1]","[]","[]",4,0,4,1
6064,"['autoridad', 'colombio', 'comparacao', 'crise', 'crise', 'economia', 'economia', 'estimativo', 'juro', 'liderar', 'mexico', 'monetario', 'negativar', 'periodo', 'prazo', 'previsao', 'quedo', 'regiao', 'regiao', 'ritmar']","[1, 1, 1, 2, 2, 2, 2, 1, 1, 1, 1, 1, 1, 1, 1, 1, 1, 2, 2, 1]","[]","[]",20,0,20,1
6065,"['associacao', 'crise', 'esperancar', 'metropolitano', 'regiao', 'reuter', 'saudar']","[1, 1, 1, 1, 1, 1, 1]","['disseminar']","[1]",7,1,8,1
6066,"['apurar', 'compromisso', 'domingo', 'gabinet', 'integro', 'republico', 'viagem']","[1, 1, 1, 1, 1, 1, 1]","[]","[]",7,0,7,1
6069,"['quarentenar']","[1]","['chorar', 'chorar', 'imagem']","[2, 2, 1]",1,3,4,1
6073,"['colombio', 'jornada', 'mexico', 'mexico', 'mexico', 'mexico', 'michael', 'michael', 'michael', 'respectivament', 'viagem']","[1, 1, 4, 4, 4, 4, 3, 3, 3, 1, 1]","['arquivar', 'imagem']","[1, 1]",11,2,13,1
6076,"['apurar', 'augusto', 'augusto', 'celso', 'condicao', 'estrategia', 'exministro', 'exministro', 'inquerito', 'interlocutor', 'investigacao', 'justicar', 'mello', 'ministrar', 'necessario', 'palacio', 'palacio', 'planalto', 'planalto', 'republico', 'reuniao', 'supremo']","[1, 2, 2, 1, 1, 1, 2, 2, 1, 1, 1, 1, 1, 1, 1, 2, 2, 2, 2, 1, 1, 1]","[]","[]",22,0,22,1
6080,"['afastamento', 'aprovacao', 'congresso', 'constituicao', 'decisao', 'desenvolvimento', 'emendar', 'funcao', 'funcao', 'funcao', 'fundeb', 'manutencao', 'proposto']","[1, 1, 1, 1, 1, 1, 1, 3, 3, 3, 1, 1, 1]","[]","[]",13,0,13,1
6081,"['destinar', 'distrito', 'funcionamento', 'funcionamento', 'habitant', 'intensivo', 'levantamento', 'orientacao', 'reforcar', 'regiao', 'regiao', 'saudar']","[1, 1, 2, 2, 1, 1, 1, 1, 1, 2, 2, 1]","[]","[]",12,0,12,1
6085,"['academiar', 'epicentro', 'epidemiar', 'infectar', 'instituto', 'liderar', 'respiratorio', 'saudar']","[1, 1, 1, 1, 1, 1, 1, 1]","[]","[]",8,0,8,1
6088,"['ambientar', 'apreensao', 'atuacao', 'avancar', 'compromisso', 'decisao', 'desenvolvimento', 'desmatamento', 'desmatamento', 'desmatamento', 'desmatamento', 'desmatamento', 'dificuldad', 'equipamento', 'indicador', 'mantido', 'margem', 'obtido', 'preocupacao', 'prever', 'quilometro', 'reducao', 'reducao', 'regiao', 'republico', 'significativo']","[1, 1, 1, 1, 1, 1, 1, 5, 5, 5, 5, 5, 1, 1, 1, 1, 1, 1, 1, 1, 1, 2, 2, 1, 1, 1]","['narrativo']","[1]",26,1,27,1
6092,"['domicilio', 'necessario', 'periodo', 'perspectivo', 'preparacao', 'quarentenar', 'quarentenar', 'rotina', 'rotina', 'saudad', 'situacao', 'treino', 'treino']","[1, 1, 1, 1, 1, 2, 2, 2, 2, 1, 1, 2, 2]","['sobrar']","[1]",13,1,14,1
6093,"['atrasar', 'atrasar', 'competicao', 'concedido', 'confederacao', 'confederacao', 'confederacao', 'confederacao', 'contrato', 'decisao', 'decisao', 'especialment', 'inedito', 'justicar', 'parcelar', 'recurso', 'relativo', 'sindicato', 'sindicato', 'transmissao']","[2, 2, 1, 1, 4, 4, 4, 4, 1, 2, 2, 1, 1, 1, 1, 1, 1, 2, 2, 1]","[]","[]",20,0,20,1
6094,"['acompanhamento', 'acompanhamento', 'acumular', 'diagnosticar', 'saudar']","[2, 2, 1, 1, 1]","[]","[]",5,0,5,1
6095,"['arthur', 'arthur', 'lira', 'lira', 'palacio', 'planalto', 'ppal', 'subir']","[2, 2, 2, 2, 1, 1, 1, 1]","[]","[]",8,0,8,1
6097,"['alcolumbr', 'autonomia', 'autonomia', 'demap', 'plenario', 'possibilidad', 'prever']","[1, 2, 2, 1, 1, 1, 1]","[]","[]",7,0,7,1
6098,"['ambito', 'augusto', 'autoridad', 'autoridad', 'barroso', 'barroso', 'barroso', 'barroso', 'celso', 'constituicao', 'decisao', 'edson', 'estabilidad', 'fachin', 'funcao', 'integrant', 'interpretar', 'justicar', 'mello', 'ministrar', 'plenario', 'plenario', 'precedent', 'previsto', 'privilegiar', 'processo', 'republico', 'supremo', 'supremo', 'tramitar']","[1, 1, 2, 2, 4, 4, 4, 4, 1, 1, 1, 1, 1, 1, 1, 1, 1, 1, 1, 1, 2, 2, 1, 1, 1, 1, 1, 2, 2, 1]","['atribuir']","[1]",30,1,31,1
6101,"['aprovacao', 'associacao', 'associacao', 'biliao', 'biliao', 'biliao', 'celso', 'economia', 'economia', 'especifico', 'gued', 'gued', 'ministrar', 'ministrar', 'mudanca', 'necessidad', 'pastar', 'presidir', 'prever', 'privar', 'privar', 'semestr', 'sugestao', 'sugestao']","[1, 2, 2, 3, 3, 3, 1, 2, 2, 1, 2, 2, 2, 2, 1, 1, 1, 1, 1, 2, 2, 1, 2, 2]","['bandeiro', 'espalhar']","[1, 1]",24,2,26,1
6102,"['guarulho', 'irregularidad', 'justicar', 'processo']","[1, 1, 1, 1]","[]","[]",4,0,4,1
6103,"['assistencia', 'associacao', 'destinar', 'provincia', 'provincia', 'quadro', 'saudar', 'toquio']","[1, 1, 1, 2, 2, 1, 1, 1]","[]","[]",8,0,8,1
6104,"['parceiro', 'quarentenar', 'regrar', 'treinar', 'treinar']","[1, 1, 1, 2, 2]","['compartilhar', 'imagem', 'legendar']","[1, 1, 1]",5,3,8,1
6105,"['desenvolvimento', 'exigencia', 'fase', 'funcionamento', 'reabertura', 'regrar']","[1, 1, 1, 1, 1, 1]","[]","[]",6,0,6,1
6106,"['heleno', 'instituto', 'saudar', 'wilson', 'witzel', 'witzel', 'witzel', 'witzel']","[1, 1, 1, 1, 4, 4, 4, 4]","['compartilhar', 'legendar']","[1, 1]",8,2,10,1
6107,"['economia', 'exigencia', 'gued', 'gued', 'gued', 'gued', 'integro', 'ministrar', 'ministrar', 'ministrar', 'privar', 'reuniao', 'saudar']","[1, 1, 4, 4, 4, 4, 1, 3, 3, 3, 1, 1, 1]","['enderecar', 'parabem', 'preencher']","[1, 1, 1]",13,3,16,1
6109,"['amplo', 'colunista', 'decisao', 'dialogo']","[1, 1, 1, 1]","[]","[]",4,0,4,1
6111,"['adicionar', 'afp', 'apreensao', 'congresso', 'crise', 'extensao', 'institut']","[1, 1, 1, 1, 1, 1, 1]","[]","[]",7,0,7,1
6112,"['biliao', 'broadcast', 'conformar', 'congresso', 'demrj', 'plenario', 'prazo', 'proposto', 'proposto', 'requerimento', 'tesourar', 'transferencia']","[1, 1, 1, 1, 1, 1, 1, 2, 2, 1, 1, 1]","[]","[]",12,0,12,1
6114,"['crise', 'decisao', 'republico']","[1, 1, 1]","[]","[]",3,0,3,1
6115,"['associacao', 'associacao', 'atuam', 'cnj', 'cnj', 'cnj', 'decisao', 'descumprir', 'gestant', 'justicar', 'ministrar', 'ministrar', 'orientacao', 'propagacao', 'provisorio', 'reducao', 'rejeitar', 'rejeitar', 'republico', 'republico', 'resolucao', 'resolucao', 'resolucao', 'sobretudo', 'supremo', 'transferir']","[2, 2, 1, 3, 3, 3, 1, 1, 1, 1, 2, 2, 1, 1, 1, 1, 2, 2, 2, 2, 3, 3, 3, 1, 1, 1]","[]","[]",26,0,26,1
6116,"['sorocaba']","[1]","['compartilhar']","[1]",1,1,2,1
6117,"['autoridad', 'decisao', 'disseminacao', 'esperancar', 'europeu', 'fronteiro', 'inglaterra', 'preventivo', 'propagacao', 'quilometro', 'quilometro', 'quilometro', 'saudar']","[1, 1, 1, 1, 1, 1, 1, 1, 1, 3, 3, 3, 1]","['espalhar']","[1]",13,1,14,1
6119,"['biliao', 'condicao', 'decorrent', 'impulsionar', 'iniciativo', 'monetario', 'necessario', 'preservacao', 'reducao', 'regulamentar', 'reuniao', 'reuter', 'temporario', 'volumar']","[1, 1, 1, 1, 1, 1, 1, 1, 1, 1, 1, 1, 1, 1]","[]","[]",14,0,14,1
6124,"['acordo', 'associacao', 'associacao', 'desmatamento', 'entregu', 'equivalent', 'instituto', 'levantamento']","[1, 2, 2, 1, 1, 1, 1, 1]","['fotografia', 'fotografia']","[2, 2]",8,2,10,1
6125,"['diariament', 'preliminar', 'preliminar']","[1, 2, 2]","['nasal']","[1]",3,1,4,1
6128,"['claudio', 'equipamento', 'exercicio', 'henriqu', 'ministrar', 'presenca', 'previsto', 'provisorio', 'republico', 'transmissao']","[1, 1, 1, 1, 1, 1, 1, 1, 1, 1]","[]","[]",10,0,10,1
6132,"['cenario', 'cerimonia', 'necessario', 'presenca', 'suspeito']","[1, 1, 1, 1, 1]","['caixao']","[1]",5,1,6,1
6133,"['decisao', 'flavia', 'imunizacao', 'possibilidad']","[1, 1, 1, 1]","['crech']","[1]",4,1,5,1
6135,"['biliao', 'destacar', 'destinar', 'extraordinario', 'parceria', 'pastar', 'prever', 'previsao', 'provisorio', 'reforcar', 'reforcar', 'saudar', 'saudar', 'secretarioexecutivo']","[1, 1, 1, 1, 1, 1, 1, 1, 1, 2, 2, 2, 2, 1]","[]","[]",14,0,14,1
6137,"['adversario', 'colegio', 'comissao', 'discussao', 'internar', 'logistico', 'palacio', 'planalto', 'precedent', 'previo', 'previo', 'previo', 'previo', 'previo', 'tucano']","[1, 1, 1, 1, 1, 1, 1, 1, 1, 5, 5, 5, 5, 5, 1]","[]","[]",15,0,15,1
6138,"['alteracao', 'balancar', 'boletim', 'comissao', 'demrj', 'domingo', 'domingo', 'estatistico', 'externo', 'infectar', 'painel', 'saudar', 'saudar', 'saudar']","[1, 1, 1, 1, 1, 2, 2, 1, 1, 1, 1, 3, 3, 3]","[]","[]",14,0,14,1
6140,"['arrecadacao', 'constituicao', 'crise', 'decorrent', 'dificuldad', 'economia', 'exercicio', 'flexibilizacao', 'gued', 'ministrar', 'pagamento', 'possibilidad', 'reuniao', 'transferencia', 'tributario']","[1, 1, 1, 1, 1, 1, 1, 1, 1, 1, 1, 1, 1, 1, 1]","[]","[]",15,0,15,1
6143,"['alunar', 'bbc', 'dificuldad', 'dificuldad', 'esforco', 'habitant', 'marilia']","[1, 1, 2, 2, 1, 1, 1]","[]","[]",7,0,7,1
6144,"['consecutivo', 'crescimento', 'crise', 'decorrent', 'gabinet', 'indicador', 'internacao', 'internar', 'quedo', 'reducao', 'reducao', 'regiao', 'significativo']","[1, 1, 1, 1, 1, 1, 1, 1, 1, 2, 2, 1, 1]","['bandeiro']","[1]",13,1,14,1
6145,"[]","[]","[]","[]",0,0,0,1
6146,"['destinar', 'dosar', 'dosar', 'esquema', 'esquema', 'esquema', 'esquema', 'federativo', 'instituto', 'materiaprima', 'operacionalizacao', 'pastar', 'planar', 'previsao', 'prioritario', 'saudar']","[1, 2, 2, 4, 4, 4, 4, 1, 1, 1, 1, 1, 1, 1, 1, 1]","[]","[]",16,0,16,1
6148,"['inglaterra', 'moderno', 'quilometro', 'tambem']","[1, 1, 1, 1]","[]","[]",4,0,4,1
6149,"['adiamento', 'adiamento', 'calendario', 'condenacao', 'constituicao', 'decisao', 'decisao', 'emendar', 'intervalar', 'mudanca', 'pratico', 'prazo', 'punicao']","[2, 2, 1, 1, 1, 2, 2, 1, 1, 1, 1, 1, 1]","['abusar']","[1]",13,1,14,1
6155,"['afp', 'balancar', 'compilar', 'contabil', 'diagnosticar', 'diagnosticar', 'espanha', 'mudanca', 'notificar', 'oficialment', 'oficialment', 'prioridad', 'rastreamento', 'revisar']","[1, 1, 1, 1, 2, 2, 1, 1, 1, 2, 2, 1, 1, 1]","[]","[]",14,0,14,1
6156,"['argumentar', 'comissao', 'constituicao', 'crise', 'demrj', 'entregu', 'exministro', 'inquerito', 'justicar', 'prioridad', 'processo', 'republico', 'saudar']","[1, 1, 1, 1, 1, 1, 1, 1, 1, 1, 1, 1, 1]","['verificar']","[1]",13,1,14,1
6157,"['araujo', 'cooperacao', 'cupula', 'cupula', 'desmatamento', 'desmatamento', 'diplomata', 'ernesto', 'organizador', 'periodo', 'reuniao', 'sessao', 'situacao']","[1, 1, 2, 2, 2, 2, 1, 1, 1, 1, 1, 1, 1]","[]","[]",13,0,13,1
6158,"['ambientar', 'incerteza', 'integrant', 'integrant', 'ministrar', 'ministrar', 'permanencia', 'preocupacao', 'ricardo', 'sall', 'sall', 'saudar', 'saudar', 'saudar', 'situacao', 'transmissao']","[1, 1, 2, 2, 2, 2, 1, 1, 1, 2, 2, 3, 3, 3, 1, 1]","[]","[]",16,0,16,1
6159,"['autoridad', 'contabiliza', 'impacto', 'informaco', 'interrupcao', 'investigacao', 'isolar', 'medida', 'medida', 'monitoramento', 'painel', 'plena', 'profissionai', 'resistencia', 'rossi', 'serao', 'sindicato', 'tambem', 'temporariament', 'temporariament', 'transmissao']","[1, 1, 1, 1, 1, 1, 1, 2, 2, 1, 1, 1, 1, 1, 1, 1, 1, 1, 2, 2, 1]","['compartilhar', 'greve']","[1, 1]",21,2,23,1
6160,"['flavio', 'funcao', 'fundeb', 'importancia', 'instituto', 'ministrar', 'ministrar', 'ministrar', 'parceria', 'piorar', 'planar', 'previsto', 'sabado', 'supremo']","[1, 1, 1, 1, 1, 3, 3, 3, 1, 1, 1, 1, 1, 1]","['realment']","[1]",14,1,15,1
6161,"['afastamento', 'client', 'client', 'externo', 'fluxo', 'higienizacao', 'manutencao', 'pagamento', 'pagamento', 'reforcar', 'sabado']","[1, 2, 2, 1, 1, 1, 1, 2, 2, 1, 1]","['humanar', 'sacar', 'sacar', 'sacar']","[1, 3, 3, 3]",11,4,15,1
6163,"['adotada', 'coletivo', 'disseminacao', 'ministrar', 'passageiro', 'plenario', 'privar', 'privar', 'supremo', 'vetar']","[1, 1, 1, 1, 1, 1, 2, 2, 1, 1]","[]","[]",10,0,10,1
6164,"['comparacao', 'economia', 'economia', 'proporcao', 'quedo', 'requerimento']","[1, 2, 2, 1, 1, 1]","[]","[]",6,0,6,1
6166,"['aglomeracao', 'queixar', 'recebido', 'regulamentar']","[1, 1, 1, 1]","['cartaz']","[1]",4,1,5,1
6170,"['consumidor', 'demand', 'inovacao', 'parceria', 'possibilidad', 'transmissao']","[1, 1, 1, 1, 1, 1]","['botao', 'imagem']","[1, 1]",6,2,8,1
6171,"[]","[]","[]","[]",0,0,0,1
6172,"['apreensao', 'apreensao', 'apreensao', 'autoridad', 'justicar']","[3, 3, 3, 1, 1]","['cocaina']","[1]",5,1,6,1
6173,"['anvisa', 'autoridad', 'autorizacao', 'calamidad', 'calamidad', 'decorrencia', 'emergenciai', 'escalar', 'importacao', 'reconhecimento', 'reconhecimento', 'regrar', 'saudar', 'saudar', 'saudar', 'vigilancia']","[1, 1, 1, 2, 2, 1, 1, 1, 1, 2, 2, 1, 3, 3, 3, 1]","[]","[]",16,0,16,1
6176,"['alerj', 'alerj', 'claudio', 'claudio', 'converso', 'delacao', 'delacao', 'delacao', 'destinar', 'esquema', 'exercicio', 'legislativo', 'saudar', 'transferencia', 'wilson', 'witzel']","[2, 2, 2, 2, 1, 3, 3, 3, 1, 1, 1, 1, 1, 1, 1, 1]","[]","[]",16,0,16,1
6178,"['afp', 'correspondent', 'periodo', 'proviso']","[1, 1, 1, 1]","[]","[]",4,0,4,1
6179,"['desgastar', 'mexico', 'punicao', 'republico', 'sancao', 'transmissao']","[1, 1, 1, 1, 1, 1]","['postagen']","[1]",6,1,7,1
6181,"['agravar', 'anvisa', 'comparacao', 'conformar', 'demandar', 'diminuicao', 'expressivo', 'flexibilizacao', 'privar', 'quadro', 'quedo', 'quedo', 'reforcar', 'regiao', 'saudar', 'saudar', 'saudar', 'saudar', 'saudar', 'situacao', 'vigilancia']","[1, 1, 1, 1, 1, 1, 1, 1, 1, 1, 2, 2, 1, 1, 5, 5, 5, 5, 5, 1, 1]","[]","[]",21,0,21,1
6182,"['assintomatico', 'infectar', 'regiao']","[1, 1, 1]","[]","[]",3,0,3,1
6183,"['fluxo', 'inglaterra', 'movimentacao', 'obtido', 'passageiro', 'primeiroministro', 'regrar', 'regrar', 'relaxamento']","[1, 1, 1, 1, 1, 1, 2, 2, 1]","['imagem', 'motorista']","[1, 1]",9,2,11,1
6184,"['amplo', 'amplo', 'preconceito', 'republico', 'tendencia']","[2, 2, 1, 1, 1]","['assassinar', 'assassinar', 'verdadeiro']","[2, 2, 1]",5,3,8,1
6190,"['bbc', 'chefiar', 'mutacao', 'nelson', 'oliveira', 'oliveira', 'oliveira', 'preocupacao', 'saudar', 'transmissao']","[1, 1, 1, 1, 3, 3, 3, 1, 1, 1]","['assinalar', 'circular', 'compartilhar']","[1, 1, 1]",10,3,13,1
6194,"['alckmin', 'alckmin', 'alckmin', 'condenacao', 'deflagrar', 'exgovernador', 'exgovernador', 'fase', 'geraldo', 'geraldo', 'investigacao', 'investigacao', 'justicar', 'lavagem', 'plano', 'respostar', 'respostar', 'saudar', 'suspeito']","[3, 3, 3, 1, 1, 2, 2, 1, 2, 2, 2, 2, 1, 1, 1, 2, 2, 1, 1]","[]","[]",19,0,19,1
6195,"['acumular', 'acumular', 'curvo', 'dificultar', 'intenso', 'planalto', 'pratico', 'regrar', 'relativo', 'respostar', 'saudar']","[2, 2, 1, 1, 1, 1, 1, 1, 1, 1, 1]","['manobrar']","[1]",11,1,12,1
6196,"['arrecadacao', 'biliao', 'comparacao', 'comparacao', 'crise', 'economia', 'folhar', 'impactar', 'integro', 'periodo', 'tendencia']","[1, 1, 2, 2, 1, 1, 1, 1, 1, 1, 1]","[]","[]",11,0,11,1
6197,"['antecipar', 'iniciativo', 'justicar', 'mudanca', 'saudar']","[1, 1, 1, 1, 1]","[]","[]",5,0,5,1
6199,"['diagnosticar']","[1]","[]","[]",1,0,1,1
6200,"['constatar', 'espanha', 'independentement', 'possibilidad', 'saudar']","[1, 1, 1, 1, 1]","[]","[]",5,0,5,1
6203,"['ambientar', 'associacao', 'avancar', 'epidemiar', 'estimativo', 'periodo', 'renata', 'renata', 'renata', 'rocha', 'roraima', 'sarampo']","[1, 1, 1, 1, 1, 1, 3, 3, 3, 1, 1, 1]","[]","[]",12,0,12,1
6206,"['conjuntar', 'henriqu', 'sindicato']","[1, 1, 1]","['parir', 'reivindicar']","[1, 1]",3,2,5,1
6207,"['andrew', 'anuncio', 'anvisa', 'estagio', 'etapa', 'fase', 'fase', 'fundacao', 'oswaldo', 'vigilancia']","[1, 1, 1, 1, 1, 2, 2, 1, 1, 1]","[]","[]",10,0,10,1
6211,"['diariament', 'viagem']","[1, 1]","['menino']","[1]",2,1,3,1
6213,"['barroso', 'especialment', 'estatistico', 'fluxo', 'justicar', 'levantamento']","[1, 1, 1, 1, 1, 1]","['checagem', 'verificacao']","[1, 1]",6,2,8,1
6214,"['aplicacao', 'armazenamento', 'liderar', 'previsao', 'substituto', 'tendencia']","[1, 1, 1, 1, 1, 1]","[]","[]",6,0,6,1
6215,"['cardiologista', 'cardiologista', 'defendido', 'divergencia', 'henriqu', 'medida', 'nelson', 'nomeacao', 'opcao', 'queiroga', 'queiroga', 'queiroga', 'reforca', 'sendo', 'teich']","[2, 2, 1, 1, 1, 1, 1, 1, 1, 3, 3, 3, 1, 1, 1]","[]","[]",15,0,15,1
6216,"['condicao', 'disseminacao', 'epicentro', 'estabilidad', 'estatistico', 'examinar', 'externo', 'genoma', 'hubei', 'infeccioso', 'infeccioso', 'infectar', 'infectar', 'infectar', 'instituto', 'mudanca', 'mutacao', 'previsto', 'provincia', 'respiratorio', 'respostar', 'respostar', 'risco', 'sigla', 'surtir', 'taxar', 'transmissao']","[1, 1, 1, 1, 1, 1, 1, 1, 1, 2, 2, 3, 3, 3, 1, 1, 1, 1, 1, 1, 2, 2, 1, 1, 1, 1, 1]","['acidentar', 'replicar']","[1, 1]",27,2,29,1
6217,"['circulacao', 'domingo', 'domingo', 'domingo', 'propagacao']","[1, 3, 3, 3, 1]","[]","[]",5,0,5,1
6221,"['atuacao', 'congresso', 'enxergar']","[1, 1, 1]","[]","[]",3,0,3,1
6223,"['anvisa', 'definitivo', 'imunizacao', 'ministrar', 'ministrar', 'planar', 'respostar', 'saudar', 'vigilancia']","[1, 1, 1, 2, 2, 1, 1, 1, 1]","[]","[]",9,0,9,1
6224,"['acumular', 'atuacao', 'autoridad', 'avancar', 'especialment', 'especifico', 'flexibilizacao', 'funcao', 'jorg', 'jorg', 'justicar', 'ministrar', 'ministrar', 'ministrar', 'oliveira', 'oliveira', 'palacio', 'planalto', 'pslsp', 'revisar', 'revisar', 'secretariager', 'secretariager', 'secretariager', 'sigla']","[1, 1, 1, 1, 1, 1, 1, 1, 2, 2, 1, 3, 3, 3, 2, 2, 1, 1, 1, 2, 2, 3, 3, 3, 1]","[]","[]",25,0,25,1
6226,"['consorcio', 'decorrencia', 'diariament', 'levantamento', 'periodo', 'saudar']","[1, 1, 1, 1, 1, 1]","[]","[]",6,0,6,1
6229,"['compilar', 'intervalar', 'levantamento', 'oficialment', 'periodo', 'recebido', 'saudar', 'subir', 'taxar']","[1, 1, 1, 1, 1, 1, 1, 1, 1]","[]","[]",9,0,9,1
6231,"['complicacao', 'integro', 'internar', 'ministrar', 'pslsp']","[1, 1, 1, 1, 1]","[]","[]",5,0,5,1
6232,"['distrito', 'folhar', 'imunizacao', 'integro', 'operacionalizacao', 'planar', 'prioritario', 'prioritario', 'saudar']","[1, 1, 1, 1, 1, 1, 2, 2, 1]","[]","[]",9,0,9,1
6233,"['administrativo', 'ambientar', 'ambientar', 'ambientar', 'ambientar', 'atuam', 'chefiar', 'conservacao', 'exonerar', 'federar', 'instituto', 'instituto', 'ministrar', 'ricardo', 'ricardo', 'sall', 'sall', 'servidor', 'substituto']","[1, 4, 4, 4, 4, 1, 1, 1, 1, 1, 2, 2, 1, 2, 2, 2, 2, 1, 1]","['soldar']","[1]",19,1,20,1
6234,"['arthur', 'exgovernador', 'exprefeito', 'integrant', 'precandidato', 'tambem', 'tucano']","[1, 1, 1, 1, 1, 1, 1]","[]","[]",7,0,7,1
6238,"['assistencia', 'avancar', 'batalhar', 'contrato', 'contrato', 'emergenciai', 'instituto', 'recurso', 'regiao', 'saudar', 'saudar', 'saudar', 'suspenso', 'wilson', 'witzel']","[1, 1, 1, 2, 2, 1, 1, 1, 1, 3, 3, 3, 1, 1, 1]","[]","[]",15,0,15,1
6239,"['apreensao', 'bolsonarista', 'chefiar', 'contrato', 'desvio', 'emergenciai', 'epicentro', 'exministro', 'flavio', 'flavio', 'heleno', 'intenso', 'palacio', 'planar', 'republicanosrj', 'republico', 'respectivament', 'saudar', 'suspeito', 'suspeito', 'wilson', 'witzel', 'witzel', 'witzel', 'witzel', 'witzel']","[1, 1, 1, 1, 1, 1, 1, 1, 2, 2, 1, 1, 1, 1, 1, 1, 1, 1, 2, 2, 1, 5, 5, 5, 5, 5]","['fraudar']","[1]",26,1,27,1
6240,"['passageiro', 'periferia', 'periferia', 'preventivo', 'regrar']","[1, 2, 2, 1, 1]","['agredir', 'motorista', 'parir', 'parir', 'parir']","[1, 1, 3, 3, 3]",5,5,10,1
6241,"['dedicar', 'destinar', 'help', 'parceria']","[1, 1, 1, 1]","['basto', 'compartilhar', 'ganhar', 'gravacao']","[1, 1, 1, 1]",4,4,8,1
6242,"['decisao', 'flexibilizar', 'regrar', 'supremo']","[1, 1, 1, 1]","[]","[]",4,0,4,1
6243,"['celso', 'tucano', 'vespera']","[1, 1, 1]","[]","[]",3,0,3,1
6244,"['institut', 'observar', 'saudar']","[1, 1, 1]","[]","[]",3,0,3,1
6246,"['caxia', 'enfrentamento', 'estrategico', 'goncalv', 'necessario', 'orientacao', 'parcelar', 'pastar', 'pastar', 'planar', 'prorrogacao', 'prorrogacao', 'prorrogar', 'prorrogar', 'saudar', 'saudar', 'saudar', 'saudar', 'saudar', 'taxar']","[1, 1, 1, 1, 1, 1, 1, 2, 2, 1, 2, 2, 2, 2, 5, 5, 5, 5, 5, 1]","[]","[]",20,0,20,1
6247,"['balancar', 'internacao', 'internacao', 'internacao', 'internar', 'internar', 'periodo', 'quedo', 'quedo', 'quedo', 'reducao', 'taxar']","[1, 3, 3, 3, 2, 2, 1, 3, 3, 3, 1, 1]","[]","[]",12,0,12,1
6248,"['administrativo', 'afastamento', 'conformar', 'economia', 'forcatarefa', 'gued', 'gued', 'gued', 'gued', 'investigacao', 'investigacao', 'ministrar', 'ministrar', 'supremo', 'vespera']","[1, 1, 1, 1, 1, 4, 4, 4, 4, 2, 2, 2, 2, 1, 1]","['legendar']","[1]",15,1,16,1
6249,"['henri', 'intenso']","[1, 1]","['nobel']","[1]",2,1,3,1
6250,"['ausencia', 'dedicar', 'enfermagem', 'internacao', 'saudar']","[1, 1, 1, 1, 1]","[]","[]",5,0,5,1
6251,"['exministro', 'justicar']","[1, 1]","[]","[]",2,0,2,1
6252,"['adotada', 'advocaciager', 'expansao', 'henriqu', 'justicar', 'mendonca', 'ministrar', 'ministrar', 'ministrar', 'ministrar', 'orientacao', 'palacio', 'planalto', 'saudar', 'secom', 'secom', 'situacao']","[1, 1, 1, 1, 1, 1, 4, 4, 4, 4, 1, 1, 1, 1, 2, 2, 1]","[]","[]",17,0,17,1
6254,"['biliao', 'decisao', 'destinar', 'destinar', 'instituto', 'julgamento', 'ministrar', 'privilegiar', 'recurso']","[1, 1, 2, 2, 1, 1, 1, 1, 1]","[]","[]",9,0,9,1
6257,"['bbc', 'rocha', 'velocidad']","[1, 1, 1]","[]","[]",3,0,3,1
6259,"['adicionar', 'aprovacao', 'biliao', 'biliao', 'desenvolvido', 'fabricacao', 'reuter', 'saudar']","[1, 1, 2, 2, 1, 1, 1, 1]","[]","[]",8,0,8,1
6260,"['adulto', 'aprovacao', 'saudar']","[1, 1, 1]","['torturar', 'verificacao']","[1, 1]",3,2,5,1
6261,"['apurar', 'atrasar', 'augusto', 'cenario', 'crise', 'crise', 'reducao', 'temporada', 'vencimento']","[1, 1, 1, 1, 2, 2, 1, 1, 1]","['ganhar', 'imagem']","[1, 1]",9,2,11,1
6262,"['mudanca', 'possibilidad']","[1, 1]","['circular', 'falsar', 'filmar', 'verdadeiro']","[1, 1, 1, 1]",2,4,6,1
6266,"['ambientar', 'apurar', 'internar', 'internar', 'internar', 'recuperacao', 'santiago', 'saudar', 'souza', 'superar', 'superar', 'totalizar']","[1, 1, 3, 3, 3, 1, 1, 1, 1, 2, 2, 1]","[]","[]",12,0,12,1
6267,"['habitant', 'taxar']","[1, 1]","[]","[]",2,0,2,1
6268,"['medida', 'medida', 'panamericana', 'profissionai', 'tambem', 'tambem', 'tambem', 'testagem']","[2, 2, 1, 1, 3, 3, 3, 1]","[]","[]",8,0,8,1
6270,"['entregu', 'gorinchteyn', 'imunizacao', 'inicialment', 'instituto', 'montant', 'presenca', 'saudar', 'saudar', 'saudar']","[1, 1, 1, 1, 1, 1, 1, 3, 3, 3]","[]","[]",10,0,10,1
6271,"['bancada', 'congresso', 'congresso', 'contribuicao', 'decisao', 'decisao', 'gued', 'situacao', 'vetar', 'vetar', 'vetar', 'vetar']","[1, 2, 2, 1, 2, 2, 1, 1, 4, 4, 4, 4]","[]","[]",12,0,12,1
6273,"['celebrar', 'decisao', 'diariament', 'florido', 'internar', 'possibilidad']","[1, 1, 1, 1, 1, 1]","['compartilhar']","[1]",6,1,7,1
6276,"['integro', 'intensivo', 'internar', 'saudar', 'taxar']","[1, 1, 1, 1, 1]","[]","[]",5,0,5,1
6279,"['fabricio', 'queiroz', 'recebido']","[1, 1, 1]","['catedr']","[1]",3,1,4,1
6280,"['araujo', 'biliao', 'carla', 'cenario', 'colunista', 'colunista', 'consequencia', 'discussao', 'discussao', 'presenca', 'respostar', 'significativo', 'situacao']","[1, 1, 1, 1, 2, 2, 1, 2, 2, 1, 1, 1, 1]","['minutar', 'minutar']","[2, 2]",13,2,15,1
6282,"['ministrar', 'ministrar', 'prazo', 'reuter', 'saudar']","[2, 2, 1, 1, 1]","[]","[]",5,0,5,1
6283,"['instituto', 'primeiroministro', 'regiao']","[1, 1, 1]","[]","[]",3,0,3,1
6284,"['diretoria', 'hospitalizar', 'infectar', 'intensivo', 'internar', 'internar', 'quedo', 'reducao', 'reforcar', 'regiao', 'saudar', 'vigilancia']","[1, 1, 1, 1, 2, 2, 1, 1, 1, 1, 1, 1]","['circular', 'parir', 'parir']","[1, 2, 2]",12,3,15,1
6285,"['atuam', 'bastidor', 'consenso', 'converso', 'cupula', 'fluminens', 'integro', 'interlocutor', 'reducao', 'sindicato']","[1, 1, 1, 1, 1, 1, 1, 1, 1, 1]","[]","[]",10,0,10,1
6287,"['apurar', 'companhia', 'consultoria', 'deteccao', 'especializar', 'inedito', 'inedito', 'lancamento', 'vulnerabilidad', 'vulnerabilidad']","[1, 1, 1, 1, 1, 2, 2, 1, 2, 2]","[]","[]",10,0,10,1
6288,"['aprovacao', 'aprovacao', 'autoridad', 'dosar', 'turista', 'turista', 'turistico']","[2, 2, 1, 1, 2, 2, 1]","['ganhar']","[1]",7,1,8,1
6291,"['barroso', 'barroso', 'celso', 'confederacao', 'definitivo', 'julgamento', 'mello', 'plenario', 'plenario', 'possibilidad', 'processo', 'processo', 'suspensa']","[2, 2, 1, 1, 1, 1, 1, 2, 2, 1, 2, 2, 1]","['postam']","[1]",13,1,14,1
6293,"['anuncio', 'atrasar', 'atrasar', 'republico', 'saudar', 'saudar']","[1, 2, 2, 1, 2, 2]","[]","[]",6,0,6,1
6295,"['economia', 'gued', 'ministrar', 'preconceito']","[1, 1, 1, 1]","[]","[]",4,0,4,1
6300,"['equivalent', 'flavio', 'flavio', 'folhar', 'obtido', 'oficio', 'pagamento', 'parcelar', 'recurso', 'recurso', 'recurso', 'regiao', 'relativo', 'republicanosrj', 'transferencia']","[1, 2, 2, 1, 1, 1, 1, 1, 3, 3, 3, 1, 1, 1, 1]","['mansao', 'mansao']","[2, 2]",15,2,17,1
6302,"[]","[]","['curioso', 'humanar']","[1, 1]",0,2,2,1
6306,"['administrativo', 'afastamento', 'araujo', 'atuacao', 'bancada', 'demmg', 'ernesto', 'indicador', 'itamarati', 'legislativo', 'legislativo', 'martim', 'martim', 'oficio', 'pacheco', 'pacheco', 'presenca', 'randolf', 'sessao', 'sessao', 'sessao']","[1, 1, 1, 1, 1, 1, 1, 1, 1, 2, 2, 2, 2, 1, 2, 2, 1, 1, 3, 3, 3]","[]","[]",21,0,21,1
6310,"['apurar', 'augusto', 'delacao', 'discussao', 'exgovernador', 'fux', 'gabinet', 'gabinet', 'inquerito', 'inquerito', 'interlocutor', 'ministrar', 'ministrar', 'recurso', 'recurso', 'republico', 'supremo']","[1, 1, 1, 1, 1, 1, 2, 2, 2, 2, 1, 2, 2, 2, 2, 1, 1]","[]","[]",17,0,17,1
6312,"['anticorpo', 'anticorpo', 'infectar', 'respostar']","[2, 2, 1, 1]","[]","[]",4,0,4,1
6314,"['chefiar', 'congresso', 'dedicar', 'governista', 'ministrar', 'plenario', 'provisorio']","[1, 1, 1, 1, 1, 1, 1]","[]","[]",7,0,7,1
6317,"['biliao', 'biliao', 'descumprir', 'inicialment', 'prever', 'proposto', 'respectivament']","[2, 2, 1, 1, 1, 1, 1]","['barragem', 'barragem']","[2, 2]",7,2,9,1
6318,"['deflagrar', 'federativo', 'justicar', 'justicar', 'parceria']","[1, 1, 2, 2, 1]","[]","[]",5,0,5,1
6321,"['antecipar', 'antecipar', 'decisao', 'decisao', 'desenvolvimento', 'desenvolvimento', 'destacar', 'feriar', 'feriar', 'feriar', 'mandatario', 'periodo', 'prever', 'propagacao', 'reforcar', 'regiao', 'reuniao', 'turista', 'turista']","[2, 2, 2, 2, 2, 2, 1, 3, 3, 3, 1, 1, 1, 1, 1, 1, 1, 2, 2]","['adorar']","[1]",19,1,20,1
6324,"['bolsonarista', 'comissao', 'comissao', 'comissao', 'decisao', 'decisao', 'dificultar', 'inquerito', 'palacio', 'planalto', 'prorrogar', 'reforcar']","[1, 3, 3, 3, 2, 2, 1, 1, 1, 1, 1, 1]","[]","[]",12,0,12,1
6328,"['apurar', 'decisao', 'extensao', 'iniciativo', 'itamarati', 'itamarati', 'mudanca', 'palacio', 'planalto', 'prazo', 'prazo', 'prazo', 'reuniao', 'reuniao', 'saudar']","[1, 1, 1, 1, 2, 2, 1, 1, 1, 3, 3, 3, 2, 2, 1]","[]","[]",15,0,15,1
6330,"['aplicacao', 'apostar', 'consultoria', 'extensao', 'folhar', 'mudanca', 'quarentenar', 'transmissao']","[1, 1, 1, 1, 1, 1, 1, 1]","['espalhar', 'lembres', 'pelar', 'pelar']","[1, 1, 2, 2]",8,4,12,1
6332,"['acordo', 'contrato', 'contrato', 'destacar', 'fundacao', 'instituto', 'milho', 'milho', 'milho', 'oswaldo', 'pfizerbiontech', 'porqu', 'queiroga', 'queiroga', 'queiroga', 'trimestr']","[1, 2, 2, 1, 1, 1, 3, 3, 3, 1, 1, 1, 3, 3, 3, 1]","[]","[]",16,0,16,1
6335,"['agravar', 'calheiro', 'depoimento', 'depoimento', 'disseminacao', 'elaborar', 'especialment', 'exministro', 'exministro', 'expectativa', 'governista', 'governista', 'henriqu', 'mdbal', 'orientacao', 'palacio', 'planalto', 'saudar']","[1, 1, 2, 2, 1, 1, 1, 2, 2, 1, 2, 2, 1, 1, 1, 1, 1, 1]","[]","[]",18,0,18,1
6336,"['colombio', 'espanha', 'levantamento', 'mexico', 'situacao']","[1, 1, 1, 1, 1]","[]","[]",5,0,5,1
6338,"['apurar']","[1]","['compartilhar', 'realment']","[1, 1]",1,2,3,1
6343,"['aurelio', 'aurelio', 'edson', 'fachin', 'fachin', 'julgamento', 'mello', 'ministrar', 'ministrar', 'ministrar', 'processo', 'supremo', 'turma', 'turma']","[2, 2, 1, 2, 2, 1, 1, 3, 3, 3, 1, 1, 2, 2]","[]","[]",14,0,14,1
6344,"['antecipar', 'anuncio', 'lorenzoni', 'ministrar', 'ministrar', 'onyx', 'parcelar', 'parcelar', 'parcelar', 'presenca', 'republico', 'respostar', 'revogar']","[1, 1, 1, 2, 2, 1, 3, 3, 3, 1, 1, 1, 1]","['imagem']","[1]",13,1,14,1
6345,"['autoridad', 'comparacao', 'dificulta', 'esforco', 'intensivo', 'mutacao', 'periodo', 'prazo', 'provincia', 'regiao', 'regiao', 'regiao', 'surto', 'tambem']","[1, 1, 1, 1, 1, 1, 1, 1, 1, 3, 3, 3, 1, 1]","[]","[]",14,0,14,1
6348,"['decisao', 'esquema', 'fabricio', 'flavio', 'flavio', 'flavio', 'gabinet', 'justicar', 'justicar', 'magistrado', 'oliveira', 'queiroz', 'queiroz', 'rachadinha', 'republicanosrj', 'restritivo', 'servidor', 'souza', 'turma']","[1, 1, 1, 3, 3, 3, 1, 2, 2, 1, 1, 2, 2, 1, 1, 1, 1, 1, 1]","['soltura']","[1]",19,1,20,1
6351,"['adotada', 'alergia', 'anticorpo', 'antonio', 'aspecto', 'calendario', 'calendario', 'celso', 'comissao', 'complicacao', 'desenvolvimento', 'desenvolvimento', 'destacar', 'efetividad', 'epidemiologico', 'estrategia', 'estrategia', 'gestant', 'lesao', 'lesao', 'lesao', 'logistico', 'pastar', 'possibilidad', 'preventivo', 'regiao', 'saudar', 'saudar', 'saudar', 'saudar', 'saudar', 'saudar', 'saudar', 'sustentabilidad']","[1, 1, 1, 1, 1, 2, 2, 1, 1, 1, 2, 2, 1, 1, 1, 2, 2, 1, 3, 3, 3, 1, 1, 1, 1, 1, 7, 7, 7, 7, 7, 7, 7, 1]","['pelar']","[1]",34,1,35,1
6353,"['anuncio', 'privar']","[1, 1]","['usuario', 'usuario', 'usuario']","[3, 3, 3]",2,3,5,1
6354,"['aliviar', 'confederacao', 'consequencia', 'constatar', 'fase', 'internar', 'negativar', 'piorar', 'piorar', 'privilegiar', 'saudar']","[1, 1, 1, 1, 1, 1, 1, 2, 2, 1, 1]","['amigar', 'verificar']","[1, 1]",11,2,13,1
6355,"['ambientar', 'biliao', 'condicao']","[1, 1, 1]","['carbono', 'dioxido']","[1, 1]",3,2,5,1
6356,"['crescimento', 'domingo', 'domingo', 'esforco', 'medida', 'periodo', 'porqu', 'resultado', 'transmissao', 'varga']","[1, 2, 2, 1, 1, 1, 1, 1, 1, 1]","['venezuelano']","[1]",10,1,11,1
6357,"['adiamento', 'ampliacao', 'depoimento', 'exministro', 'henriqu', 'nelson', 'pastar', 'pastar', 'saudar', 'teich', 'teich']","[1, 1, 1, 1, 1, 1, 2, 2, 1, 2, 2]","[]","[]",11,0,11,1
6358,"['biliao', 'biliao', 'biliao', 'confederacao', 'crise', 'expansao', 'fluxo', 'fronteiro', 'passageiro', 'periodo', 'quedo', 'reducao', 'reducao', 'ritmar']","[3, 3, 3, 1, 1, 1, 1, 1, 1, 1, 1, 2, 2, 1]","[]","[]",14,0,14,1
6359,"['araujo', 'articulacao', 'carla', 'colunista', 'domingo', 'domingo', 'economia', 'economia', 'federar', 'gued', 'ministrar', 'ministrar', 'pagamento', 'patamar', 'possibilidad', 'prorrogacao', 'reabertura']","[1, 1, 1, 1, 2, 2, 2, 2, 1, 1, 2, 2, 1, 1, 1, 1, 1]","[]","[]",17,0,17,1
6363,"['ambientar', 'congresso', 'crise', 'desenvolvimento', 'economia', 'ideologico', 'ideologico', 'implementar', 'parcelar', 'planalto', 'pratico', 'presidir', 'reajustar', 'supremo']","[1, 1, 1, 1, 1, 2, 2, 1, 1, 1, 1, 1, 1, 1]","['disseminar', 'sortir']","[1, 1]",14,2,16,1
6364,"['arthur', 'congresso', 'decisao', 'decisao', 'federar', 'gabinet', 'lira', 'lira', 'plenario', 'plenario', 'salao', 'salao', 'transferencia']","[1, 1, 2, 2, 1, 1, 2, 2, 2, 2, 2, 2, 1]","[]","[]",13,0,13,1
6366,"['opcao']","[1]","['sacar']","[1]",1,1,2,1
6367,"['arthur', 'bolsonarista', 'calculo', 'congresso', 'converso', 'estimular', 'exgovernador', 'governista', 'lira', 'necessario', 'opcao', 'percepcao', 'presidir', 'proposto', 'reforcar']","[1, 1, 1, 1, 1, 1, 1, 1, 1, 1, 1, 1, 1, 1, 1]","['acidentar', 'legendar']","[1, 1]",15,2,17,1
6370,"['adulto', 'adulto', 'adulto', 'aglomeracao', 'boletim', 'comportamento', 'conjuntar', 'especifico', 'expressivo', 'higienizacao', 'levantamento', 'necessario', 'observar', 'parceria', 'pastar', 'pastar', 'pratico', 'pratico', 'propagacao', 'saudar', 'saudar', 'saudar', 'subir']","[3, 3, 3, 1, 1, 1, 1, 1, 1, 1, 1, 1, 1, 1, 2, 2, 2, 2, 1, 3, 3, 3, 1]","[]","[]",23,0,23,1
6371,"['consequencia', 'contagioso', 'deteccao', 'deteccao', 'disseminacao', 'dosar', 'esforco', 'esforco', 'impactar', 'imunizacao', 'imunizacao', 'imunizacao', 'insuficient', 'interrupcao', 'piorar', 'precaucao', 'proliferacao', 'propagacao', 'sarampo', 'sarampo', 'sarampo', 'sarampo', 'sarampo', 'sarampo', 'sarampo', 'sarampo', 'saudar', 'saudar', 'saudar', 'saudar', 'saudar', 'saudar', 'temporario']","[1, 1, 2, 2, 1, 1, 2, 2, 1, 3, 3, 3, 1, 1, 1, 1, 1, 1, 8, 8, 8, 8, 8, 8, 8, 8, 6, 6, 6, 6, 6, 6, 1]","[]","[]",33,0,33,1
6372,"['instituto', 'internar', 'jorg', 'ricardo', 'saudar', 'saudar', 'situacao', 'universitario']","[1, 1, 1, 1, 2, 2, 1, 1]","[]","[]",8,0,8,1
6374,"['adotada', 'aglomeracao', 'agravamento', 'alvorar', 'apurar', 'argumentar', 'atuacao', 'autonomia', 'cardiologista', 'cerimonia', 'circulacao', 'conjunto', 'converso', 'converso', 'crise', 'desgast', 'distrito', 'distrito', 'enfrentamento', 'funcionamento', 'imunizacao', 'interlocutor', 'internacao', 'lorenzoni', 'ministrar', 'ministrar', 'ministrar', 'ministrar', 'ministrar', 'necessidad', 'onyx', 'onyx', 'palacio', 'palacio', 'pastar', 'planalto', 'preservar', 'previsto', 'queiroga', 'queiroga', 'queiroga', 'queiroga', 'reuniao', 'reuniao', 'sabado', 'sancao', 'saudar', 'saudar', 'secretariager', 'supremo']","[1, 1, 1, 1, 1, 1, 1, 1, 1, 1, 1, 1, 2, 2, 1, 1, 2, 2, 1, 1, 1, 1, 1, 1, 5, 5, 5, 5, 5, 1, 2, 2, 2, 2, 1, 1, 1, 1, 4, 4, 4, 4, 2, 2, 1, 1, 2, 2, 1, 1]","['imagem']","[1]",50,1,51,1
6375,"['contagioso', 'genoma', 'infectar', 'mutacao', 'mutacao', 'sequenciamento', 'variacao']","[1, 1, 1, 2, 2, 1, 1]","['circular', 'circular', 'espalhar']","[2, 2, 1]",7,3,10,1
6378,"['demandar', 'disseminacao', 'etapa', 'importancia', 'infectar', 'infectar', 'necessario', 'preliminar', 'prever', 'rotina', 'sarampo', 'sarampo', 'sarampo', 'sarampo', 'saudar', 'saudar', 'saudar', 'saudar']","[1, 1, 1, 1, 2, 2, 1, 1, 1, 1, 4, 4, 4, 4, 4, 4, 4, 4]","['disseminar']","[1]",18,1,19,1
6380,"['descumprimento', 'determinacao', 'interino', 'interrupcao', 'jorg', 'justicar', 'ministrar', 'pastar', 'regiao', 'saudar', 'saudar', 'saudar', 'servidor', 'servidor', 'servidor', 'varar']","[1, 1, 1, 1, 1, 1, 1, 1, 1, 3, 3, 3, 3, 3, 3, 1]","[]","[]",16,0,16,1
6381,"['ibg', 'preparacao', 'significativo']","[1, 1, 1]","[]","[]",3,0,3,1
6383,"['carla', 'conjuntar', 'zambelli']","[1, 1, 1]","[]","[]",3,0,3,1
6387,"['assistencia', 'assistencia', 'assistencia', 'conformar', 'desembarcar', 'dificuldad', 'dificuldad', 'distrito', 'enfrentamento', 'enfrentamento', 'equipamento', 'equipamento', 'equipamento', 'equipamento', 'estrategico', 'infectar', 'infectar', 'pulmonar', 'pulmonar', 'pulmonar', 'pulmonar', 'reforcar', 'reforcar', 'respiratorio', 'respiratorio', 'saudar', 'saudar', 'saudar', 'saudar', 'saudar', 'saudar', 'suportar', 'transmissao', 'velocidad', 'ventilador', 'ventilador', 'ventilador', 'ventilador', 'ventilador', 'ventilatorio']","[3, 3, 3, 1, 1, 2, 2, 1, 2, 2, 4, 4, 4, 4, 1, 2, 2, 4, 4, 4, 4, 2, 2, 2, 2, 6, 6, 6, 6, 6, 6, 1, 1, 1, 5, 5, 5, 5, 5, 1]","['ganhar']","[1]",40,1,41,1
6388,"['assistencia', 'capitar', 'interino', 'necessario', 'necessidad', 'periodo']","[1, 1, 1, 1, 1, 1]","['garganta', 'idioma']","[1, 1]",6,2,8,1
6389,"['converso', 'republico']","[1, 1]","[]","[]",2,0,2,1
6391,"['atuacao', 'decisao', 'disseminacao', 'justicar', 'justicar', 'justicar', 'ministrar', 'ministrar', 'processo', 'recurso', 'respostar']","[1, 1, 1, 3, 3, 3, 2, 2, 1, 1, 1]","[]","[]",11,0,11,1
6392,"['distrito', 'distrito', 'federativo', 'fundacao', 'igualitario', 'instituto', 'materiaprima', 'oswaldo', 'recebido', 'remessar', 'saudar', 'saudar']","[2, 2, 1, 1, 1, 1, 1, 1, 1, 1, 2, 2]","[]","[]",12,0,12,1
6393,"['antonio', 'anvisa', 'conduta', 'depoimento', 'instaurar', 'instaurar', 'taxar']","[1, 1, 1, 1, 2, 2, 1]","['verdadeiro', 'verdadeiro']","[2, 2]",7,2,9,1
6398,"['autoridad', 'avancar', 'dificuldad', 'intensivo', 'recordar', 'saudar', 'saudar', 'saudar', 'situacao']","[1, 1, 1, 1, 1, 3, 3, 3, 1]","[]","[]",9,0,9,1
6402,"['campino', 'etapa', 'etapa', 'justificativo']","[1, 2, 2, 1]","[]","[]",4,0,4,1
6403,"['mudanca', 'prazo']","[1, 1]","['cnh', 'motorista']","[1, 1]",2,2,4,1
6404,"['arthur', 'azevedo', 'calheiro', 'colegiado', 'comissao', 'depoimento', 'folhar', 'integro', 'mdbal', 'requerimento']","[1, 1, 1, 1, 1, 1, 1, 1, 1, 1]","[]","[]",10,0,10,1
6405,"['infectar', 'internar', 'internar', 'negativar', 'respiratorio']","[1, 2, 2, 1, 1]","[]","[]",5,0,5,1
6409,"['aplicacao', 'atuacao', 'avancar', 'biliao', 'cenario', 'circulacao', 'client', 'crescimento', 'crise', 'crise', 'economia', 'economia', 'economia', 'funcionamento', 'impactar', 'incerteza', 'juro', 'necessario', 'piorar', 'planar', 'prever', 'recuperacao', 'recuperacao', 'subir', 'vulneravel']","[1, 1, 1, 1, 1, 1, 1, 1, 2, 2, 3, 3, 3, 1, 1, 1, 1, 1, 1, 1, 1, 2, 2, 1, 1]","['soltar']","[1]",25,1,26,1
6411,"['atendido', 'comunitario', 'depressao', 'dosar', 'iniciativo', 'necessidad', 'parceria']","[1, 1, 1, 1, 1, 1, 1]","['arquivar', 'imagem']","[1, 1]",7,2,9,1
6412,"['gestant', 'infectar', 'intensivo', 'internacao', 'internacao', 'internar', 'positivar', 'trimestr']","[1, 1, 1, 2, 2, 1, 1, 1]","['menino']","[1]",8,1,9,1
6414,"['alunar', 'alunar', 'colegio', 'colegio', 'colegio', 'quedo', 'rotina', 'rotina', 'saudar']","[2, 2, 3, 3, 3, 1, 2, 2, 1]","['lixar', 'menino', 'sapato']","[1, 1, 1]",9,3,12,1
6415,"['colaboracao', 'colleg', 'colleg', 'complicacao', 'complicacao', 'decorrent', 'respirador', 'respiratorio', 'respiratorio', 'respiratorio']","[1, 2, 2, 2, 2, 1, 1, 3, 3, 3]","[]","[]",10,0,10,1
6416,"['boletim', 'infectar', 'periodo', 'saudar']","[1, 1, 1, 1]","[]","[]",4,0,4,1
6418,"['celebrar', 'expectativa', 'sabado', 'sabado', 'temporariament', 'temporario']","[1, 1, 2, 2, 1, 1]","[]","[]",6,0,6,1
6420,"['andrew', 'autoridad', 'biliao', 'crise', 'depressao', 'etapa', 'infraestrutura', 'realizacao', 'regiao', 'sabado', 'viagem']","[1, 1, 1, 1, 1, 1, 1, 1, 1, 1, 1]","['circular']","[1]",11,1,12,1
6421,"['anvisa', 'decorrencia', 'decorrent', 'entregu', 'equipamento', 'equipamento', 'equipamento', 'equipamento', 'equipamento', 'equipamento', 'gabinet', 'gabinet', 'gabinet', 'guarulho', 'impactar', 'mantido', 'necessario', 'necessario', 'orcamentaria', 'pastar', 'periodo', 'prazo', 'prazo', 'prazo', 'previsto', 'prorrogacao', 'prorrogacao', 'prorrogar', 'recurso', 'respostar', 'saudar', 'saudar', 'saudar', 'saudar', 'saudar', 'secretariager', 'situacao', 'situacao', 'vencimento', 'vigilancia']","[1, 1, 1, 1, 6, 6, 6, 6, 6, 6, 3, 3, 3, 1, 1, 1, 2, 2, 1, 1, 1, 3, 3, 3, 1, 2, 2, 1, 1, 1, 5, 5, 5, 5, 5, 1, 2, 2, 1, 1]","['enganir']","[1]",40,1,41,1
6422,"['adulto', 'adulto', 'anticorpo', 'anticorpo', 'anticorpo', 'assintomatico', 'assintomatico', 'complicacao', 'especifico', 'infectar', 'infectar', 'instituto', 'negativar', 'parceria', 'positivar', 'positivar', 'resistencia', 'respostar', 'respostar', 'respostar', 'respostar', 'taxar']","[2, 2, 3, 3, 3, 2, 2, 1, 1, 2, 2, 1, 1, 1, 2, 2, 1, 4, 4, 4, 4, 1]","['casamentar', 'realment', 'replicar']","[1, 1, 1]",22,3,25,1
6425,"['alvorar', 'converso', 'palacio', 'posturar', 'respostar']","[1, 1, 1, 1, 1]","['gravacao']","[1]",5,1,6,1
6426,"['araujo', 'cilindro', 'cilindro', 'ernesto', 'manutencao', 'ministrar']","[1, 2, 2, 1, 1, 1]","['galaxi', 'plam']","[1, 1]",6,2,8,1
6427,"['acompanhamento', 'balancar', 'saudar', 'saudar']","[1, 1, 2, 2]","[]","[]",4,0,4,1
6428,"['compromisso', 'crise', 'ministrar', 'ministrar', 'ministrar', 'pratico', 'queiroga', 'saudar', 'saudar']","[1, 1, 3, 3, 3, 1, 1, 2, 2]","[]","[]",9,0,9,1
6429,"['anvisa', 'anvisa', 'atrasar', 'importacao', 'importacao', 'independentement', 'instituto', 'instituto', 'integro', 'materiaprima', 'vigilancia']","[2, 2, 1, 2, 2, 1, 2, 2, 1, 1, 1]","[]","[]",11,0,11,1
6432,"['arthur', 'arthur', 'arthur', 'lira', 'lira', 'lira', 'lorenzoni', 'ministrar', 'onyx', 'ppal', 'presidir', 'presidir']","[3, 3, 3, 3, 3, 3, 1, 1, 1, 1, 2, 2]","['imagem']","[1]",12,1,13,1
6433,"['anticorpo', 'transmissao']","[1, 1]","['ganhar']","[1]",2,1,3,1
6435,"['acordo', 'aumento', 'comparacao', 'espanha', 'porqu']","[1, 1, 1, 1, 1]","[]","[]",5,0,5,1
6436,"['autoridad', 'companhia', 'concorrent', 'europeu', 'mudanca', 'mudanca', 'prever', 'sabado']","[1, 1, 1, 1, 2, 2, 1, 1]","['privacidad', 'telegram', 'usuario']","[1, 1, 1]",8,3,11,1
6437,"['companhia', 'quedo', 'temporario']","[1, 1, 1]","[]","[]",3,0,3,1
6438,"['conformar', 'temor']","[1, 1]","[]","[]",2,0,2,1
6439,"['autoridad', 'balancar', 'consequencia', 'crise', 'deteccao', 'epidemiar', 'epidemiar', 'hubei', 'hubei', 'infectar', 'kong', 'provincia', 'quarentenar', 'turista']","[1, 1, 1, 1, 1, 2, 2, 2, 2, 1, 1, 1, 1, 1]","['ganhar', 'indignacao']","[1, 1]",14,2,16,1
6440,"['anticorpo', 'anticorpo', 'anticorpo', 'anticorpo', 'assintomatico', 'californio', 'inicialment', 'investigacao', 'liderar', 'oferecido', 'periodo', 'recuperacao', 'reforcar', 'respostar', 'respostar']","[4, 4, 4, 4, 1, 1, 1, 1, 1, 1, 1, 1, 1, 2, 2]","[]","[]",15,0,15,1
6442,"['decisao', 'decisao', 'parceria', 'precaucao', 'presenciar', 'situacao']","[2, 2, 1, 1, 1, 1]","[]","[]",6,0,6,1
6444,"['augusto', 'colunista', 'colunista', 'cooperacao', 'integrant', 'kassio', 'republico']","[1, 2, 2, 1, 1, 1, 1]","['arquivar']","[1]",7,1,8,1
6445,"['administrativo', 'aglomeracao', 'decisao', 'decisao', 'distrito', 'funcionamento', 'funcionamento', 'justicar', 'justicar', 'mendonca', 'mendonca', 'orientacao', 'palacio', 'planalto', 'realizacao', 'realizacao', 'regiao', 'saudar']","[1, 1, 2, 2, 1, 2, 2, 2, 2, 2, 2, 1, 1, 1, 2, 2, 1, 1]","[]","[]",18,0,18,1
6448,"['benjamin', 'dosar', 'economia', 'habitant', 'primeiroministro', 'reabertura', 'ritmar', 'saudar']","[1, 1, 1, 1, 1, 1, 1, 1]","[]","[]",8,0,8,1
6450,"['andrew', 'aplicacao', 'conjuntar', 'desenvolvimento', 'dosar', 'dosar', 'dosar', 'dosar', 'dosar', 'dosar', 'imunizacao', 'preliminar', 'prever', 'prioridad', 'reforcar', 'sigla']","[1, 1, 1, 1, 6, 6, 6, 6, 6, 6, 1, 1, 1, 1, 1, 1]","[]","[]",16,0,16,1
6451,"['acordo', 'antecipar', 'expectativa', 'florido', 'florido', 'florido', 'globonew', 'interlocutor', 'jantar', 'jantar', 'jantar', 'oficialment', 'planalto', 'possibilidad', 'sabado', 'viagem']","[1, 1, 1, 3, 3, 3, 1, 1, 3, 3, 3, 1, 1, 1, 1, 1]","[]","[]",16,0,16,1
6452,"['boletim', 'espirito', 'excecao', 'infectar', 'internar', 'investigacao', 'investigacao', 'levantamento', 'levantamento', 'regiao', 'respiratorio', 'saudar', 'suspeito']","[1, 1, 1, 1, 1, 2, 2, 2, 2, 1, 1, 1, 1]","[]","[]",13,0,13,1
6454,"['assintomatico', 'autoridad', 'californio', 'contencao', 'especializar', 'infectar', 'passageiro', 'passageiro', 'positivar', 'quarentenar', 'quarentenar', 'submetido', 'submetido']","[1, 1, 1, 1, 1, 1, 2, 2, 1, 2, 2, 2, 2]","[]","[]",13,0,13,1
6455,"['desenvolvimento', 'desenvolvimento', 'dificuldad', 'economia', 'emprestimo', 'exigencia', 'necessario', 'oferecido', 'provisorio', 'recurso', 'reducao']","[2, 2, 1, 1, 1, 1, 1, 1, 1, 1, 1]","[]","[]",11,0,11,1
6460,"['alteracao', 'fornecimento', 'possibilidad', 'prorrogar', 'restritivo', 'saudar', 'saudar']","[1, 1, 1, 1, 1, 2, 2]","[]","[]",7,0,7,1
6461,"['exjuiz', 'exministro']","[1, 1]","[]","[]",2,0,2,1
6462,"['afp', 'afp', 'algun', 'embora', 'embora', 'epicentro', 'kong', 'kong', 'quilometro']","[2, 2, 1, 2, 2, 1, 2, 2, 1]","[]","[]",9,0,9,1
6463,"['acordo', 'acordo', 'acordo', 'cenario', 'congresso', 'crise', 'economia', 'jornada', 'julgamento', 'manutencao', 'medida', 'milho', 'milho', 'necessidad', 'preservar', 'sindicato', 'supremo', 'tambem']","[3, 3, 3, 1, 1, 1, 1, 1, 1, 1, 1, 2, 2, 1, 1, 1, 1, 1]","[]","[]",18,0,18,1
6464,"['impactar']","[1]","['realment']","[1]",1,1,2,1
6470,"['assistencia', 'decisao', 'exigencia', 'iniciativo', 'iniciativo', 'magistrado', 'plano', 'privar', 'relativo', 'resolucao', 'saudar', 'saudar', 'saudar', 'sindicato', 'varar']","[1, 1, 1, 2, 2, 1, 1, 1, 1, 1, 3, 3, 3, 1, 1]","['ganhar']","[1]",15,1,16,1
6471,"['comorbidad', 'hospitalizar', 'internar', 'internar', 'internar', 'jorg', 'jorg', 'pulmonar', 'recuperacao', 'sabado', 'saudar', 'sobretudo']","[1, 1, 3, 3, 3, 2, 2, 1, 1, 1, 1, 1]","[]","[]",12,0,12,1
6473,"['administrativo', 'assistencia', 'coletivo', 'coletivo', 'coletivo', 'conjunto', 'manutencao', 'normalment', 'pagamento', 'privar', 'saudar', 'saudar', 'saudar', 'saudar', 'saudar', 'servidor', 'suspensao', 'urbano']","[1, 1, 3, 3, 3, 1, 1, 1, 1, 1, 5, 5, 5, 5, 5, 1, 1, 1]","[]","[]",18,0,18,1
6474,"['metropolitano', 'processo', 'queixar']","[1, 1, 1]","[]","[]",3,0,3,1
6479,"['desafiar', 'desafio', 'desigualdad', 'desigualdad', 'infraestrutura', 'infraestrutura', 'limitacao', 'ministrar', 'ministrar', 'mudanca', 'mudanca', 'projeco', 'supremo']","[1, 1, 2, 2, 2, 2, 1, 2, 2, 2, 2, 1, 1]","[]","[]",13,0,13,1
6480,"['calendario', 'cupula', 'emprestimo', 'fluminens', 'henriqu', 'mantido', 'semestr', 'semestr', 'situacao', 'treinamento']","[1, 1, 1, 1, 1, 1, 2, 2, 1, 1]","[]","[]",10,0,10,1
6482,"['infectar']","[1]","[]","[]",1,0,1,1
6483,"['prioritario', 'reportar']","[1, 1]","[]","[]",2,0,2,1
6486,"['definitivo', 'gabbardo', 'gabbardo', 'instalacao', 'insuficient', 'necessidad', 'prioridad', 'recurso', 'reforcar', 'temporario', 'tendencia']","[1, 2, 2, 1, 1, 1, 1, 1, 1, 1, 1]","[]","[]",11,0,11,1
6492,"['comparacao', 'consolidar', 'consorcio', 'estabilidad', 'levantamento', 'recordar', 'ritmar', 'saudar', 'saudar', 'situacao', 'tendencia', 'tendencia', 'totalizar', 'variacao', 'variacao']","[1, 1, 1, 1, 1, 1, 1, 2, 2, 1, 2, 2, 1, 2, 2]","[]","[]",15,0,15,1
6493,"['assistencia', 'cirurgico', 'distrito', 'enfrentamento', 'enfrentamento', 'equipamento', 'equipamento', 'especifico', 'especifico', 'reforcar', 'saudar', 'saudar', 'saudar', 'saudar', 'saudar']","[1, 1, 1, 2, 2, 2, 2, 2, 2, 1, 5, 5, 5, 5, 5]","['espalhar']","[1]",15,1,16,1
6496,"['afp', 'atrasar', 'estrategia', 'impactar', 'iniciativo', 'merkel', 'previsto', 'reuniao', 'ritmar', 'totalizar', 'transferir', 'transferir']","[1, 1, 1, 1, 1, 1, 1, 1, 1, 1, 2, 2]","[]","[]",12,0,12,1
6498,"['afp', 'cirurgico', 'concreto', 'dedicar', 'equipamento', 'estrategico', 'michael', 'painel']","[1, 1, 1, 1, 1, 1, 1, 1]","[]","[]",8,0,8,1
6499,"[]","[]","[]","[]",0,0,0,1
6501,"['conjuntar', 'domingo', 'examinar', 'gabinet', 'habitant', 'imunizacao', 'infectar', 'ministrar', 'primeiroministro', 'prorrogar', 'saudar', 'saudar', 'situacao']","[1, 1, 1, 1, 1, 1, 1, 1, 1, 1, 2, 2, 1]","['compartilhar']","[1]",13,1,14,1
6504,"['condicao', 'guarulho', 'internar', 'positivar', 'quedo', 'respiratorio', 'saudar', 'suportar', 'ventilacao']","[1, 1, 1, 1, 1, 1, 1, 1, 1]","['estomago']","[1]",9,1,10,1
6507,"['apoio', 'arthur', 'desenvolvimento', 'equipamento', 'lira', 'palacio', 'planalto', 'ppal', 'recurso', 'rossi', 'sendo']","[1, 1, 1, 1, 1, 1, 1, 1, 1, 1, 1]","[]","[]",11,0,11,1
6510,"['academiar', 'anvisa', 'apurar', 'azevedo', 'cardiologista', 'complicacao', 'complicacao', 'decisao', 'decisao', 'demandar', 'dinamarca', 'dinamarca', 'escalar', 'europeu', 'hipertensao', 'imunizacao', 'indicador', 'instituto', 'instituto', 'integrant', 'investigacao', 'investigacao', 'investigacao', 'jorg', 'justificativo', 'observar', 'prescricao', 'prever', 'pulmonar', 'risco', 'saudar', 'saudar', 'taxar', 'taxar']","[1, 1, 1, 1, 1, 2, 2, 2, 2, 1, 2, 2, 1, 1, 1, 1, 1, 2, 2, 1, 3, 3, 3, 1, 1, 1, 1, 1, 1, 1, 2, 2, 2, 2]","['circular', 'espalhar', 'ilustrar', 'usuario']","[1, 1, 1, 1]",34,4,38,1
6511,"['comparacao', 'consolidar', 'consorcio', 'estabilidad', 'levantamento', 'quedo', 'quedo', 'roraima', 'saudar', 'situacao', 'tendencia', 'variacao', 'variacao']","[1, 1, 1, 1, 1, 2, 2, 1, 1, 1, 1, 2, 2]","[]","[]",13,0,13,1
6512,"['condicao', 'congresso', 'crise', 'crise', 'curvo', 'demrj', 'dificuldad', 'economia', 'economia', 'impactar', 'impactar', 'prioridad', 'recurso', 'reflexo', 'superar', 'superar']","[1, 1, 2, 2, 1, 1, 1, 2, 2, 2, 2, 1, 1, 1, 2, 2]","[]","[]",16,0,16,1
6513,"['desenvolvimento', 'inconsistencia', 'ministrar', 'ministrar', 'nomeacao', 'nomeacao']","[1, 1, 2, 2, 2, 2]","[]","[]",6,0,6,1
6515,"['federativo', 'mandatario', 'regiao', 'regiao', 'reuniao', 'roraima', 'roraima', 'situacao', 'transferencia', 'wilson']","[1, 1, 2, 2, 1, 2, 2, 1, 1, 1]","[]","[]",10,0,10,1
6516,"['colaborar', 'contrato', 'demandar', 'domingo', 'especifico', 'externo', 'externo', 'proposto', 'subordinar']","[1, 1, 1, 1, 1, 2, 2, 1, 1]","[]","[]",9,0,9,1
6521,"['antecipar', 'epidemiar', 'flexibilizar', 'quarentenar', 'quarentenar', 'reabertura', 'risco', 'vulneravel']","[1, 1, 1, 2, 2, 1, 1, 1]","[]","[]",8,0,8,1
6522,"['cirurgico', 'disseminacao', 'epidemiar', 'equipamento', 'pratico', 'surto', 'transmissao']","[1, 1, 1, 1, 1, 1, 1]","['circular', 'imagem']","[1, 1]",7,2,9,1
6523,"['decisao', 'exjuiz', 'exjuiz', 'exjuiz', 'forcatarefa', 'julgamento', 'lewandowski', 'necessidad', 'reconhecimento', 'ricardo', 'supremo', 'suspeicao', 'turma']","[1, 3, 3, 3, 1, 1, 1, 1, 1, 1, 1, 1, 1]","[]","[]",13,0,13,1
6524,"['californio']","[1]","['incendio', 'incendio', 'incendio', 'incendio']","[4, 4, 4, 4]",1,4,5,1
6525,"['advocaciager', 'bolsonarista', 'destacar', 'dificultar', 'lewandowski', 'lewandowski', 'ministrar', 'ministrar', 'ministrar', 'oposto', 'plenario', 'prever', 'processo', 'realizacao', 'republico', 'republico', 'ricardo', 'saudar', 'supremo', 'supremo']","[1, 1, 1, 1, 2, 2, 3, 3, 3, 1, 1, 1, 1, 1, 2, 2, 1, 1, 2, 2]","['supostament']","[1]",20,1,21,1
6526,"['barroso', 'equipamento', 'funcao', 'julgamento', 'justicar', 'magistrado', 'ministrar', 'ministrar', 'ministrar', 'plantao', 'plenario', 'sessao', 'supremo', 'videoconferencia']","[1, 1, 1, 1, 1, 1, 3, 3, 3, 1, 1, 1, 1, 1]","['mesario', 'secreto']","[1, 1]",14,2,16,1
6528,"['alcolumbr', 'bandeirant', 'infectar', 'isolar', 'sessao', 'supremo', 'supremo']","[1, 1, 1, 1, 1, 2, 2]","['verificar']","[1]",7,1,8,1
6529,"['bolsonarista', 'dialogo', 'fundacao', 'oswaldo', 'wilson', 'witzel', 'witzel']","[1, 1, 1, 1, 1, 2, 2]","['atribuir', 'sortir']","[1, 1]",7,2,9,1
6530,"['indicado', 'resultado', 'resultado', 'sabado', 'sociai']","[1, 2, 2, 1, 1]","[]","[]",5,0,5,1
6534,"['adotada', 'anvisa', 'consorcio', 'destinar', 'diagnosticar', 'especializar', 'importacao', 'intubacao', 'privar', 'privar', 'resolucao', 'saudar', 'saudar', 'saudar', 'saudar', 'sindicato', 'sindicato', 'temporario', 'vigilancia']","[1, 1, 1, 1, 1, 1, 1, 1, 2, 2, 1, 4, 4, 4, 4, 2, 2, 1, 1]","[]","[]",19,0,19,1
6535,"['californio', 'decisao', 'escalar', 'henriqu', 'impacto', 'ministrar', 'preocupacao', 'propagacao', 'quarentenar', 'saudar', 'suspeito']","[1, 1, 1, 1, 1, 1, 1, 1, 1, 1, 1]","[]","[]",11,0,11,1
6536,"['distrito', 'espirito', 'instituto', 'saudar', 'transmissao']","[1, 1, 1, 1, 1]","[]","[]",5,0,5,1
6537,"['aplicacao', 'contemplar', 'dosar', 'imunizacao', 'interrupcao', 'previsao']","[1, 1, 1, 1, 1, 1]","[]","[]",6,0,6,1
6538,"['fez', 'fundacao', 'instituto', 'oswaldo', 'panamericana', 'pedido', 'respiratorio', 'sarampo', 'treinar']","[1, 1, 1, 1, 1, 1, 1, 1, 1]","[]","[]",9,0,9,1
6540,"['anvisa', 'avancar', 'coordenar', 'elaborar', 'fabricacao', 'fase', 'inovacao', 'institut', 'integro', 'ministrar', 'vigilancia']","[1, 1, 1, 1, 1, 1, 1, 1, 1, 1, 1]","[]","[]",11,0,11,1
6542,"['flavio', 'preocupacao', 'saudar', 'saudar']","[1, 1, 2, 2]","['estranhar', 'estranhar', 'estranhar']","[3, 3, 3]",4,3,7,1
6545,"['ampliacao', 'apurar', 'curvo', 'domingo', 'economia', 'economia', 'expectativa', 'prever', 'previsao', 'quarentenar', 'reabertura']","[1, 1, 1, 1, 2, 2, 1, 1, 1, 1, 1]","[]","[]",11,0,11,1
6546,"['celso', 'folhar', 'funcao', 'gabinet', 'instituto', 'integro', 'relativo']","[1, 1, 1, 1, 1, 1, 1]","[]","[]",7,0,7,1
6548,"['comportamento', 'conformar', 'enquadrar', 'epidemiar', 'estimular', 'exercicio', 'exercicio', 'funcao', 'individuar', 'processo', 'proposto', 'republico', 'republico', 'republico', 'saudar', 'supremo', 'tramitar']","[1, 1, 1, 1, 1, 2, 2, 1, 1, 1, 1, 3, 3, 3, 1, 1, 1]","['wagner']","[1]",17,1,18,1
6552,"['apostar', 'aprovacao', 'aprovacao', 'apurar', 'ccj', 'ccj', 'ccj', 'celso', 'cenario', 'colegiado', 'comissao', 'comissao', 'constituicao', 'desgastar', 'governista', 'inconsistencia', 'inconsistencia', 'integrant', 'justicar', 'kassio', 'kassio', 'mello', 'minimizar', 'ministrar', 'necessario', 'plenario', 'plenario', 'posicionamento', 'pratico', 'supremo', 'suspeito', 'suspeito']","[1, 2, 2, 1, 3, 3, 3, 1, 1, 1, 2, 2, 1, 1, 1, 2, 2, 1, 1, 2, 2, 1, 1, 1, 1, 2, 2, 1, 1, 1, 2, 2]","[]","[]",32,0,32,1
6553,"['anvisa', 'anvisa', 'fronteiro', 'necessidad', 'passageiro', 'quarentenar', 'saudar', 'saudar', 'servidor', 'situacao', 'situacao', 'subir', 'suspeito', 'treinar', 'vigilancia']","[2, 2, 1, 1, 1, 1, 2, 2, 1, 2, 2, 1, 1, 1, 1]","[]","[]",15,0,15,1
6555,"['desenvolvimento', 'internacao', 'internar', 'recordar']","[1, 1, 1, 1]","['minutar']","[1]",4,1,5,1
6557,"['boletim', 'contabilizar', 'recordar', 'recordar', 'recordar', 'saudar', 'surtir']","[1, 1, 3, 3, 3, 1, 1]","[]","[]",7,0,7,1
6558,"['aplicacao', 'folhar', 'hospitalizacao', 'hospitalizacao', 'impactar', 'integro', 'internacao', 'quedo']","[1, 1, 2, 2, 1, 1, 1, 1]","[]","[]",8,0,8,1
6559,"[]","[]","[]","[]",0,0,0,1
6561,"['apostar', 'compilar', 'consorcio', 'contrato', 'dosar', 'habitant', 'imunizacao', 'imunizacao', 'imunizacao', 'instituto', 'instituto', 'margem', 'percepcao', 'proporcao', 'ritmar', 'sabado', 'velocidad']","[1, 1, 1, 1, 1, 1, 3, 3, 3, 2, 2, 1, 1, 1, 1, 1, 1]","[]","[]",17,0,17,1
6564,"['crise', 'epidemia', 'informaco', 'institut']","[1, 1, 1, 1]","[]","[]",4,0,4,1
6565,"['investigacao', 'investigacao']","[2, 2]","['fraudar', 'fraudar']","[2, 2]",2,2,4,1
6568,"['campino', 'esquema', 'investigacao', 'vieira']","[1, 1, 1, 1]","['cocaina', 'trafico']","[1, 1]",4,2,6,1
6578,"['californio', 'cardiologista', 'comportament', 'demandar', 'estrategia', 'funcao', 'instituto', 'internar', 'mudanca', 'necessario', 'periodo', 'periodo', 'periodo', 'privar', 'privar', 'reducao', 'ritmar', 'rotina', 'saudar', 'saudar']","[1, 1, 1, 1, 1, 1, 1, 1, 1, 1, 3, 3, 3, 2, 2, 1, 1, 1, 2, 2]","['humanar']","[1]",20,1,21,1
6582,"['convencao', 'descumprimento', 'exercicio', 'fase', 'fundamentar', 'imunizacao', 'inclusao', 'lewandowski', 'ministrar', 'operacionalizacao', 'planar', 'prioritario', 'ricardo', 'supremo']","[1, 1, 1, 1, 1, 1, 1, 1, 1, 1, 1, 1, 1, 1]","['legendar']","[1]",14,1,15,1
6586,"['anuncio', 'autoridad', 'crescimento', 'diagnosticar', 'economia', 'enxergar', 'esforco', 'importacao', 'previsao', 'quarentenar', 'saudar', 'temor']","[1, 1, 1, 1, 1, 1, 1, 1, 1, 1, 1, 1]","[]","[]",12,0,12,1
6587,"['cooperacao', 'curvo', 'desgastar', 'destinar', 'destinar', 'logistico', 'regiao', 'saudar', 'saudar', 'transferir', 'voo']","[1, 1, 1, 2, 2, 1, 1, 2, 2, 1, 1]","[]","[]",11,0,11,1
6590,"['desafiar']","[1]","[]","[]",1,0,1,1
6591,"['antecipar', 'antonio', 'autoridad', 'economia', 'gued', 'minimizar', 'ministrar', 'planalto', 'proposto', 'proposto', 'reuniao', 'ritmar', 'saudar', 'trimestr']","[1, 1, 1, 1, 1, 1, 1, 1, 2, 2, 1, 1, 1, 1]","[]","[]",14,0,14,1
6597,"['celebrar', 'dificuldad', 'exgovernador', 'plano', 'tatto', 'tatto', 'tatto']","[1, 1, 1, 1, 3, 3, 3]","[]","[]",7,0,7,1
6598,"['alvorar', 'cardiologista', 'cardiologista', 'converso', 'domingo', 'domingo', 'integro', 'ministrar', 'palacio', 'presenca', 'pslsp', 'reuniao', 'saudar', 'saudar']","[1, 2, 2, 1, 2, 2, 1, 1, 1, 1, 1, 1, 2, 2]","[]","[]",14,0,14,1
6600,"['apurar', 'decisao', 'epidemiar', 'especifico', 'necessidad', 'notificar', 'notificar', 'oficio', 'oficio', 'oficio', 'orientacao', 'pastar', 'pastar', 'saudar', 'saudar']","[1, 1, 1, 1, 1, 2, 2, 3, 3, 3, 1, 2, 2, 2, 2]","['preencher']","[1]",15,1,16,1
6604,"['convencao', 'convencao', 'convencao']","[3, 3, 3]","['captar']","[1]",3,1,4,1
6605,"['academiar', 'academiar', 'amplo', 'conjuntar', 'especifico', 'hospitalizar', 'resistencia']","[2, 2, 1, 1, 1, 1, 1]","['vitaminar', 'vitaminar', 'vitaminar', 'vitaminar']","[4, 4, 4, 4]",7,4,11,1
6607,"['coordenar', 'crise', 'dinamarca', 'liderar', 'liderar', 'merkel', 'respostar', 'situacao']","[1, 1, 1, 2, 2, 1, 1, 1]","[]","[]",8,0,8,1
6608,"['administrativo', 'ampliacao', 'arthur', 'autonomia', 'congresso', 'defendido', 'descumprimento', 'destinar', 'discussao', 'lira', 'plenario', 'ppal', 'prioritario', 'proposto', 'regrar', 'saudar', 'temporariament', 'tributario']","[1, 1, 1, 1, 1, 1, 1, 1, 1, 1, 1, 1, 1, 1, 1, 1, 1, 1]","[]","[]",18,0,18,1
6610,"['arthur', 'demrj', 'globonew', 'lira', 'lira', 'lira', 'ppal', 'rossi']","[1, 1, 1, 3, 3, 3, 1, 1]","[]","[]",8,0,8,1
6615,"['complicacao', 'cronica', 'desenvolvimento', 'exercicio', 'exercicio', 'exercicio', 'exercicio', 'fluxo', 'humberto', 'piorar', 'pratico', 'quedo', 'realizacao', 'respiratorio', 'respiratorio', 'respiratorio', 'risco', 'saudar', 'subir']","[1, 1, 1, 4, 4, 4, 4, 1, 1, 1, 1, 1, 1, 3, 3, 3, 1, 1, 1]","[]","[]",19,0,19,1
6617,"['acumular', 'crise', 'crise', 'curvo', 'economia', 'escalar', 'estimular', 'extensao', 'gued', 'incerteza', 'juro', 'justicar', 'ministrar', 'percepcao', 'realizacao', 'recuperacao', 'subir', 'temor', 'vencimento']","[1, 2, 2, 1, 1, 1, 1, 1, 1, 1, 1, 1, 1, 1, 1, 1, 1, 1, 1]","['atribuir']","[1]",19,1,20,1
6619,"['exgovernador', 'interpretar', 'precandidato', 'precandidato', 'republico', 'suspenso']","[1, 1, 2, 2, 1, 1]","['wagner']","[1]",6,1,7,1
6620,"['companhia', 'condicao', 'congresso', 'delacao', 'domicilio', 'enfrentamento', 'entendimento', 'estatistico', 'fabricio', 'fabricio', 'fabricio', 'flavio', 'geografia', 'gripezinha', 'ibg', 'instituto', 'palacio', 'planalto', 'preservar', 'queiroz', 'queiroz', 'rachadinha', 'supremo']","[1, 1, 1, 1, 1, 1, 1, 1, 3, 3, 3, 1, 1, 1, 1, 1, 1, 1, 1, 2, 2, 1, 1]","['renunciar']","[1]",23,1,24,1
6622,"['crescimento', 'decisao', 'minimizar', 'regiao']","[1, 1, 1, 1]","[]","[]",4,0,4,1
6624,"['assistencia', 'deslocamento', 'enfrentamento', 'especifico', 'oferecido', 'primario', 'primario', 'primario', 'reforcar', 'saudar', 'saudar', 'saudar', 'saudar', 'suportar']","[1, 1, 1, 1, 1, 3, 3, 3, 1, 4, 4, 4, 4, 1]","[]","[]",14,0,14,1
6628,"['autoridad', 'orientacao', 'paralisar', 'prioridad', 'rotina', 'saudar']","[1, 1, 1, 1, 1, 1]","[]","[]",6,0,6,1
6632,"['cooperacao', 'cooperacao', 'decisao', 'desenvolvimento', 'desenvolvimento', 'economia', 'folhar', 'globonew', 'integrant', 'spaulo']","[2, 2, 1, 2, 2, 1, 1, 1, 1, 1]","[]","[]",10,0,10,1
6634,"['confederacao', 'destinar', 'dificuldad', 'dosar', 'dosar', 'dosar', 'fabricacao', 'periodo', 'prioritario', 'situacao', 'subir']","[1, 1, 1, 3, 3, 3, 1, 1, 1, 1, 1]","[]","[]",11,0,11,1
6635,"['condenacao', 'congresso', 'consolidar', 'guaruja', 'nogueira', 'nogueira', 'nogueira', 'pratico', 'presenca', 'triplex']","[1, 1, 1, 1, 3, 3, 3, 1, 1, 1]","[]","[]",10,0,10,1
6636,"['administrativo', 'atrasar', 'bolsonarista', 'congresso', 'economia', 'economia', 'expectativa', 'gued', 'gued', 'legislativo', 'ministrar', 'tributario', 'viagem']","[1, 1, 1, 1, 2, 2, 1, 2, 2, 1, 1, 1, 1]","['enfim']","[1]",13,1,14,1
6640,"['descumprir', 'fase', 'planar', 'planar', 'restritivo']","[1, 1, 2, 2, 1]","[]","[]",5,0,5,1
6641,"['opcao', 'previsto', 'situacao']","[1, 1, 1]","['humanar', 'interaco']","[1, 1]",3,2,5,1
6642,"['adversario', 'alteracao', 'ambientar', 'discussao', 'integro', 'ministrar', 'ricardo', 'sall', 'sall', 'souza']","[1, 1, 1, 1, 1, 1, 1, 2, 2, 1]","['circular']","[1]",10,1,11,1
6643,"['araujo', 'diplomata', 'ernesto', 'extraordinario', 'fronteiro', 'itamarati', 'liderar', 'ministrar', 'respostar', 'reuniao']","[1, 1, 1, 1, 1, 1, 1, 1, 1, 1]","['venezuelano']","[1]",10,1,11,1
6645,"['adesao', 'calculo', 'cenario', 'diagnosticar', 'enfrentamento', 'henriqu', 'instituto', 'previsao', 'projecao', 'saudar', 'saudar', 'saudar', 'saudar', 'saudar', 'taxar', 'tendencia']","[1, 1, 1, 1, 1, 1, 1, 1, 1, 5, 5, 5, 5, 5, 1, 1]","[]","[]",16,0,16,1
6647,"['porqu', 'rotina']","[1, 1]","['preencher']","[1]",2,1,3,1
6648,"['adulto', 'ministrar', 'mudanca', 'planar', 'planar', 'saudar']","[1, 1, 1, 2, 2, 1]","[]","[]",6,0,6,1
6651,"['bandeirant', 'gabbardo', 'gabbardo', 'palacio', 'possibilidad', 'proposto']","[1, 2, 2, 1, 1, 1]","[]","[]",6,0,6,1
6652,"['autorizacao', 'cupula', 'desembarcar', 'epidemiar', 'especializar', 'infectar', 'necessario', 'saudar', 'saudar', 'surtir']","[1, 1, 1, 1, 1, 1, 1, 2, 2, 1]","[]","[]",10,0,10,1
6655,"['desafiar', 'destacar', 'domingo', 'domingo']","[1, 1, 2, 2]","[]","[]",4,0,4,1
6659,"['consecutivo', 'contabilizar', 'crescimento', 'diagnosticar', 'diminuicao', 'diminuicao', 'epidemiologico', 'fase', 'importancia', 'infectar', 'instituto', 'monitoramento', 'respectivament', 'saudar', 'saudar']","[1, 1, 1, 1, 2, 2, 1, 1, 1, 1, 1, 1, 1, 2, 2]","[]","[]",15,0,15,1
6661,"['armazenamento', 'armazenamento', 'armazenamento', 'companhia', 'condicao', 'desafiar', 'desenvolvido', 'elaborar', 'escalar', 'estimular', 'estrategia', 'fase', 'instituto', 'logistico', 'monitoramento', 'necessidad', 'planar']","[3, 3, 3, 1, 1, 1, 1, 1, 1, 1, 1, 1, 1, 1, 1, 1, 1]","['manipular']","[1]",17,1,18,1
6662,"['legislativo', 'levantamento', 'metropolitano', 'regiao', 'regiao', 'regiao', 'regiao']","[1, 1, 1, 4, 4, 4, 4]","[]","[]",7,0,7,1
6664,"['conjuntar', 'consequencia', 'economia', 'liderar', 'necessario', 'preocupacao', 'respiratorio']","[1, 1, 1, 1, 1, 1, 1]","[]","[]",7,0,7,1
6665,"['conjuntar', 'distrito', 'edson', 'globonew', 'pastar', 'periferia', 'prorrogar', 'quarentenar', 'saudar', 'saudar', 'suspeito']","[1, 1, 1, 1, 1, 1, 1, 1, 2, 2, 1]","[]","[]",11,0,11,1
6668,"['alergia', 'ansiedad', 'aspecto', 'celebrar', 'complicacao', 'condicao', 'converso', 'depressao', 'destacar', 'destacar', 'dificuldad', 'diminuicao', 'diminuicao', 'esperancar', 'esperancar', 'exercicio', 'exercicio', 'expressar', 'expressar', 'expressar', 'expressivo', 'externo', 'externo', 'habito', 'impactar', 'internar', 'internar', 'minimizar', 'periodo', 'positivar', 'psicologo', 'psicologo', 'psicologo', 'psicologo', 'relaxamento', 'relaxamento', 'risco', 'saudar', 'souza']","[1, 1, 1, 1, 1, 1, 1, 1, 2, 2, 1, 2, 2, 2, 2, 2, 2, 3, 3, 3, 1, 2, 2, 1, 1, 2, 2, 1, 1, 1, 4, 4, 4, 4, 2, 2, 1, 1, 1]","['pelar', 'realment']","[1, 1]",39,2,41,1
6671,"['autoridad', 'dinamarca', 'dinamarca', 'epidemia', 'medida', 'milho', 'mutacao', 'regiao', 'risco', 'tambem']","[1, 2, 2, 1, 1, 1, 1, 1, 1, 1]","['ampla']","[1]",10,1,11,1
6673,"['algun', 'aliviar', 'economia', 'economia', 'medida', 'medida', 'medida', 'plano', 'primeiroministro', 'propagacao', 'regiao', 'relaxamento', 'relaxamento']","[1, 1, 2, 2, 3, 3, 3, 1, 1, 1, 1, 2, 2]","[]","[]",13,0,13,1
6677,"['converso', 'dialogo', 'dialogo', 'exjuiz', 'folhar', 'guaruja', 'inedito', 'integro', 'integro', 'lewandowski', 'ministrar', 'ricardo', 'supremo', 'triplex']","[1, 2, 2, 1, 1, 1, 1, 2, 2, 1, 1, 1, 1, 1]","[]","[]",14,0,14,1
6679,"['anvisa', 'aprovacao', 'autorizacao', 'exigencia', 'facilitar', 'fase', 'mudanca', 'vigilancia']","[1, 1, 1, 1, 1, 1, 1, 1]","[]","[]",8,0,8,1
6680,"['ambientar', 'congresso', 'decisao', 'decisao', 'exonerar', 'fabricio', 'flavio', 'flavio', 'gabinet', 'julgamento', 'justicar', 'justicar', 'queiroz', 'republicanosrj', 'turma']","[1, 1, 2, 2, 1, 1, 2, 2, 1, 1, 2, 2, 1, 1, 1]","['bandeiro']","[1]",15,1,16,1
6681,"['avancar', 'infectar', 'precedent', 'quarentenar']","[1, 1, 1, 1]","[]","[]",4,0,4,1
6683,"['aprovacao', 'cenario', 'cilindro', 'congresso', 'desigualdad', 'disseminacao', 'escalar', 'estrategico', 'infectar', 'normalidad', 'planar', 'precisao', 'prioridad', 'prioridad', 'reducao', 'tendencia']","[1, 1, 1, 1, 1, 1, 1, 1, 1, 1, 1, 1, 2, 2, 1, 1]","[]","[]",16,0,16,1
6688,"['europeu']","[1]","['catedr']","[1]",1,1,2,1
6691,"['contencao', 'deslocamento', 'especialment', 'especialment', 'preocupacao', 'respiratorio', 'respiratorio', 'temor', 'temor', 'vulneravel']","[1, 1, 2, 2, 1, 2, 2, 2, 2, 1]","[]","[]",10,0,10,1
6692,"['airlin', 'aplicacao', 'desenvolvido', 'escalar', 'guarulho', 'instituto', 'parceria', 'remessar', 'totalizar']","[1, 1, 1, 1, 1, 1, 1, 1, 1]","[]","[]",9,0,9,1
6693,"['biliao', 'conformar', 'conformar', 'decisao', 'decisao', 'decisao', 'destinar', 'determinacao', 'independentement', 'lewandowski', 'lewandowski', 'lewandowski', 'lewandowski', 'lewandowski', 'ministrar', 'necessario', 'plenario', 'proporcao', 'recurso', 'recurso', 'recurso', 'regrar', 'ricardo', 'sigla', 'supremo', 'tendencia', 'volumar']","[1, 2, 2, 3, 3, 3, 1, 1, 1, 5, 5, 5, 5, 5, 1, 1, 1, 1, 3, 3, 3, 1, 1, 1, 1, 1, 1]","['legendar']","[1]",27,1,28,1
6695,"['autorizacao', 'excecao', 'fundacao', 'isolar', 'isolar', 'isolar', 'isolar', 'mudanca', 'respostar', 'saudar']","[1, 1, 1, 4, 4, 4, 4, 1, 1, 1]","[]","[]",10,0,10,1
6696,"['alcolumbr', 'bolsonarista', 'calheiro', 'kassio', 'kassio', 'supremo']","[1, 1, 1, 2, 2, 1]","['ganhar']","[1]",6,1,7,1
6697,"['azevedo', 'exgovernador', 'exgovernador', 'exgovernador', 'humberto', 'magistrado', 'oliveira', 'prazo', 'ricardo']","[1, 3, 3, 3, 1, 1, 1, 1, 1]","[]","[]",9,0,9,1
6698,"['infectar']","[1]","[]","[]",1,0,1,1
6699,"['administrativo', 'ambientar', 'bandeirant', 'bandeirant', 'bandeirant', 'improbidad', 'situacao', 'situacao', 'wilson', 'witzel']","[1, 1, 3, 3, 3, 1, 2, 2, 1, 1]","[]","[]",10,0,10,1
6700,"['adversario', 'enfrentamento', 'parceria', 'regiao']","[1, 1, 1, 1]","[]","[]",4,0,4,1
6701,"['esperancar', 'importancia', 'renata', 'souza', 'souza', 'transmissao', 'transmissao']","[1, 1, 1, 2, 2, 2, 2]","['filmar', 'imagem', 'invadir']","[1, 1, 1]",7,3,10,1
6702,"['fabricacao', 'fabricacao', 'importacao', 'instituto', 'instituto', 'instituto', 'materiaprima']","[2, 2, 1, 3, 3, 3, 1]","[]","[]",7,0,7,1
6704,"['dedicar', 'destacar', 'saudar', 'sobretudo']","[1, 1, 1, 1]","['macho']","[1]",4,1,5,1
6705,"['congresso', 'contabilizar', 'demrj', 'diariament', 'diariament', 'exministro', 'exministro', 'folhar', 'henriqu', 'levantamento', 'nelson', 'pastar', 'prever', 'sabado', 'saudar', 'saudar', 'teich']","[1, 1, 1, 2, 2, 2, 2, 1, 1, 1, 1, 1, 1, 1, 2, 2, 1]","[]","[]",17,0,17,1
6706,"['administrativo', 'administrativo', 'aprovacao', 'aprovacao', 'aprovacao', 'apurar', 'broadcast', 'broadcast', 'congresso', 'economia', 'economia', 'economia', 'gued', 'gued', 'gued', 'ministrar', 'mudanca', 'mudanca', 'pacheco', 'pacheco', 'pacheco', 'planalto', 'proposto', 'proposto', 'proposto', 'reforcar', 'regrar', 'regrar', 'superar']","[2, 2, 3, 3, 3, 1, 2, 2, 1, 3, 3, 3, 3, 3, 3, 1, 2, 2, 3, 3, 3, 1, 3, 3, 3, 1, 2, 2, 1]","[]","[]",29,0,29,1
6707,"['antecipar', 'bandeirant', 'colunista', 'conformar', 'destinar', 'folhar', 'republico', 'saudar', 'supremo']","[1, 1, 1, 1, 1, 1, 1, 1, 1]","[]","[]",9,0,9,1
6708,"['alcolumbr', 'alcolumbr', 'demap', 'demrj', 'henriqu', 'justicar', 'magistrado', 'ministrar', 'ministrar', 'negativar', 'preventivo', 'sabado', 'saudar', 'supremo']","[2, 2, 1, 1, 1, 1, 1, 2, 2, 1, 1, 1, 1, 1]","[]","[]",14,0,14,1
6710,"['caxia', 'duqu', 'fluminens', 'julgamento', 'justicar', 'justicar', 'situacao', 'supremo', 'turma']","[1, 1, 1, 1, 2, 2, 1, 1, 1]","[]","[]",9,0,9,1
6711,"['superar', 'superar', 'variacao']","[2, 2, 1]","[]","[]",3,0,3,1
6712,"['advocaciager', 'alvorar', 'ambito', 'argumentar', 'argumentar', 'atuacao', 'atuacao', 'aurelio', 'aurelio', 'conjuntar', 'destacar', 'diariament', 'discussao', 'discussao', 'enfrentamento', 'entendimento', 'julgamento', 'justicar', 'ministrar', 'nomeacao', 'palacio', 'privar', 'privar', 'privar', 'recurso', 'republico', 'republico', 'supremo', 'supremo', 'transferencia', 'transmissao', 'transmissao']","[1, 1, 1, 2, 2, 2, 2, 2, 2, 1, 1, 1, 2, 2, 1, 1, 1, 1, 1, 1, 1, 3, 3, 3, 1, 2, 2, 2, 2, 1, 2, 2]","['compartilhar', 'interaco', 'usuario', 'usuario', 'usuario']","[1, 1, 3, 3, 3]",32,5,37,1
6714,"['alternativo', 'escalar', 'expectativa', 'interlocutor', 'interlocutor', 'justicar', 'ministrar', 'ministrar', 'ministrar', 'possibilidad', 'ramagem', 'ramagem', 'recebido']","[1, 1, 1, 2, 2, 1, 3, 3, 3, 1, 2, 2, 1]","[]","[]",13,0,13,1
6715,"['associacao', 'associacao', 'domingo', 'necessario', 'queixar', 'queixar', 'suspeito']","[2, 2, 1, 1, 2, 2, 1]","[]","[]",7,0,7,1
6716,"['afp', 'autoridad', 'decisao', 'determinacao', 'habitant', 'regiao']","[1, 1, 1, 1, 1, 1]","[]","[]",6,0,6,1
6721,"['atrasar', 'atrasar', 'diminuicao', 'distrito', 'equipamento', 'equipamento', 'manutencao', 'modelo', 'modelo', 'prever', 'prever', 'prever', 'reducao', 'reducao']","[2, 2, 1, 1, 2, 2, 1, 2, 2, 3, 3, 3, 2, 2]","[]","[]",14,0,14,1
6722,"['cooperacao', 'etapa', 'expectativa', 'imunizacao', 'parceria', 'preliminar', 'previsao']","[1, 1, 1, 1, 1, 1, 1]","[]","[]",7,0,7,1
6726,"['argumentar', 'aurelio', 'autorizacao', 'decisao', 'gabinet', 'gabinet', 'integro', 'justicar', 'mello', 'mello', 'ministrar', 'pereira', 'previo', 'privilegiar', 'supremo', 'supremo']","[1, 1, 1, 1, 2, 2, 1, 1, 2, 2, 1, 1, 1, 1, 2, 2]","[]","[]",16,0,16,1
6732,"['anteriorment', 'anteriorment', 'bruto', 'consumidor', 'crescimento', 'crescimento', 'crescimento', 'crescimento', 'economia', 'economia', 'economia', 'expansao', 'expansao', 'internar', 'pib', 'pib', 'pib', 'recordar', 'reflexo', 'revisar', 'taxar']","[2, 2, 1, 1, 4, 4, 4, 4, 3, 3, 3, 2, 2, 1, 3, 3, 3, 1, 1, 1, 1]","['obama']","[1]",21,1,22,1
6733,"['balancar', 'bruto', 'conjuntar', 'desenvolvimento', 'economia', 'economia', 'economia', 'economia', 'economia', 'economia', 'economia', 'entendimento', 'especialment', 'gued', 'instituto', 'internar', 'ministrar', 'pagamento', 'sigla']","[1, 1, 1, 1, 7, 7, 7, 7, 7, 7, 7, 1, 1, 1, 1, 1, 1, 1, 1]","[]","[]",19,0,19,1
6738,"['aprovacao', 'aprovacao', 'aprovacao', 'constituicao', 'emendar', 'exministro', 'justicar', 'prioridad', 'prioridad', 'proposto']","[3, 3, 3, 1, 1, 1, 1, 2, 2, 1]","[]","[]",10,0,10,1
6743,"['alvaro', 'alvaro', 'alvaro', 'antonio', 'antonio', 'antonio', 'assintomatico', 'bancada', 'ministrar', 'ministrar', 'ministrar', 'ministrar', 'ministrar', 'palacio', 'pastar', 'planalto', 'positivar', 'saudar', 'saudar']","[3, 3, 3, 3, 3, 3, 1, 1, 5, 5, 5, 5, 5, 1, 1, 1, 1, 2, 2]","[]","[]",19,0,19,1
6744,"['aplicacao', 'edson', 'expectativa', 'funcao', 'habitant', 'imunizacao', 'planar', 'planar', 'previsto', 'rigoroso', 'sabado', 'saudar', 'saudar', 'saudar', 'saudar', 'saudar']","[1, 1, 1, 1, 1, 1, 2, 2, 1, 1, 1, 5, 5, 5, 5, 5]","[]","[]",16,0,16,1
6745,"['aglomeracao', 'antecipar', 'demandar', 'mudanca', 'orientacao', 'reforcar', 'reforcar']","[1, 1, 1, 1, 1, 2, 2]","[]","[]",7,0,7,1
6746,"['afp', 'balancar', 'balancar', 'espanha', 'flexibilizar', 'normalidad', 'regiao', 'regiao', 'sabado', 'sabado', 'superar']","[1, 2, 2, 1, 1, 1, 2, 2, 2, 2, 1]","[]","[]",11,0,11,1
6747,"['apreensao', 'equipamento', 'irregularidad', 'justicar', 'ministrar', 'pereira', 'respirador', 'saudar', 'saudar', 'suspeito', 'suspeito']","[1, 1, 1, 1, 1, 1, 1, 2, 2, 2, 2]","['fraudar']","[1]",11,1,12,1
6748,"['californio']","[1]","[]","[]",1,0,1,1
6750,"['colleg', 'comunitario', 'constatar', 'disseminacao', 'epidemiar', 'fase', 'inglaterra', 'inglaterra', 'inglaterra', 'revisar', 'transmissao']","[1, 1, 1, 1, 1, 1, 3, 3, 3, 1, 1]","[]","[]",11,0,11,1
6755,"['autoridad', 'economia', 'equilibrio', 'especializar', 'kong', 'normalidad', 'provincia', 'rastreamento', 'saudar', 'surtir', 'surto', 'vigilancia']","[1, 1, 1, 1, 1, 1, 1, 1, 1, 1, 1, 1]","['imagem', 'implantar', 'tampouco']","[1, 1, 1]",12,3,15,1
6756,"['adulto', 'carat', 'conformar', 'correspondent', 'distrito', 'pastar', 'reforcar', 'saudar', 'saudar', 'temporario']","[1, 1, 1, 1, 1, 1, 1, 2, 2, 1]","[]","[]",10,0,10,1
6757,"['companhia', 'contabilizar', 'domingo', 'impactar', 'respiratorio', 'restritivo', 'saudar']","[1, 1, 1, 1, 1, 1, 1]","['implantar']","[1]",7,1,8,1
6761,"['academico', 'administrativo', 'alvorar', 'araujo', 'araujo', 'araujo', 'atrasar', 'atuacao', 'atuacao', 'atuacao', 'avancar', 'biliao', 'biliao', 'biliao', 'cenario', 'cenario', 'comissao', 'concreto', 'congresso', 'congresso', 'congresso', 'congresso', 'congresso', 'congresso', 'consequencia', 'consolidar', 'crise', 'crise', 'crise', 'crise', 'crise', 'cupula', 'decisao', 'demandar', 'destinar', 'destinar', 'economia', 'economia', 'emendar', 'emendar', 'enfrentamento', 'enfrentamento', 'ernesto', 'escalar', 'expectativa', 'flavia', 'gued', 'imunizacao', 'incerteza', 'inconsistencia', 'instituto', 'insuficient', 'interpretar', 'investigacao', 'itamarati', 'jantar', 'legislativo', 'legislativo', 'lira', 'lira', 'martim', 'martim', 'ministrar', 'ministrar', 'ministrar', 'nomeacao', 'orcamentaria', 'pacheco', 'pagamento', 'palacio', 'pastar', 'pastar', 'patamar', 'planalto', 'planalto', 'plenario', 'plenario', 'positivar', 'possibilidad', 'posturar', 'prever', 'privatizacao', 'quedo', 'recurso', 'recurso', 'republico', 'reuniao', 'ribeiro', 'sabatino', 'sessao', 'sessao', 'situacao', 'subir', 'tributario', 'vetar', 'vetar']","[1, 1, 1, 3, 3, 3, 1, 3, 3, 3, 1, 3, 3, 3, 2, 2, 1, 1, 6, 6, 6, 6, 6, 6, 1, 1, 5, 5, 5, 5, 5, 1, 1, 1, 2, 2, 2, 2, 2, 2, 2, 2, 1, 1, 1, 1, 1, 1, 1, 1, 1, 1, 1, 1, 1, 1, 2, 2, 2, 2, 2, 2, 3, 3, 3, 1, 1, 1, 1, 1, 2, 2, 1, 2, 2, 2, 2, 1, 1, 1, 1, 1, 1, 2, 2, 1, 1, 1, 1, 2, 2, 1, 1, 1, 2, 2]","['narrativo', 'sortir']","[1, 1]",96,2,98,1
6763,"['alteracao', 'campino', 'enquadrar', 'especifico']","[1, 1, 1, 1]","['pelar', 'vitaminar', 'zincar']","[1, 1, 1]",4,3,7,1
6766,"['adotada', 'anvisa', 'anvisa', 'assistencia', 'client', 'destinar', 'estrategia', 'investigacao', 'minimizar', 'orientacao', 'orientacao', 'prever', 'privar', 'realizacao', 'realizacao', 'realizacao', 'saudar', 'saudar', 'suspeito', 'vigilancia']","[1, 2, 2, 1, 1, 1, 1, 1, 1, 2, 2, 1, 1, 3, 3, 3, 2, 2, 1, 1]","[]","[]",20,0,20,1
6767,"['amplo', 'antecipar', 'assistencia', 'assistencia', 'consolidar', 'decisao', 'estrategico', 'flexibilizacao', 'flexibilizar', 'mprj', 'planar', 'prazo', 'previsao', 'previsao', 'saudar', 'suspensao', 'urbano', 'vigilancia', 'vulneravel', 'wilson', 'witzel']","[1, 1, 2, 2, 1, 1, 1, 1, 1, 1, 1, 1, 2, 2, 1, 1, 1, 1, 1, 1, 1]","[]","[]",21,0,21,1
6770,"['atuacao', 'condenacao', 'condenacao', 'crise', 'depoimento', 'inquerito', 'inquerito', 'investigacao', 'justicar', 'lewandowski', 'ministrar', 'ministrar', 'ministrar', 'ministrar', 'pastar', 'prazo', 'ricardo', 'saudar', 'supremo', 'supremo', 'supremo', 'suspeito', 'tramitar', 'tramitar']","[1, 2, 2, 1, 1, 2, 2, 1, 1, 1, 4, 4, 4, 4, 1, 1, 1, 1, 3, 3, 3, 1, 2, 2]","[]","[]",24,0,24,1
6771,"['decisao', 'deteccao', 'distrito', 'distrito', 'examinar', 'internar', 'justicar', 'oliveira', 'orientacao', 'positivar', 'realizacao', 'realizacao', 'saudar', 'saudar', 'varar']","[1, 1, 2, 2, 1, 1, 1, 1, 1, 1, 2, 2, 2, 2, 1]","[]","[]",15,0,15,1
6774,"['apreensao', 'apreensao', 'deflagrar', 'desvio', 'esquema', 'esquema', 'investigacao', 'justicar', 'lavagem', 'liderar', 'recurso', 'tcu']","[2, 2, 1, 1, 2, 2, 1, 1, 1, 1, 1, 1]","['trafico']","[1]",12,1,13,1
6776,"['adotada', 'alternativo', 'cerimonia', 'fase', 'funcionamento', 'planar', 'regrar', 'restritivo', 'sabado', 'saudar', 'suportar']","[1, 1, 1, 1, 1, 1, 1, 1, 1, 1, 1]","[]","[]",11,0,11,1
6777,"['argumentar', 'decisao', 'desvio', 'edson', 'fachin', 'fachin', 'inquerito', 'justicar', 'ministrar', 'ministrar', 'observar', 'processo', 'relativo', 'republico', 'supremo', 'tramitar', 'varar']","[1, 1, 1, 1, 2, 2, 1, 1, 2, 2, 1, 1, 1, 1, 1, 1, 1]","[]","[]",17,0,17,1
6778,"['dosar', 'especializar', 'imunizacao']","[1, 1, 1]","['ganhar']","[1]",3,1,4,1
6779,"['adulto', 'adulto', 'adulto', 'adulto', 'anticorpo', 'autoridad', 'autoridad', 'autorizacao', 'autorizacao', 'complicacao', 'converso', 'decisao', 'entregu', 'entregu', 'estagio', 'federar', 'federar', 'hospitalizacao', 'moderno', 'moderno', 'moderno', 'mudanca', 'necessario', 'necessario', 'observar', 'painel', 'pfizerbiontech', 'pfizerbiontech', 'pfizerbiontech', 'pfizerbiontech', 'plano', 'portavoz', 'preparacao', 'respostar', 'revisar', 'revisar', 'semestr', 'sigla', 'significativo', 'suprimento', 'suprimento', 'suprimento', 'suprimento', 'surtir']","[4, 4, 4, 4, 1, 2, 2, 2, 2, 1, 1, 1, 2, 2, 1, 2, 2, 1, 3, 3, 3, 1, 2, 2, 1, 1, 4, 4, 4, 4, 1, 1, 1, 1, 2, 2, 1, 1, 1, 4, 4, 4, 4, 1]","[]","[]",44,0,44,1
6780,"['bolsonarista', 'domingo', 'respostar', 'situacao']","[1, 1, 1, 1]","['desgracar']","[1]",4,1,5,1
6781,"['administrativo', 'advocaciager', 'decisao', 'distrito', 'gabinet', 'justicar', 'palacio', 'planalto', 'privar', 'suspenso']","[1, 1, 1, 1, 1, 1, 1, 1, 1, 1]","['gleisi', 'gleisi', 'imagem']","[2, 2, 1]",10,3,13,1
6782,"['infectar', 'infectar', 'isolar', 'normalment', 'preventivo', 'quarentenar', 'surtir']","[2, 2, 1, 1, 1, 1, 1]","[]","[]",7,0,7,1
6783,"['aplicacao', 'cenario', 'claudio', 'epidemiar', 'fluminens', 'infectar', 'infectar', 'instituto', 'notificar', 'notificar', 'orientacao', 'periodo', 'previsto', 'saudar', 'saudar', 'ufrj', 'ufrj', 'ufrj']","[1, 1, 1, 1, 1, 2, 2, 1, 2, 2, 1, 1, 1, 2, 2, 3, 3, 3]","['quinzena']","[1]",18,1,19,1
6784,"['acumular', 'alternativo', 'client', 'consultoria', 'consultoria', 'estatistico', 'exjuiz', 'investigacao', 'justicar', 'ministrar', 'ministrar', 'observar', 'prazo', 'quarentenar']","[1, 1, 1, 2, 2, 1, 1, 1, 1, 2, 2, 1, 1, 1]","[]","[]",14,0,14,1
6785,"['apoio', 'bruno', 'bruno', 'bruno', 'dificuldad', 'palacio', 'proprio', 'prtb']","[1, 3, 3, 3, 1, 1, 1, 1]","[]","[]",8,0,8,1
6787,"['atuam', 'coordenar', 'destinar', 'distrito', 'entregu', 'fundacao', 'instituto', 'oswaldo', 'pastar', 'prioritario', 'saudar', 'saudar', 'saudar', 'saudar', 'vigilancia']","[1, 1, 1, 1, 1, 1, 1, 1, 1, 1, 4, 4, 4, 4, 1]","[]","[]",15,0,15,1
6789,"['converso', 'dialogo', 'entregu', 'folhar', 'integro', 'supremo']","[1, 1, 1, 1, 1, 1]","[]","[]",6,0,6,1
6793,"['minoria', 'periferia', 'periferia', 'periferia', 'saudar', 'saudar', 'saudar', 'suspeito', 'testagem', 'vulnerabilidad']","[1, 3, 3, 3, 3, 3, 3, 1, 1, 1]","[]","[]",10,0,10,1
6794,"['infectar', 'observar', 'saudar', 'taxar']","[1, 1, 1, 1]","[]","[]",4,0,4,1
6795,"['cupula', 'extensa', 'journal', 'journal', 'nelson', 'proposta']","[1, 1, 2, 2, 1, 1]","[]","[]",6,0,6,1
6796,"['elaborar', 'justicar']","[1, 1]","[]","[]",2,0,2,1
6797,"['cnj', 'cnj', 'condicao', 'condicao', 'constatar', 'decorrencia', 'extraordinario', 'funcionamento', 'justicar', 'ministrar', 'plantao', 'prazo', 'presenca', 'presenciar', 'processo', 'resolucao', 'resolucao', 'resolucao', 'saudar', 'suspenso', 'tramitar']","[2, 2, 2, 2, 1, 1, 1, 1, 1, 1, 1, 1, 1, 1, 1, 3, 3, 3, 1, 1, 1]","[]","[]",21,0,21,1
6801,"['defendido', 'desempenhar', 'exministro']","[1, 1, 1]","['espalhar']","[1]",3,1,4,1
6802,"['adiamento', 'adiamento', 'administrativo', 'aprovacao', 'autoridad', 'congresso', 'emergenciai', 'europeu', 'mantido', 'periodo', 'prorrogar', 'provisorio', 'punicao', 'regrar']","[2, 2, 1, 1, 1, 1, 1, 1, 1, 1, 1, 1, 1, 1]","[]","[]",14,0,14,1
6805,"['apurar', 'autoridad', 'coordenar', 'crise', 'esforco', 'esforco', 'improbidad', 'inquerito', 'logistico', 'opcao', 'plena', 'preventivo', 'spaulo', 'transferir']","[1, 1, 1, 1, 2, 2, 1, 1, 1, 1, 1, 1, 1, 1]","[]","[]",14,0,14,1
6806,"['balancar', 'balancar', 'superar', 'superar']","[2, 2, 2, 2]","[]","[]",4,0,4,1
6808,"['cenario', 'compromisso', 'destacar', 'destacar', 'enfrentamento', 'enfrentamento', 'estrategico', 'importancia', 'inovacao', 'modelo', 'modelo', 'pastar', 'projecao', 'recurso', 'recurso', 'reforcar', 'saudar', 'saudar', 'saudar', 'saudar', 'saudar', 'saudar', 'saudar', 'saudar']","[1, 1, 2, 2, 2, 2, 1, 1, 1, 2, 2, 1, 1, 2, 2, 1, 8, 8, 8, 8, 8, 8, 8, 8]","['compartilhar', 'compartilhar']","[2, 2]",24,2,26,1
6809,"['estagio']","[1]","[]","[]",1,0,1,1
6811,"['autoridad', 'bancada', 'infectar', 'situacao']","[1, 1, 1, 1]","['circular', 'circular', 'compartilhar', 'desmentir', 'falsar', 'imagem', 'lupa', 'narrativo', 'verificar']","[2, 2, 1, 1, 1, 1, 1, 1, 1]",4,9,13,1
6812,"['acordo', 'apreensao', 'assistenci', 'conduta', 'deflagrar', 'esquema', 'fase', 'investigacao', 'investigacao', 'oliveira', 'pereira', 'pratico', 'quilometro', 'recurso', 'regiao', 'regiao', 'republico', 'situacao']","[1, 1, 1, 1, 1, 1, 1, 2, 2, 1, 1, 1, 1, 1, 2, 2, 1, 1]","[]","[]",18,0,18,1
6816,"['apurar', 'cometido', 'inquerito', 'justicar', 'legislativo', 'obtido', 'segredar', 'servidor', 'servidor', 'servidor', 'tramitar']","[1, 1, 1, 1, 1, 1, 1, 3, 3, 3, 1]","['compartilhar', 'invadir']","[1, 1]",11,2,13,1
6817,"['contemplar', 'mendonca', 'recebido', 'visitant']","[1, 1, 1, 1]","['imagem']","[1]",4,1,5,1
6818,"['alteracao', 'anuncio', 'companhia']","[1, 1, 1]","['imagem', 'imagem', 'imagem', 'imagem', 'imagem', 'postagen']","[5, 5, 5, 5, 5, 1]",3,6,9,1
6819,"['afetado', 'afp', 'condicao', 'crise', 'florido', 'infeccioso', 'preventivo', 'prever', 'saudar']","[1, 1, 1, 1, 1, 1, 1, 1, 1]","[]","[]",9,0,9,1
6820,"['apreensao', 'contrato', 'contrato', 'deflagrar', 'destinar', 'equipamento', 'federar', 'ideologico', 'instalacao', 'recurso', 'recurso', 'regiao', 'saudar', 'saudar', 'saudar', 'suspeito', 'temporario', 'totalizar']","[1, 2, 2, 1, 1, 1, 1, 1, 1, 2, 2, 1, 3, 3, 3, 1, 1, 1]","['fraudar']","[1]",18,1,19,1
6822,"['celso', 'desenvolvido', 'metropolitano', 'opcao', 'regiao']","[1, 1, 1, 1, 1]","[]","[]",5,0,5,1
6823,"['ambito', 'iniciativo', 'instituto', 'journal', 'revisar', 'rigoroso', 'saudar', 'submetido']","[1, 1, 1, 1, 1, 1, 1, 1]","[]","[]",8,0,8,1
6824,"['afetado', 'antecipar', 'avancar', 'balancar', 'circulacao', 'complicacao', 'diagnosticar', 'disseminacao', 'dosar', 'dosar', 'dosar', 'dosar', 'espirito', 'imunizacao', 'isolar', 'necessidad', 'oliveira', 'oliveira', 'oliveira', 'panamericana', 'paralelo', 'periodo', 'possibilidad', 'preventivo', 'reforcar', 'rotina', 'sarampo', 'sarampo', 'sarampo', 'sarampo', 'sarampo', 'sarampo', 'sarampo', 'sarampo', 'saudar', 'saudar', 'saudar', 'saudar', 'significativo', 'surtir', 'surtir', 'surtir', 'suspeito', 'suspeito', 'transmissao', 'volumar']","[1, 1, 1, 1, 1, 1, 1, 1, 4, 4, 4, 4, 1, 1, 1, 1, 3, 3, 3, 1, 1, 1, 1, 1, 1, 1, 8, 8, 8, 8, 8, 8, 8, 8, 4, 4, 4, 4, 1, 3, 3, 3, 2, 2, 1, 1]","[]","[]",46,0,46,1
6831,"['disseminacao', 'infeccioso', 'infectar', 'liderar', 'mutacao', 'preliminar', 'preocupacao']","[1, 1, 1, 1, 1, 1, 1]","[]","[]",7,0,7,1
6833,"['anuncio', 'arthur', 'consequencia', 'crise', 'decisao', 'decisao', 'decisao', 'dialogo', 'divergencia', 'enfrentamento', 'infectar', 'reabertura', 'reabertura', 'reabrir', 'wilson']","[1, 1, 1, 1, 3, 3, 3, 1, 1, 1, 1, 2, 2, 1, 1]","[]","[]",15,0,15,1
6834,"['academiar', 'acordo', 'acordo', 'companhia', 'crise', 'dificultar', 'dificultar', 'economia', 'enfrentamento', 'federativo', 'gued', 'gued', 'ministrar', 'ministrar', 'prioridad', 'privatizacao', 'privatizacao', 'privatizacao', 'privatizacao']","[1, 2, 2, 1, 1, 2, 2, 1, 1, 1, 2, 2, 2, 2, 1, 4, 4, 4, 4]","[]","[]",19,0,19,1
6838,"['adotada', 'adotada', 'distrito', 'epidemiar', 'estrategia', 'implementacao', 'instituto', 'instituto', 'monitoramento', 'orientacao', 'propagacao', 'propagacao', 'realizacao', 'realizacao', 'saudar', 'saudar', 'saudar', 'saudar', 'saudar', 'sequenciamento', 'sequenciamento', 'vigilancia']","[2, 2, 1, 1, 1, 1, 2, 2, 1, 1, 2, 2, 2, 2, 5, 5, 5, 5, 5, 2, 2, 1]","[]","[]",22,0,22,1
6843,"['conjunto', 'destacar', 'prioritario', 'propagacao', 'reabrir']","[1, 1, 1, 1, 1]","[]","[]",5,0,5,1
6844,"['client', 'concessionario', 'entregu', 'equipamento', 'habito', 'lavagem', 'parceria', 'passageiro']","[1, 1, 1, 1, 1, 1, 1, 1]","[]","[]",8,0,8,1
6852,"['afetado', 'condicao', 'portavoz', 'respiratorio', 'saudar', 'saudar']","[1, 1, 1, 1, 2, 2]","[]","[]",6,0,6,1
6854,"['cerimonia']","[1]","[]","[]",1,0,1,1
6855,"['alerj', 'anteontem', 'atuacao', 'colegiado', 'desvio', 'especializar', 'esquema', 'fabricio', 'flavio', 'flavio', 'flavio', 'gabinet', 'investigacao', 'investigacao', 'justicar', 'lavagem', 'legislativo', 'queiroz', 'rachadinha', 'recurso', 'recurso', 'recurso', 'republicanosrj', 'suspeito', 'turma', 'turma']","[1, 1, 1, 1, 1, 1, 1, 1, 3, 3, 3, 1, 2, 2, 1, 1, 1, 1, 1, 3, 3, 3, 1, 1, 2, 2]","[]","[]",26,0,26,1
6861,"['calculo', 'calculo', 'calculo', 'consorcio', 'contabilizar', 'diariament', 'dosar', 'dosar', 'enxergar', 'equivalent', 'escassez', 'estabilidad', 'estatistico', 'folhar', 'inconsistencia', 'infectar', 'iniciativo', 'periodo', 'plantao', 'quedo', 'recordar', 'recurso', 'regiao', 'restritivo', 'saudar', 'saudar', 'saudar', 'spaulo', 'tendencia', 'tendencia', 'totalizar']","[3, 3, 3, 1, 1, 1, 2, 2, 1, 1, 1, 1, 1, 1, 1, 1, 1, 1, 1, 1, 1, 1, 1, 1, 3, 3, 3, 1, 2, 2, 1]","[]","[]",31,0,31,1
6862,"['adotada', 'carat', 'congresso', 'pagamento', 'possibilidad', 'prever', 'previsto', 'psicologo', 'saudar', 'saudar', 'saudar', 'saudar', 'saudar']","[1, 1, 1, 1, 1, 1, 1, 1, 5, 5, 5, 5, 5]","[]","[]",13,0,13,1
6864,"['alcolumbr', 'alvorar', 'compromisso', 'congresso', 'conjunto', 'coordenar', 'decisao', 'demap', 'demrj', 'mandatario', 'ministrar', 'palacio', 'republico', 'supremo']","[1, 1, 1, 1, 1, 1, 1, 1, 1, 1, 1, 1, 1, 1]","[]","[]",14,0,14,1
6865,"['apitar', 'bastidor', 'comissao', 'diretoria', 'favorito', 'fluminens', 'motivacao', 'oposto', 'oposto', 'parceria', 'transmissao']","[1, 1, 1, 1, 1, 1, 1, 2, 2, 1, 1]","['imagem']","[1]",11,1,12,1
6867,"['anvisa', 'helen', 'prescricao', 'quadro', 'saudar', 'saudar', 'vigilancia']","[1, 1, 1, 1, 2, 2, 1]","['zincar']","[1]",7,1,8,1
6869,"['desenvolvimento', 'exportacao', 'pedido', 'proprio', 'remessa']","[1, 1, 1, 1, 1]","[]","[]",5,0,5,1
6870,"['competicao', 'iniciativo', 'regrar', 'tornear', 'varar', 'varar']","[1, 1, 1, 1, 2, 2]","[]","[]",6,0,6,1
6873,"['alternativo', 'broadcast', 'crise', 'equivalent', 'jornada', 'pagamento', 'reducao', 'suspensao', 'temporario']","[1, 1, 1, 1, 1, 1, 1, 1, 1]","['compartilhar']","[1]",9,1,10,1
6876,"['anticorpo', 'assintomatico', 'estrategia', 'instituto', 'instituto', 'mudanca', 'presenca', 'presenca', 'previsto', 'respiratorio', 'testagem']","[1, 1, 1, 2, 2, 1, 2, 2, 1, 1, 1]","[]","[]",11,0,11,1
6877,"['dengu', 'transmissao']","[1, 1]","[]","[]",2,0,2,1
6878,"['deslocamento', 'determinacao', 'periodo', 'propagacao', 'rastreamento', 'rigoroso', 'surtir', 'taxar', 'viagem', 'vigilancia']","[1, 1, 1, 1, 1, 1, 1, 1, 1, 1]","['usuario']","[1]",10,1,11,1
6881,"['consolidar', 'diminuicao', 'piorar', 'quedo', 'recordar', 'saudar', 'subir']","[1, 1, 1, 1, 1, 1, 1]","['verificar']","[1]",7,1,8,1
6882,"['autoridad', 'azevedo', 'domingo', 'enfermagem', 'expectativa', 'henriqu', 'risco', 'sabado', 'tripulacao']","[1, 1, 1, 1, 1, 1, 1, 1, 1]","[]","[]",9,0,9,1
6883,"['comissao', 'dialogo', 'governista', 'jorg', 'previsao']","[1, 1, 1, 1, 1]","['limao']","[1]",5,1,6,1
6884,"['cilindro', 'dificuldad', 'medida', 'tambem']","[1, 1, 1, 1]","['gravacao']","[1]",4,1,5,1
6885,"['adesao', 'especifico', 'importancia', 'individuar', 'pastar', 'respostar', 'saudar', 'saudar', 'saudar']","[1, 1, 1, 1, 1, 1, 3, 3, 3]","['usuario']","[1]",9,1,10,1
6890,"['autoridad', 'crescimento', 'distant', 'respostar', 'saudar', 'saudar', 'saudar']","[1, 1, 1, 1, 3, 3, 3]","[]","[]",7,0,7,1
6891,"['opcao', 'pratico', 'pratico', 'quarentenar']","[1, 2, 2, 1]","[]","[]",4,0,4,1
6892,"['suspeito', 'viagem']","[1, 1]","['misericordia']","[1]",2,1,3,1
6893,"['comportamento', 'crescimento', 'epidemiar', 'internacao', 'mudanca', 'observar', 'oficio', 'regiao', 'saudar']","[1, 1, 1, 1, 1, 1, 1, 1, 1]","['verificar']","[1]",9,1,10,1
6894,"['celso', 'congresso', 'consumidor', 'consumidor', 'periodo']","[1, 1, 2, 2, 1]","['pego', 'pego']","[2, 2]",5,2,7,1
6895,"['arrecadar', 'companhia', 'companhia', 'consequencia', 'destacar', 'disseminacao', 'ministrar', 'primeiroministro', 'quilometro', 'suspenso']","[1, 2, 2, 1, 1, 1, 1, 1, 1, 1]","[]","[]",10,0,10,1
6896,"['almeida', 'anteontem', 'internar', 'metropolitano', 'negativar', 'regiao', 'sorocaba']","[1, 1, 1, 1, 1, 1, 1]","[]","[]",7,0,7,1
6899,"['afetado', 'agravar', 'arrecadacao', 'circulacao', 'colaboracao', 'contrato', 'contrato', 'contrato', 'crise', 'crise', 'funcao', 'parceria', 'precedent', 'prever', 'prever', 'proposto', 'quedo', 'reducao', 'taxar']","[1, 1, 1, 1, 1, 3, 3, 3, 2, 2, 1, 1, 1, 2, 2, 1, 1, 1, 1]","[]","[]",19,0,19,1
6903,"['anvisa', 'balancar', 'boletim', 'calculo', 'consorcio', 'consorcio', 'contabilizar', 'desenvolvimento', 'diariament', 'enxergar', 'escassez', 'estabilidad', 'estabilidad', 'estagio', 'estatistico', 'folhar', 'inconsistencia', 'infectar', 'infectar', 'iniciativo', 'parceria', 'pastar', 'piorar', 'plantao', 'quedo', 'quedo', 'recurso', 'reuter', 'saudar', 'saudar', 'spaulo', 'surto', 'taxar', 'tendencia', 'tendencia', 'tendencia', 'totalizar']","[1, 1, 1, 1, 2, 2, 1, 1, 1, 1, 1, 2, 2, 1, 1, 1, 1, 2, 2, 1, 1, 1, 1, 1, 2, 2, 1, 1, 2, 2, 1, 1, 1, 3, 3, 3, 1]","[]","[]",37,0,37,1
6904,"['anuncio', 'apurar', 'augusto', 'depoimento', 'distrito', 'escassez', 'exministro', 'inquerito', 'inquerito', 'inquerito', 'inquerito', 'inquerito', 'instaurar', 'justicar', 'justicar', 'lewandowski', 'martim', 'ministrar', 'ministrar', 'necessario', 'pastar', 'possibilidad', 'privilegiar', 'queiroga', 'republico', 'republico', 'ricardo', 'saudar', 'saudar', 'saudar', 'saudar', 'supremo', 'tramitar', 'tramitar', 'tramitar']","[1, 1, 1, 1, 1, 1, 1, 5, 5, 5, 5, 5, 1, 2, 2, 1, 1, 2, 2, 1, 1, 1, 1, 1, 2, 2, 1, 4, 4, 4, 4, 1, 3, 3, 3]","['versao']","[1]",35,1,36,1
6908,"['demrj', 'economia', 'folhar', 'integro', 'sancao']","[1, 1, 1, 1, 1]","[]","[]",5,0,5,1
6909,"['comparacao', 'desenvolvimento', 'diminuicao', 'fase', 'hospitalizacao', 'hospitalizacao', 'parceria', 'periodo']","[1, 1, 1, 1, 2, 2, 1, 1]","[]","[]",8,0,8,1
6910,"['administrativo', 'argumentar', 'calamidad', 'client', 'consumidor', 'consumidor', 'consumidor', 'fundacao', 'obtido', 'opcao', 'periodo', 'pratico', 'pratico', 'queixar', 'suspensao']","[1, 1, 1, 1, 3, 3, 3, 1, 1, 1, 1, 2, 2, 1, 1]","[]","[]",15,0,15,1
6911,"['escassez', 'florido']","[1, 1]","[]","[]",2,0,2,1
6918,"['apurar', 'movimentacao', 'videoconferencia']","[1, 1, 1]","['filmar']","[1]",3,1,4,1
6919,"['apurar', 'enquadrar', 'folhar', 'folhar', 'inquerito', 'integro', 'investigacao', 'motivacao', 'silveiro']","[1, 1, 2, 2, 1, 1, 1, 1, 1]","['carrefour', 'espancar']","[1, 1]",9,2,11,1
6921,"['juro', 'pagamento', 'piorar', 'piorar', 'privar', 'prorrogacao', 'situacao', 'situacao']","[1, 1, 2, 2, 1, 1, 2, 2]","[]","[]",8,0,8,1
6922,"['apreensao', 'apurar', 'deflagrar', 'equipamento', 'especializar', 'fluminens', 'fornecimento', 'investigacao', 'mprj', 'varar']","[1, 1, 1, 1, 1, 1, 1, 1, 1, 1]","[]","[]",10,0,10,1
6923,"['avancar', 'decisao', 'desenvolvido', 'instituto', 'parceria', 'portavoz', 'saudar', 'saudar']","[1, 1, 1, 1, 1, 1, 2, 2]","[]","[]",8,0,8,1
6925,"['almeida', 'desafiar', 'exgovernador', 'situacao', 'ultimo']","[1, 1, 1, 1, 1]","[]","[]",5,0,5,1
6927,"['epidemia', 'reabrir']","[1, 1]","[]","[]",2,0,2,1
6929,"['antecipar', 'apreensao', 'araujo', 'atrasar', 'destinar', 'entregu', 'equipamento', 'equipamento', 'exportacao', 'fornecimento', 'fornecimento', 'importacao', 'instalacao', 'justicar', 'ministrar', 'oliveira', 'palacio', 'realizacao', 'relativo', 'republico', 'republico', 'respirador', 'respirador', 'respirador', 'saudar', 'saudar', 'saudar']","[1, 1, 1, 1, 1, 1, 2, 2, 1, 2, 2, 1, 1, 1, 1, 1, 1, 1, 1, 2, 2, 3, 3, 3, 3, 3, 3]","[]","[]",27,0,27,1
6930,"['circulacao', 'complicacao', 'complicacao', 'condicao', 'domingo', 'domingo', 'especifico', 'fluxo', 'internar', 'piorar', 'piorar', 'respiratorio', 'respostar', 'situacao']","[1, 2, 2, 1, 2, 2, 1, 1, 1, 2, 2, 1, 1, 1]","['circular', 'disseminar', 'disseminar', 'espalhar']","[1, 2, 2, 1]",14,4,18,1
6932,"['distrito', 'palacio']","[1, 1]","['gasolina']","[1]",2,1,3,1
6933,"['adversario', 'advocaciager', 'advocaciager', 'agravamento', 'algun', 'algun', 'anuncio', 'apoio', 'araujo', 'araujo', 'arthur', 'articulacao', 'articulacao', 'aurelio', 'azevedo', 'azevedo', 'bancada', 'bancada', 'bolsonarista', 'cerimoni', 'certeza', 'circulacao', 'colunista', 'conduta', 'congresso', 'congresso', 'congresso', 'congresso', 'congresso', 'corpu', 'crise', 'desenvolvido', 'diplomata', 'diplomata', 'distrito', 'emenda', 'enquadrar', 'entregu', 'ernesto', 'ernesto', 'eventualment', 'exgovernador', 'flavia', 'flavia', 'flavio', 'funcao', 'funcao', 'habea', 'impacto', 'inquerito', 'integrant', 'integrant', 'integrant', 'investigacao', 'itamarati', 'itamarati', 'jorg', 'legislativo', 'legislativo', 'lira', 'medida', 'mello', 'mendonca', 'mendonca', 'mendonca', 'mendonca', 'monitoramento', 'mudanca', 'none', 'none', 'none', 'oliveira', 'opcao', 'palacio', 'pedido', 'pedido', 'pedido', 'periodo', 'periodo', 'planalto', 'planalto', 'plano', 'porqu', 'ppal', 'processo', 'proposta', 'pslsp', 'quatro', 'quatro', 'recurso', 'recurso', 'relacao', 'relacao', 'republicanosrj', 'resistencia', 'reuniao', 'sido', 'supremo', 'supremo', 'tambem', 'tambem', 'tambem', 'tcu', 'temor']","[1, 2, 2, 1, 2, 2, 1, 1, 2, 2, 1, 2, 2, 1, 2, 2, 2, 2, 1, 1, 1, 1, 1, 1, 5, 5, 5, 5, 5, 1, 1, 1, 2, 2, 1, 1, 1, 1, 2, 2, 1, 1, 2, 2, 1, 2, 2, 1, 1, 1, 3, 3, 3, 1, 2, 2, 1, 2, 2, 1, 1, 1, 4, 4, 4, 4, 1, 1, 3, 3, 3, 1, 1, 1, 3, 3, 3, 2, 2, 2, 2, 1, 1, 1, 1, 1, 1, 2, 2, 2, 2, 2, 2, 1, 1, 1, 1, 2, 2, 3, 3, 3, 1, 1]","[]","[]",104,0,104,1
6934,"['inovacao', 'ministrar', 'pastar']","[1, 1, 1]","['desligar', 'realment']","[1, 1]",3,2,5,1
6935,"['cepa', 'decorrent', 'desenvolvido', 'flexibilizacao', 'infeccioso', 'inglaterra', 'internacao', 'justicar', 'oficio', 'oficio', 'oficio', 'quarentenar', 'reflexo']","[1, 1, 1, 1, 1, 1, 1, 1, 3, 3, 3, 1, 1]","[]","[]",13,0,13,1
6938,"['aplicacao', 'aplicacao', 'argumentar', 'crise', 'decisao', 'decisao', 'desigualdad', 'etapa', 'funcao', 'instituto', 'justicar', 'manutencao', 'necessario', 'planar', 'realizacao']","[2, 2, 1, 1, 2, 2, 1, 1, 1, 1, 1, 1, 1, 1, 1]","[]","[]",15,0,15,1
6941,"['acompanhamento', 'balancar', 'balancar', 'contabilizar', 'infectar', 'infectar', 'investigacao', 'montant', 'periodo', 'recordar', 'saudar']","[1, 2, 2, 1, 2, 2, 1, 1, 1, 1, 1]","[]","[]",11,0,11,1
6944,"['aglomeracao', 'bastidor', 'decisao', 'decisao', 'discussao', 'domingo', 'kassio', 'magistrado', 'ministrar', 'oficialment', 'plenario', 'plenario', 'presenciar', 'previsao', 'sentenca', 'supremo']","[1, 1, 2, 2, 1, 1, 1, 1, 1, 1, 2, 2, 1, 1, 1, 1]","[]","[]",16,0,16,1
6946,"['afetado', 'europeu', 'excecao', 'gabinet', 'preservar', 'primeiroministro', 'propagacao', 'quarentenar', 'submetido', 'taxar', 'viajant']","[1, 1, 1, 1, 1, 1, 1, 1, 1, 1, 1]","[]","[]",11,0,11,1
6947,"['elaborar', 'integro', 'ministrar', 'orientacao', 'pastar', 'respostar', 'saudar', 'submetido', 'tcu']","[1, 1, 1, 1, 1, 1, 1, 1, 1]","[]","[]",9,0,9,1
6948,"['corpu', 'discussao', 'extraordinario', 'fabricio', 'flavio', 'habea', 'investigacao', 'jorg', 'jurista', 'justicar', 'justicar', 'ministrar', 'mprj', 'obtido', 'obtido', 'previsao', 'queiroz', 'rachadinha', 'recurso', 'republicanosrj', 'supremo']","[1, 1, 1, 1, 1, 1, 1, 1, 1, 2, 2, 1, 1, 2, 2, 1, 1, 1, 1, 1, 1]","['ganhar']","[1]",21,1,22,1
6949,"['esperancar']","[1]","['menino']","[1]",1,1,2,1
6952,"['avancar', 'compromisso', 'compromisso', 'decisao', 'inclusao', 'inclusao', 'justificativo', 'observar', 'painel', 'saudar', 'situacao']","[1, 2, 2, 1, 2, 2, 1, 1, 1, 1, 1]","[]","[]",11,0,11,1
6953,"['periodo', 'reforcar', 'respiratorio', 'sarampo', 'saudar']","[1, 1, 1, 1, 1]","[]","[]",5,0,5,1
6955,"['ausencia', 'benjamin', 'cilindro', 'determinacao', 'funcao', 'investigacao', 'lewandowski', 'ministrar', 'ministrar', 'ministrar', 'processo', 'ricardo', 'supremo', 'tcu']","[1, 1, 1, 1, 1, 1, 1, 3, 3, 3, 1, 1, 1, 1]","['despejar', 'supostament']","[1, 1]",14,2,16,1
6957,"['arthur', 'lira', 'mandatario', 'oposto', 'palacio', 'planalto', 'ppal', 'rossi']","[1, 1, 1, 1, 1, 1, 1, 1]","['ideologia']","[1]",8,1,9,1
6960,"['acordo', 'confirmado', 'profissionai', 'sabado']","[1, 1, 1, 1]","[]","[]",4,0,4,1
6961,"['desenvolvimento', 'especialment', 'esperancar', 'fundacao', 'implementacao', 'reuter']","[1, 1, 1, 1, 1, 1]","[]","[]",6,0,6,1
6963,"['bandeirant', 'desenvolvido', 'impactar', 'instituto', 'logistico', 'necessario', 'palacio', 'parceria', 'preocupacao', 'saudar']","[1, 1, 1, 1, 1, 1, 1, 1, 1, 1]","['bandeiro']","[1]",10,1,11,1
6964,"['arthur', 'demmg', 'folhar', 'gabinet', 'integro', 'lira', 'pacheco', 'ppal', 'prtb', 'reuniao']","[1, 1, 1, 1, 1, 1, 1, 1, 1, 1]","[]","[]",10,0,10,1
6965,"['alternativo', 'ambientar', 'amplo', 'iniciativo', 'ministrar', 'preservacao', 'privar', 'privatizacao', 'respostar', 'ricardo', 'sall', 'sall', 'sall']","[1, 1, 1, 1, 1, 1, 1, 1, 1, 1, 3, 3, 3]","[]","[]",13,0,13,1
6966,"['apurar', 'decisao', 'instituto', 'irregularidad', 'irregularidad', 'pagamento', 'revisar', 'situacao', 'tcu']","[1, 1, 1, 2, 2, 1, 1, 1, 1]","[]","[]",9,0,9,1
6968,"['concessionario', 'decisao', 'decisao', 'economia', 'enquadrar', 'justicar', 'justicar', 'magistrado', 'prever', 'proferir', 'reabertura', 'reabertura', 'reabertura']","[1, 2, 2, 1, 1, 2, 2, 1, 1, 1, 3, 3, 3]","[]","[]",13,0,13,1
6973,"['apurar', 'barroso', 'barroso', 'barroso', 'crise', 'decisao', 'decisao', 'decisao', 'instalacao', 'interferencia', 'jorg', 'ministrar', 'necessario', 'palacio', 'planalto', 'supremo', 'vieira']","[1, 3, 3, 3, 1, 3, 3, 3, 1, 1, 1, 1, 1, 1, 1, 1, 1]","[]","[]",17,0,17,1
6974,"['balancar', 'domingo', 'intensivo', 'intensivo', 'intensivo', 'respostar', 'sabado', 'saudar', 'saudar', 'saudar']","[1, 1, 3, 3, 3, 1, 1, 3, 3, 3]","[]","[]",10,0,10,1
6976,"['chefiar', 'decisao', 'inconsistencia', 'justicar', 'justificativo', 'levantamento', 'pastar', 'reclamacao', 'roraima']","[1, 1, 1, 1, 1, 1, 1, 1, 1]","[]","[]",9,0,9,1
6977,"['ambientar', 'apreensao', 'apreensao', 'cupula', 'desempenhar', 'investigacao', 'queiroz', 'reuniao', 'ricardo', 'sall']","[1, 2, 2, 1, 1, 1, 1, 1, 1, 1]","[]","[]",10,0,10,1
6983,"['arthur', 'articulacao', 'associacao', 'congresso', 'congresso', 'congresso', 'congresso', 'lira', 'orcamentaria', 'ppal', 'proposto', 'reuniao', 'reuter', 'sancao']","[1, 1, 1, 4, 4, 4, 4, 1, 1, 1, 1, 1, 1, 1]","[]","[]",14,0,14,1
6990,"['folhar', 'integro', 'ministrar', 'pastar', 'queiroga', 'saudar']","[1, 1, 1, 1, 1, 1]","[]","[]",6,0,6,1
6992,"['aplicacao', 'dificultar', 'intubacao', 'logistico', 'ministrar', 'necessario', 'planar', 'respirador', 'saudar', 'saudar']","[1, 1, 1, 1, 1, 1, 1, 1, 2, 2]","[]","[]",10,0,10,1
6993,"['decisao', 'emprestimo', 'inconsistencia', 'investigacao', 'justicar', 'magistrado', 'magistrado', 'metropolitano', 'movimentacao', 'movimentacao', 'pagamento', 'suspeito', 'suspeito', 'totalizar', 'varar']","[1, 1, 1, 1, 1, 2, 2, 1, 2, 2, 1, 2, 2, 1, 1]","[]","[]",15,0,15,1
6996,"['goncalo', 'metropolitano', 'metropolitano', 'regiao', 'regiao', 'regiao', 'substituicao', 'substituicao']","[1, 2, 2, 3, 3, 3, 2, 2]","[]","[]",8,0,8,1
7000,"['absoluto', 'apurar', 'dedicar', 'intensivo', 'internar', 'internar', 'internar', 'internar', 'internar', 'internar', 'internar', 'privar', 'saudar', 'saudar', 'sindicato', 'varga']","[1, 1, 1, 1, 7, 7, 7, 7, 7, 7, 7, 1, 2, 2, 1, 1]","['menino']","[1]",16,1,17,1
7002,"[]","[]","[]","[]",0,0,0,1
7003,"['converso', 'integro', 'republico']","[1, 1, 1]","[]","[]",3,0,3,1
7004,"['atuacao', 'augusto', 'chefiar', 'cooperacao', 'destacar', 'integrant', 'investigacao', 'nomeacao', 'nomeacao', 'permanencia', 'republico', 'republico', 'republico', 'republico']","[1, 1, 1, 1, 1, 1, 1, 2, 2, 1, 4, 4, 4, 4]","[]","[]",14,0,14,1
7005,"['agravar', 'decorrencia', 'desigualdad', 'efetividad', 'epidemiologico', 'levantamento', 'periodo', 'saudar', 'saudar']","[1, 1, 1, 1, 1, 1, 1, 2, 2]","[]","[]",9,0,9,1
7007,"['coordenar', 'deslocamento', 'economia', 'epidemiar', 'escalar', 'europeu', 'fronteiro', 'fronteiro', 'fronteiro', 'levantamento', 'reabertura', 'reabrir', 'reabrir', 'recuperacao', 'relaxar', 'turista']","[1, 1, 1, 1, 1, 1, 3, 3, 3, 1, 1, 2, 2, 1, 1, 1]","[]","[]",16,0,16,1
7008,"['acumular', 'afp', 'balancar', 'diagnosticar', 'infectar', 'infectar', 'kong', 'sabado', 'sabado']","[1, 1, 1, 1, 2, 2, 1, 2, 2]","[]","[]",9,0,9,1
7009,"['colaborar', 'distrito', 'justicar', 'ministrar', 'ministrar', 'necessario', 'necessario', 'quarentenar', 'saudar', 'saudar', 'saudar', 'supremo', 'supremo', 'suspeito', 'suspeito', 'suspeito']","[1, 1, 1, 2, 2, 2, 2, 1, 3, 3, 3, 2, 2, 3, 3, 3]","[]","[]",16,0,16,1
7010,"['atrasar', 'atrasar', 'barroso', 'barroso', 'ministrar', 'ministrar', 'normalment', 'recebido']","[2, 2, 2, 2, 2, 2, 1, 1]","[]","[]",8,0,8,1
7013,"['autoridad', 'converso', 'cooperacao', 'positivar', 'saudar', 'suspensao']","[1, 1, 1, 1, 1, 1]","['compartilhar']","[1]",6,1,7,1
7014,"['aurelio', 'aurelio', 'coordenar', 'crise', 'decisao', 'implementar', 'importancia', 'kassio', 'mello', 'ministrar', 'ministrar', 'ministrar', 'ministrar', 'sabado', 'supremo', 'supremo']","[2, 2, 1, 1, 1, 1, 1, 1, 1, 4, 4, 4, 4, 1, 2, 2]","[]","[]",16,0,16,1
7016,"['avancar', 'congresso', 'desafio', 'destacar', 'destinar', 'determinacao', 'necessario', 'proposto', 'superar', 'superar', 'supremo']","[1, 1, 1, 1, 1, 1, 1, 1, 2, 2, 1]","['compartilhar', 'compartilhar', 'protestar']","[2, 2, 1]",11,3,14,1
7019,"['destacar', 'necessario', 'necessidad', 'posturar', 'saudar']","[1, 1, 1, 1, 1]","[]","[]",5,0,5,1
7023,"['atuacao', 'ccj', 'comissao', 'congresso', 'congresso', 'congresso', 'constituicao', 'iniciativo', 'justicar', 'paralelo', 'presidir', 'republico', 'situacao', 'situacao', 'unanimidad', 'vulneravel']","[1, 1, 1, 3, 3, 3, 1, 1, 1, 1, 1, 1, 2, 2, 1, 1]","[]","[]",16,0,16,1
7025,"['aglomeracao', 'diagnosticar', 'fabricio', 'respiratorio']","[1, 1, 1, 1]","[]","[]",4,0,4,1
7026,"['antecipar', 'antecipar', 'facilitar', 'instituto', 'julgamento', 'ministrar', 'ministrar', 'ministrar', 'mudanca', 'prazo', 'regrar', 'republico', 'supremo']","[2, 2, 1, 1, 1, 3, 3, 3, 1, 1, 1, 1, 1]","[]","[]",13,0,13,1
7027,"['biliao', 'destinar', 'efetividad', 'efetividad', 'emergenciai', 'manutencao', 'pagamento', 'prazo', 'prorrogar', 'prorrogar', 'provisorio', 'recurso', 'recurso', 'republico', 'transferir']","[1, 1, 2, 2, 1, 1, 1, 1, 2, 2, 1, 2, 2, 1, 1]","[]","[]",15,0,15,1
7029,"['ausencia', 'claudio', 'coordenar', 'instituto', 'modelo', 'necessario', 'orientacao', 'saudar', 'situacao']","[1, 1, 1, 1, 1, 1, 1, 1, 1]","[]","[]",9,0,9,1
7030,"['boletim', 'contabilizar', 'crise', 'disseminacao', 'saudar', 'saudar']","[1, 1, 1, 1, 2, 2]","[]","[]",6,0,6,1
7032,"['acompanhamento', 'comorbidad', 'decisao', 'decisao', 'decisao', 'hipertensao', 'internar', 'justicar', 'lavagem', 'lavagem', 'ministrar', 'periodo', 'preventivo', 'realizacao', 'respiratorio', 'substituicao']","[1, 1, 3, 3, 3, 1, 1, 1, 2, 2, 1, 1, 1, 1, 1, 1]","[]","[]",16,0,16,1
7034,"['bruto', 'economia', 'estatistico', 'estatistico', 'estimativo', 'estimativo', 'europeu', 'expectativa', 'impactar', 'inicialment', 'internar', 'journal', 'periodo', 'pib', 'pib', 'preliminar', 'quedo', 'recuar', 'trimestr', 'trimestr', 'trimestr']","[1, 1, 2, 2, 2, 2, 1, 1, 1, 1, 1, 1, 1, 2, 2, 1, 1, 1, 3, 3, 3]","[]","[]",21,0,21,1
7037,"['antonio', 'anvisa', 'anvisa', 'destac', 'medida', 'medida', 'necessidad', 'passageiro', 'suspeito', 'triagem', 'triagem', 'triagem', 'vigilancia']","[1, 2, 2, 1, 2, 2, 1, 1, 1, 3, 3, 3, 1]","['verificar']","[1]",13,1,14,1
7038,"['autoridad', 'comissao', 'conjuntar', 'domingo', 'preocupacao', 'provincia', 'sabado', 'saudar', 'saudar']","[1, 1, 1, 1, 1, 1, 1, 2, 2]","[]","[]",9,0,9,1
7040,"['supremo', 'tramitar']","[1, 1]","['compartilhar', 'parir', 'soltar', 'soltura']","[1, 1, 1, 1]",2,4,6,1
7043,"['periodo', 'trimestr']","[1, 1]","[]","[]",2,0,2,1
7044,"['autoridad', 'mutacao', 'saudar']","[1, 1, 1]","['espalhar', 'espalhar', 'versao']","[2, 2, 1]",3,3,6,1
7045,"['companhia', 'pslsp', 'publicitario']","[1, 1, 1]","['imagem', 'imagem', 'imagem']","[3, 3, 3]",3,3,6,1
7046,"['agravamento', 'autoridad', 'comparacao', 'contribuicao', 'crise', 'cronica', 'exgovernador', 'fluminens', 'habitant', 'letalidad', 'republico', 'restritivo', 'situacao', 'taxar', 'taxar']","[1, 1, 1, 1, 1, 1, 1, 1, 1, 1, 1, 1, 1, 2, 2]","[]","[]",15,0,15,1
7049,"['calendario', 'congresso', 'distrito', 'domingo', 'justicar', 'necessidad', 'regrar']","[1, 1, 1, 1, 1, 1, 1]","[]","[]",7,0,7,1
7051,"['aprovacao', 'aprovacao', 'definitivo', 'deslocamento', 'determinacao', 'implementar', 'iniciativo', 'ministrar', 'monitoramento', 'precedent', 'sabado', 'saudar']","[2, 2, 1, 1, 1, 1, 1, 1, 1, 1, 1, 1]","[]","[]",12,0,12,1
7054,"['decisao', 'dedicar', 'funcao', 'habitant', 'mudanca', 'necessario', 'portavoz', 'reforcar', 'respostar', 'respostar', 'sabado']","[1, 1, 1, 1, 1, 1, 1, 1, 2, 2, 1]","[]","[]",11,0,11,1
7057,"['arthur', 'decisao', 'funcao', 'lira', 'lira', 'ministrar', 'ppal', 'prescricao', 'saudar']","[1, 1, 1, 2, 2, 1, 1, 1, 1]","[]","[]",9,0,9,1
7058,"['armazenamento', 'armazenamento', 'boletim', 'conservacao', 'destacar', 'epidemiologico', 'instituto', 'instituto', 'instituto', 'instituto', 'instituto', 'instituto', 'investigacao', 'irregularidad', 'oficio', 'periodo', 'recebido', 'respiratorio', 'saudar', 'submetido']","[2, 2, 1, 1, 1, 1, 6, 6, 6, 6, 6, 6, 1, 1, 1, 1, 1, 1, 1, 1]","[]","[]",20,0,20,1
7059,"['anvisa', 'anvisa', 'aplicacao', 'autoridad', 'epidemiologico', 'exigencia', 'negativar', 'oficio', 'passageiro', 'passageiro', 'proposto', 'quarentenar', 'saudar', 'transmissao', 'viajant', 'vigilancia', 'vigilancia']","[2, 2, 1, 1, 1, 1, 1, 1, 2, 2, 1, 1, 1, 1, 1, 2, 2]","['enderecar']","[1]",17,1,18,1
7060,"['arrecadar', 'biliao', 'capitar', 'congresso', 'constituicao', 'destinar', 'equilibrio', 'habitant', 'previsto', 'provisorio', 'quedo', 'quedo', 'recurso', 'regrar']","[1, 1, 1, 1, 1, 1, 1, 1, 1, 1, 2, 2, 1, 1]","[]","[]",14,0,14,1
7061,"['anteontem', 'celso', 'transmissao']","[1, 1, 1]","[]","[]",3,0,3,1
7062,"['absoluto', 'absoluto', 'anuncio', 'anuncio', 'anuncio']","[2, 2, 3, 3, 3]","['mafia']","[1]",5,1,6,1
7066,"['aliquota', 'contribuicao', 'decorrent', 'emergenciai', 'mudanca', 'possibilidad', 'prazo', 'prazo', 'prever', 'proposto', 'proposto', 'sancao', 'tributario']","[1, 1, 1, 1, 1, 1, 2, 2, 1, 2, 2, 1, 1]","[]","[]",13,0,13,1
7072,"['demandar', 'dificuldad', 'importacao', 'instituto', 'ministrar', 'ministrar', 'parceria', 'saudar', 'saudar', 'sputnik']","[1, 1, 1, 1, 2, 2, 1, 2, 2, 1]","[]","[]",10,0,10,1
7073,"['californio', 'californio', 'enquadrar', 'positivar', 'regiao', 'saudar', 'saudar', 'saudar', 'suspeito']","[2, 2, 1, 1, 1, 3, 3, 3, 1]","[]","[]",9,0,9,1
7074,"['bruto', 'economia', 'infectar', 'internar', 'monetario', 'pib', 'turista']","[1, 1, 1, 1, 1, 1, 1]","[]","[]",7,0,7,1
7075,"['alteracao', 'autoridad', 'independentement', 'instituto', 'julgamento', 'lewandowski', 'mantido', 'ministrar', 'ministrar', 'ministrar', 'previsao', 'queixar', 'realizacao', 'regrar', 'ricardo', 'saudar', 'supremo']","[1, 1, 1, 1, 1, 1, 1, 3, 3, 3, 1, 1, 1, 1, 1, 1, 1]","['abortar', 'estuprar']","[1, 1]",17,2,19,1
7076,"['alerj', 'chefiar', 'comissao', 'folhar', 'parceria', 'rocha', 'rocha', 'sabatino', 'sabatino', 'saudar', 'spaulo', 'tatto', 'tatto']","[1, 1, 1, 1, 1, 2, 2, 2, 2, 1, 1, 2, 2]","[]","[]",13,0,13,1
7077,"['anuncio', 'diagnosticar', 'europeu', 'pastar', 'saudar', 'surtir', 'viagem', 'voo']","[1, 1, 1, 1, 1, 1, 1, 1]","[]","[]",8,0,8,1
7078,"['inglaterra', 'prever']","[1, 1]","[]","[]",2,0,2,1
7079,"['anvisa', 'autorizacao', 'imunizacao', 'iniciativo', 'iniciativo', 'operacionalizacao', 'planar', 'plenario', 'previsto', 'prioritario', 'privar', 'privar', 'sancao', 'saudar', 'temporario', 'vigilancia']","[1, 1, 1, 2, 2, 1, 1, 1, 1, 1, 2, 2, 1, 1, 1, 1]","[]","[]",16,0,16,1
7080,"['bbc', 'condicao', 'desempenhar', 'equivalent', 'saudar', 'saudar', 'saudar']","[1, 1, 1, 1, 3, 3, 3]","['ganhar', 'renunciar']","[1, 1]",7,2,9,1
7083,"['recurso', 'republico']","[1, 1]","[]","[]",2,0,2,1
7084,"['depoimento', 'exministro', 'instituto', 'instituto', 'republico', 'saudar']","[1, 1, 2, 2, 1, 1]","[]","[]",6,0,6,1
7086,"['desenvolvido', 'desenvolvimento', 'escalar', 'estagio', 'fabricacao', 'fase', 'moderno', 'parceria']","[1, 1, 1, 1, 1, 1, 1, 1]","[]","[]",8,0,8,1
7087,"['autoridad', 'plano', 'situacao', 'situacao']","[1, 1, 2, 2]","[]","[]",4,0,4,1
7088,"['apurar', 'barroso', 'bastidor', 'comissao', 'comissao', 'comissao', 'demmg', 'determinacao', 'inquerito', 'ministrar', 'pacheco', 'pacheco', 'pacheco', 'planalto', 'suspenso']","[1, 1, 1, 3, 3, 3, 1, 1, 1, 1, 3, 3, 3, 1, 1]","[]","[]",15,0,15,1
7092,"['epidemiar', 'funcionamento', 'minimizar', 'propagacao', 'reabrir', 'transmissao']","[1, 1, 1, 1, 1, 1]","[]","[]",6,0,6,1
7097,"['delacao', 'investigacao', 'investigacao', 'investigacao', 'justicar', 'pagamento', 'recurso']","[1, 3, 3, 3, 1, 1, 1]","['supostament']","[1]",7,1,8,1
7100,"['desenvolvimento', 'distrito', 'emergenciai', 'espirito', 'espirito', 'espirito', 'infraestrutura', 'instituto', 'intenso', 'justicar', 'reuniao', 'reuniao', 'risco', 'sabado', 'saudar', 'situacao', 'situacao']","[1, 1, 1, 3, 3, 3, 1, 1, 1, 1, 2, 2, 1, 1, 1, 2, 2]","[]","[]",17,0,17,1
7101,"['administrativo', 'administrativo', 'congresso', 'congresso', 'congresso', 'congresso', 'decisao', 'decisao', 'demrj', 'legislativo', 'proposto']","[2, 2, 4, 4, 4, 4, 2, 2, 1, 1, 1]","[]","[]",11,0,11,1
7102,"['bancada', 'bandeirant', 'henri', 'palacio', 'pereira', 'prorrogacao', 'quarentenar', 'quarentenar', 'rotina', 'tornear']","[1, 1, 1, 1, 1, 1, 2, 2, 1, 1]","['imagem']","[1]",10,1,11,1
7103,"['anvisa', 'anvisa', 'aplicacao', 'aprovacao', 'aprovacao', 'aprovacao', 'argumentar', 'desenvolvido', 'globonew', 'instituto', 'mexico', 'reuniao', 'sputnik', 'trimestr', 'vigilancia']","[2, 2, 1, 3, 3, 3, 1, 1, 1, 1, 1, 1, 1, 1, 1]","[]","[]",15,0,15,1
7104,"['levantamento', 'privar', 'saudar']","[1, 1, 1]","['misericordia']","[1]",3,1,4,1
7105,"['avancar', 'colegio', 'colegio', 'comorbidad', 'comorbidad', 'destacar', 'gripezinha', 'presenciar', 'reafirmar', 'resistencia']","[1, 2, 2, 2, 2, 1, 1, 1, 1, 1]","['pego']","[1]",10,1,11,1
7107,"['parcelar', 'provisorio']","[1, 1]","[]","[]",2,0,2,1
7108,"['economia', 'florido', 'florido', 'quarentenar', 'quarentenar', 'regiao', 'saudar']","[1, 2, 2, 2, 2, 1, 1]","['ganhar']","[1]",7,1,8,1
7112,"['adversario', 'adversario', 'adversario', 'bolsonarista', 'celso', 'desafiar', 'necessidad', 'respectivament', 'sabatino', 'tucano', 'tucano']","[3, 3, 3, 1, 1, 1, 1, 1, 1, 2, 2]","[]","[]",11,0,11,1
7120,"['diagnosticar']","[1]","[]","[]",1,0,1,1
7121,"['associacao', 'impacto', 'inclusao', 'previsao', 'quedo', 'ritmar', 'trimestr', 'velocidad']","[1, 1, 1, 1, 1, 1, 1, 1]","[]","[]",8,0,8,1
7123,"['anuncio', 'decisao', 'instalacao', 'primeiroministro', 'sabado', 'taxar']","[1, 1, 1, 1, 1, 1]","[]","[]",6,0,6,1
7124,"['bruno', 'deteccao', 'distrito', 'medida', 'precaucao', 'precaucao', 'profissionai', 'proximo', 'resultado', 'reuniao', 'reuniao', 'sendo', 'tambem', 'treino']","[1, 1, 1, 1, 2, 2, 1, 1, 1, 2, 2, 1, 1, 1]","[]","[]",14,0,14,1
7125,"['compromisso', 'florido', 'palacio', 'planalto', 'preservar', 'quarentenar', 'saudar', 'wajngarten']","[1, 1, 1, 1, 1, 1, 1, 1]","[]","[]",8,0,8,1
7127,"['cepa', 'coreia', 'fronteiro', 'journal', 'sequenciamento', 'surtir']","[1, 1, 1, 1, 1, 1]","[]","[]",6,0,6,1
7129,"['anuncio', 'congresso', 'decisao', 'examinar', 'justicar', 'precedent', 'respostar', 'saudar', 'sessao', 'supremo']","[1, 1, 1, 1, 1, 1, 1, 1, 1, 1]","[]","[]",10,0,10,1
7130,"[]","[]","['imagem']","[1]",0,1,1,1
7131,"['amplo', 'anticorpo', 'infectar', 'moderno', 'necessario', 'respostar', 'treinar']","[1, 1, 1, 1, 1, 1, 1]","[]","[]",7,0,7,1
7133,"[]","[]","[]","[]",0,0,0,1
7135,"['anticorpo', 'anuncio', 'anuncio', 'fase', 'moderno', 'preliminar', 'preliminar', 'sputnik']","[1, 2, 2, 1, 1, 2, 2, 1]","[]","[]",8,0,8,1
7136,"['atrasar', 'client', 'consumidor', 'crise', 'crise', 'dificultar', 'emprestimo', 'emprestimo', 'indicador', 'indicador', 'indicador', 'indicador', 'indicador', 'modelo', 'pagamento', 'positivar', 'prever']","[1, 1, 1, 2, 2, 1, 2, 2, 5, 5, 5, 5, 5, 1, 1, 1, 1]","[]","[]",17,0,17,1
7137,"['atendido', 'calendario', 'calendario', 'dosar', 'expectativa', 'psicologo', 'sabado', 'saudar', 'saudar', 'saudar']","[1, 2, 2, 1, 1, 1, 1, 3, 3, 3]","[]","[]",10,0,10,1
7138,"['aplicacao', 'entregu', 'entregu', 'fundacao', 'fundacao', 'imunizacao', 'instituto', 'instituto', 'oswaldo', 'superar']","[1, 2, 2, 2, 2, 1, 2, 2, 1, 1]","[]","[]",10,0,10,1
7142,"['ministrar', 'ribeiro']","[1, 1]","[]","[]",2,0,2,1
7144,"['converso', 'converso']","[2, 2]","[]","[]",2,0,2,1
7147,"['antecipar', 'distrito', 'estrategia', 'federar', 'intenso', 'margem', 'painel', 'painel', 'publicitario', 'quilometro', 'supremo']","[1, 1, 1, 1, 1, 1, 2, 2, 1, 1, 1]","[]","[]",11,0,11,1
7150,"['afetado', 'avancar', 'avancar', 'biliao', 'biliao', 'biliao', 'crise', 'primario', 'projecao', 'recordar', 'reuter', 'reuter', 'significativo', 'tesourar', 'tesourar']","[1, 2, 2, 3, 3, 3, 1, 1, 1, 1, 2, 2, 1, 2, 2]","[]","[]",15,0,15,1
7151,"['recurso']","[1]","['chorar']","[1]",1,1,2,1
7153,"['aspecto', 'autoridad', 'competicao', 'condicao', 'curvo', 'discussao', 'infectar', 'iniciativo', 'necessario', 'parcelar', 'respostar', 'saudar', 'treino']","[1, 1, 1, 1, 1, 1, 1, 1, 1, 1, 1, 1, 1]","[]","[]",13,0,13,1
7155,"['ambientar', 'determinacao', 'inicialment', 'intervalar', 'turistico', 'wilson', 'witzel']","[1, 1, 1, 1, 1, 1, 1]","[]","[]",7,0,7,1
7156,"['circulacao', 'relaxamento']","[1, 1]","['bandeiro', 'protestar']","[1, 1]",2,2,4,1
7157,"['anvisa', 'normalment', 'pastar', 'pastar', 'pastar', 'respectivament', 'saudar', 'saudar', 'vigilancia']","[1, 1, 3, 3, 3, 1, 2, 2, 1]","[]","[]",9,0,9,1
7158,"['compilar', 'decorrencia', 'intervalar', 'levantamento', 'oficialment', 'periodo', 'recebido', 'saudar', 'subir', 'taxar']","[1, 1, 1, 1, 1, 1, 1, 1, 1, 1]","[]","[]",10,0,10,1
7161,"['celebrar', 'fronteiro', 'necessidad', 'quarentenar', 'viagem', 'voo', 'wellington']","[1, 1, 1, 1, 1, 1, 1]","[]","[]",7,0,7,1
7162,"['comparacao', 'concedido', 'crise', 'periodo', 'periodo', 'volumar']","[1, 1, 1, 2, 2, 1]","[]","[]",6,0,6,1
7165,"['boletim', 'contabilizar', 'dengu', 'dengu', 'epidemiologico', 'especifico', 'infeccioso', 'regiao', 'saudar', 'saudar', 'suspeito']","[1, 1, 2, 2, 1, 1, 1, 1, 2, 2, 1]","[]","[]",11,0,11,1
7168,"['enfatizar']","[1]","['fraudar', 'fraudar', 'protestar']","[2, 2, 1]",1,3,4,1
7174,"['carla']","[1]","[]","[]",1,0,1,1
7175,"['client', 'client', 'dificultar', 'instituto', 'integrant', 'posturar', 'suspeito']","[2, 2, 1, 1, 1, 1, 1]","[]","[]",7,0,7,1
7176,"['araujo', 'henriqu', 'ministrar', 'quarentenar', 'saudar', 'surtir']","[1, 1, 1, 1, 1, 1]","['supostament', 'usuario']","[1, 1]",6,2,8,1
7177,"['adulto', 'comissao', 'compromisso', 'compromisso', 'conjunto', 'consumidor', 'enfrentamento', 'esperancar', 'esperancar', 'intubacao', 'ministrar', 'pastar', 'pastar', 'queiroga', 'queiroga', 'reforcar', 'saudar', 'sessao', 'sessao', 'situacao']","[1, 1, 2, 2, 1, 1, 1, 2, 2, 1, 1, 2, 2, 2, 2, 1, 1, 2, 2, 1]","[]","[]",20,0,20,1
7178,"['decisao', 'domingo', 'expressivo', 'recurso', 'reforcar', 'regrar', 'tucano']","[1, 1, 1, 1, 1, 1, 1]","['cristao', 'legendar']","[1, 1]",7,2,9,1
7179,"['associacao', 'associacao', 'condicao', 'iniciativo', 'julgamento', 'plenario', 'prever', 'supremo']","[2, 2, 1, 1, 1, 1, 1, 1]","['escravo', 'escravo']","[2, 2]",8,2,10,1
7183,"['anvisa', 'anvisa', 'anvisa', 'autonomia', 'celebrar', 'instituto', 'paralisar', 'respostar', 'suspensao', 'vigilancia']","[3, 3, 3, 1, 1, 1, 1, 1, 1, 1]","['dorio', 'ganhar', 'ganhar', 'inocentar']","[1, 2, 2, 1]",10,4,14,1
7188,"['mexico', 'notificar', 'panamericana', 'regiao', 'regiao', 'saudar', 'saudar']","[1, 1, 1, 2, 2, 2, 2]","[]","[]",7,0,7,1
7192,"['autonomia', 'autoridad', 'autoridad', 'calamidad', 'calamidad', 'calamidad', 'calendario', 'calendario', 'calendario', 'carat', 'estimular', 'extensao', 'heleno', 'heleno', 'impacto', 'ministrar', 'necessidad', 'observar', 'orientacao', 'palacio', 'periodo', 'periodo', 'periodo', 'planalto', 'possibilidad', 'pratico', 'presenca', 'presenciar', 'presenciar', 'presenciar', 'prever', 'privar', 'reabertura', 'regrar', 'regulamentar', 'regulamentar', 'resolucao', 'resolucao', 'resolucao', 'resolucao', 'resolucao', 'ribeiro']","[1, 2, 2, 3, 3, 3, 3, 3, 3, 1, 1, 1, 2, 2, 1, 1, 1, 1, 1, 1, 3, 3, 3, 1, 1, 1, 1, 3, 3, 3, 1, 1, 1, 1, 2, 2, 5, 5, 5, 5, 5, 1]","[]","[]",42,0,42,1
7193,"['epidemiar', 'organizador', 'prever', 'prever', 'ricard', 'temporada', 'temporada']","[1, 1, 2, 2, 1, 2, 2]","[]","[]",7,0,7,1
7194,"['condicao', 'temporariament']","[1, 1]","[]","[]",2,0,2,1
7196,"['henriqu', 'ministrar', 'saudar']","[1, 1, 1]","[]","[]",3,0,3,1
7199,"['anteontem', 'decisao', 'iniciativo', 'pratico']","[1, 1, 1, 1]","[]","[]",4,0,4,1
7202,"['intensivo', 'recordar', 'recuar', 'recuar', 'reducao', 'sabado', 'vespera']","[1, 1, 2, 2, 1, 1, 1]","[]","[]",7,0,7,1
7204,"['aglomeracao', 'compromisso', 'comunitario', 'exprefeito', 'fluminens', 'necessidad', 'prioridad', 'turistico']","[1, 1, 1, 1, 1, 1, 1, 1]","[]","[]",8,0,8,1
7206,"['arthur', 'client', 'necessario', 'privar', 'regrar', 'saudar', 'vigilancia']","[1, 1, 1, 1, 1, 1, 1]","[]","[]",7,0,7,1
7209,"['demandar', 'expectativa', 'instituto', 'ministrar', 'ministrar', 'ministrar', 'ministrar', 'ministrar', 'necessario', 'pastar', 'queiroga', 'saudar', 'saudar']","[1, 1, 1, 5, 5, 5, 5, 5, 1, 1, 1, 2, 2]","[]","[]",13,0,13,1
7210,"['bolsonarista', 'converso', 'diagnosticar', 'infectar']","[1, 1, 1, 1]","[]","[]",4,0,4,1
7211,"['associacao', 'calendario', 'plano', 'precedent', 'previsto', 'sindicato', 'temporada', 'temporada', 'temporada', 'temporada']","[1, 1, 1, 1, 1, 1, 4, 4, 4, 4]","[]","[]",10,0,10,1
7212,"['disseminacao', 'implementar', 'jantar', 'medida', 'relaxamento']","[1, 1, 1, 1, 1]","[]","[]",5,0,5,1
7213,"['autoridad', 'autoridad', 'autoridad', 'decisao', 'infectar', 'positivar', 'preventivo', 'regiao', 'risco']","[3, 3, 3, 1, 1, 1, 1, 1, 1]","[]","[]",9,0,9,1
7214,"['normalment', 'vulnerabilidad']","[1, 1]","[]","[]",2,0,2,1
7215,"['justicar', 'justicar', 'pagamento', 'prazo', 'presenciar', 'situacao', 'suspenso']","[2, 2, 1, 1, 1, 1, 1]","[]","[]",7,0,7,1
7217,"['ambientar', 'disseminacao', 'fronteiro', 'possibilidad', 'possibilidad', 'primeiroministro', 'regrar']","[1, 1, 1, 2, 2, 1, 1]","[]","[]",7,0,7,1
7218,"['bancada', 'consenso', 'discussao', 'entendimento', 'proposto', 'resistencia', 'sessao']","[1, 1, 1, 1, 1, 1, 1]","[]","[]",7,0,7,1
7222,"[]","[]","['compartilhar']","[1]",0,1,1,1
7225,"['concedido', 'concorrent', 'consultoria', 'domingo', 'levantamento', 'liderar', 'montant', 'publicitario']","[1, 1, 1, 1, 1, 1, 1, 1]","[]","[]",8,0,8,1
7227,"['autoridad', 'desenvolvido', 'instituto', 'ministrar', 'sabado', 'saudar']","[1, 1, 1, 1, 1, 1]","[]","[]",6,0,6,1
7229,"['associacao', 'folhar', 'logistico', 'ministrar', 'ministrar', 'painel', 'pastar', 'planar', 'planar', 'planar', 'respostar', 'reuniao', 'saudar', 'saudar', 'saudar', 'saudar']","[1, 1, 1, 2, 2, 1, 1, 3, 3, 3, 1, 1, 4, 4, 4, 4]","[]","[]",16,0,16,1
7230,"['alvorar', 'palacio', 'pslsp', 'republico', 'testagem', 'wajngarten']","[1, 1, 1, 1, 1, 1]","[]","[]",6,0,6,1
7232,"['comissao', 'folhar', 'marilia', 'parceria', 'sabatino', 'spaulo']","[1, 1, 1, 1, 1, 1]","[]","[]",6,0,6,1
7234,"['decisao', 'entendimento', 'inedito', 'julgamento', 'sentenca', 'unanimidad']","[1, 1, 1, 1, 1, 1]","[]","[]",6,0,6,1
7235,"['autoridad', 'autoridad', 'epidemiologico', 'infectar', 'infectar', 'notificar', 'saudar', 'saudar', 'saudar', 'vigilancia']","[2, 2, 1, 2, 2, 1, 3, 3, 3, 1]","[]","[]",10,0,10,1
7238,"['dengu', 'epicentro', 'epidemiar', 'fronteiro', 'henriqu', 'instalacao', 'ministrar', 'ministrar', 'necessario', 'pastar', 'pastar', 'plano', 'prazo', 'reuniao', 'roraima', 'sarampo', 'saudar', 'saudar', 'saudar', 'treinar', 'vigilancia', 'vigilancia', 'vigilancia']","[1, 1, 1, 1, 1, 1, 2, 2, 1, 2, 2, 1, 1, 1, 1, 1, 3, 3, 3, 1, 3, 3, 3]","['venezuelano', 'venezuelano']","[2, 2]",23,2,25,1
7241,"['dificuldad', 'infeccioso', 'privar', 'relaxar', 'saudar', 'saudar', 'saudar', 'saudar', 'surto']","[1, 1, 1, 1, 4, 4, 4, 4, 1]","['parir']","[1]",9,1,10,1
7242,"['folhar', 'parceria', 'sabatino', 'situacao', 'spaulo']","[1, 1, 1, 1, 1]","[]","[]",5,0,5,1
7243,"['consolidar', 'estrategia', 'exercicio', 'exercicio', 'infeccioso', 'inglaterra', 'piorar', 'pratico', 'pratico']","[1, 1, 2, 2, 1, 1, 1, 2, 2]","['invadir', 'suco', 'vitaminar']","[1, 1, 1]",9,3,12,1
7246,"['afetado', 'disseminacao', 'enxergar', 'espanha', 'esquema', 'instalacao', 'processo', 'quarentenar', 'reabrir', 'regiao', 'respostar', 'turista', 'visitant']","[1, 1, 1, 1, 1, 1, 1, 1, 1, 1, 1, 1, 1]","[]","[]",13,0,13,1
7247,"['adotada', 'associacao', 'associacao', 'capitar', 'capitar', 'circulacao', 'crescimento', 'crescimento', 'diminuicao', 'discussao', 'domicilio', 'intenso', 'metropolitano', 'mudanca', 'mudanca', 'normalment', 'normalment', 'observar', 'regiao', 'sobretudo', 'suspensao', 'sustentabilidad', 'sustentabilidad', 'tendencia', 'transferir', 'volumar']","[1, 2, 2, 2, 2, 1, 2, 2, 1, 1, 1, 1, 1, 2, 2, 2, 2, 1, 1, 1, 1, 2, 2, 1, 1, 1]","['lixar', 'lixar', 'lixar']","[3, 3, 3]",26,3,29,1
7248,"['agravamento', 'concreto', 'crise', 'crise', 'destacar', 'economia', 'economia', 'economia', 'economia', 'impactar', 'impacto', 'propagacao']","[1, 1, 2, 2, 1, 4, 4, 4, 4, 1, 1, 1]","[]","[]",12,0,12,1
7249,"['aurelio', 'aurelio', 'aurelio', 'barroso', 'fez', 'gabinet', 'interferencia', 'julgamento', 'magistrado', 'mello', 'mello', 'mello', 'proprio', 'sessao', 'sido', 'supremo', 'videoconferencia']","[3, 3, 3, 1, 1, 1, 1, 1, 1, 3, 3, 3, 1, 1, 1, 1, 1]","[]","[]",17,0,17,1
7250,"['aglomeracao', 'dosar', 'etapa', 'etapa', 'expectativa', 'imunizacao', 'imunizacao', 'integrant', 'privar', 'publicoalvo', 'saudar']","[1, 1, 2, 2, 1, 2, 2, 1, 1, 1, 1]","[]","[]",11,0,11,1
7253,"[]","[]","[]","[]",0,0,0,1
7254,"['consorcio', 'coreia', 'liderar', 'mexico', 'recordar', 'republico', 'saudar']","[1, 1, 1, 1, 1, 1, 1]","[]","[]",7,0,7,1
7255,"['absoluto', 'aglomeracao', 'autoridad', 'avancar', 'demmg', 'pacheco', 'pacheco']","[1, 1, 1, 1, 1, 2, 2]","[]","[]",7,0,7,1
7259,"['avancar', 'destacar', 'economia', 'economia', 'indicador', 'pib', 'prever', 'previsao', 'recuperacao', 'semestr', 'subir']","[1, 1, 2, 2, 1, 1, 1, 1, 1, 1, 1]","[]","[]",11,0,11,1
7260,"['biliao', 'condicao', 'crise', 'crise', 'expressar', 'levantamento', 'pratico', 'quedo', 'quedo', 'quedo']","[1, 1, 2, 2, 1, 1, 1, 3, 3, 3]","[]","[]",10,0,10,1
7262,"['adhanom', 'indicador', 'preocupacao', 'preocupacao', 'quedo', 'regiao', 'sabado', 'saudar', 'tedro']","[1, 1, 2, 2, 1, 1, 1, 1, 1]","[]","[]",9,0,9,1
7263,"['constatar', 'jornada', 'periodo']","[1, 1, 1]","[]","[]",3,0,3,1
7269,"['confederacao', 'confederacao', 'imunizacao', 'imunizacao', 'planar', 'reuniao', 'saudar', 'saudar', 'saudar']","[2, 2, 2, 2, 1, 1, 3, 3, 3]","[]","[]",9,0,9,1
7270,"['anticorpo', 'anticorpo', 'autoridad', 'presenca', 'quatro', 'relacao']","[2, 2, 1, 1, 1, 1]","[]","[]",6,0,6,1
7273,"['kassio', 'orientacao', 'recebido', 'regiao', 'supremo']","[1, 1, 1, 1, 1]","['inscricao']","[1]",5,1,6,1
7280,"['constituicao', 'despesa', 'emendar', 'iniciativo', 'integro', 'possibilidad', 'proposto', 'proposto', 'prorrogar', 'reuniao', 'vieira']","[1, 1, 1, 1, 1, 1, 2, 2, 1, 1, 1]","[]","[]",11,0,11,1
7282,"['intensivo', 'intensivo', 'internar', 'obesidad', 'saudar', 'saudar', 'saudar', 'saudar', 'vulneravel', 'vulneravel']","[2, 2, 1, 1, 4, 4, 4, 4, 2, 2]","['auditoria']","[1]",10,1,11,1
7283,"['anuncio', 'inglaterra', 'necessidad', 'particularment', 'previsto', 'transmissao']","[1, 1, 1, 1, 1, 1]","[]","[]",6,0,6,1
7287,"['anticorpo', 'anticorpo', 'internar', 'recuperacao', 'respirador']","[2, 2, 1, 1, 1]","['ganhar']","[1]",5,1,6,1
7290,"['aplicacao', 'balancar', 'desenvolvido', 'enfrentamento', 'implementacao', 'imunizacao', 'ministrar', 'ministrar', 'ministrar', 'parceria', 'planar', 'planar', 'possibilidad', 'rejeitar', 'saudar']","[1, 1, 1, 1, 1, 1, 3, 3, 3, 1, 2, 2, 1, 1, 1]","[]","[]",15,0,15,1
7292,"['descumprir', 'esquema', 'feriar', 'movimentacao', 'permanencia']","[1, 1, 1, 1, 1]","[]","[]",5,0,5,1
7293,"['domingo', 'investigacao', 'supremo']","[1, 1, 1]","['parabem']","[1]",3,1,4,1
7295,"['economia', 'indicador']","[1, 1]","[]","[]",2,0,2,1
7299,"['alvorar', 'contencao', 'integro', 'mudanca', 'palacio', 'posturar', 'reuniao', 'reuniao', 'significativo', 'situacao']","[1, 1, 1, 1, 1, 1, 2, 2, 1, 1]","[]","[]",10,0,10,1
7300,"['aurelio', 'decisao', 'edson', 'fachin', 'fachin', 'fluminens', 'justificativo', 'lewandowski', 'manutencao', 'periferia', 'plenario', 'plenario', 'prazo', 'previsao', 'provisorio', 'ricardo', 'supremo']","[1, 1, 1, 2, 2, 1, 1, 1, 1, 1, 2, 2, 1, 1, 1, 1, 1]","[]","[]",17,0,17,1
7301,"['afetado', 'airlin', 'airlin', 'airlin', 'anuncio', 'aprovacao', 'companhia', 'companhia', 'companhia', 'domingo', 'especialment', 'estrategia', 'habitant', 'kong', 'lancamento', 'oficialment', 'parceiro', 'passageiro', 'taxar', 'turista', 'turistico', 'viagem', 'viagem']","[1, 3, 3, 3, 1, 1, 3, 3, 3, 1, 1, 1, 1, 1, 1, 1, 1, 1, 1, 1, 1, 2, 2]","['amplament']","[1]",23,1,24,1
7303,"['contabilizar', 'instituto', 'subir']","[1, 1, 1]","[]","[]",3,0,3,1
7304,"['acordo', 'araujo', 'conjuntar', 'contrato', 'ernesto', 'intenso', 'itamarati', 'recuperacao', 'reforcar']","[1, 1, 1, 1, 1, 1, 1, 1, 1]","[]","[]",9,0,9,1
7305,"['advocaciager', 'advocaciager', 'advocaciager', 'alteracao', 'alvaro', 'alvaro', 'alvaro', 'antonio', 'antonio', 'antonio', 'araujo', 'araujo', 'araujo', 'araujo', 'araujo', 'atuacao', 'aurelio', 'azevedo', 'azevedo', 'balancar', 'calculo', 'calculo', 'cardiologista', 'chefiar', 'chefiar', 'congresso', 'congresso', 'desenvolvimento', 'desenvolvimento', 'desgastar', 'discussao', 'distrito', 'divergencia', 'divergencia', 'equivalent', 'equivalent', 'ernesto', 'ernesto', 'ernesto', 'esquema', 'exgovernador', 'exjuiz', 'exonerar', 'exonerar', 'exonerar', 'flavia', 'henriqu', 'inconsistencia', 'integrant', 'itamarati', 'jorg', 'justicar', 'justicar', 'justicar', 'liderar', 'lira', 'lira', 'lorenzoni', 'machadar', 'marinhar', 'mello', 'mello', 'mendonca', 'mendonca', 'mendonca', 'mendonca', 'mendonca', 'mendonca', 'ministrar', 'ministrar', 'ministrar', 'ministrar', 'ministrar', 'ministrar', 'mudanca', 'mudanca', 'mudanca', 'mudanca', 'mudanca', 'nelson', 'oliveira', 'onyx', 'onyx', 'onyx', 'pacheco', 'pastar', 'pastar', 'pastar', 'pastar', 'pastar', 'pastar', 'pastar', 'pastar', 'pastar', 'pastar', 'pastar', 'pastar', 'pastar', 'periodo', 'periodo', 'planalto', 'planalto', 'queiroga', 'reuniao', 'reuniao', 'ribeiro', 'ricardo', 'rotina', 'saudar', 'saudar', 'saudar', 'secretariager', 'secretariager', 'secretariager', 'secretariager', 'subir', 'subordinar', 'substituicao', 'substituicao', 'substituto', 'substituto', 'substituto', 'substituto', 'supremo', 'supremo', 'tcu', 'teich', 'teich', 'viagem']","[3, 3, 3, 1, 3, 3, 3, 3, 3, 3, 5, 5, 5, 5, 5, 1, 1, 2, 2, 1, 2, 2, 1, 2, 2, 2, 2, 2, 2, 1, 1, 1, 2, 2, 2, 2, 3, 3, 3, 1, 1, 1, 3, 3, 3, 1, 1, 1, 1, 1, 1, 3, 3, 3, 1, 2, 2, 1, 1, 1, 2, 2, 6, 6, 6, 6, 6, 6, 6, 6, 6, 6, 6, 6, 5, 5, 5, 5, 5, 1, 1, 3, 3, 3, 1, 13, 13, 13, 13, 13, 13, 13, 13, 13, 13, 13, 13, 13, 2, 2, 2, 2, 1, 2, 2, 1, 1, 1, 3, 3, 3, 4, 4, 4, 4, 1, 1, 2, 2, 4, 4, 4, 4, 2, 2, 1, 2, 2, 1]","['amigar']","[1]",129,1,130,1
7306,"['ambientar', 'claudio', 'economia', 'exercicio', 'impactar', 'importancia', 'prioridad', 'reforcar']","[1, 1, 1, 1, 1, 1, 1, 1]","[]","[]",8,0,8,1
7309,"['journal', 'preventivo', 'saudar']","[1, 1, 1]","[]","[]",3,0,3,1
7312,"['bancada', 'condenacao', 'congresso', 'congresso', 'especialment', 'integro', 'palacio', 'planalto', 'rocha']","[1, 1, 2, 2, 1, 1, 1, 1, 1]","[]","[]",9,0,9,1
7313,"['crise', 'tendencia']","[1, 1]","['clicar']","[1]",2,1,3,1
7315,"['apurar', 'assistencia', 'complicacao', 'decorrencia', 'destacar', 'fluminens', 'internar', 'suspeito', 'varga']","[1, 1, 1, 1, 1, 1, 1, 1, 1]","[]","[]",9,0,9,1
7318,"['domingo', 'domingo', 'plano', 'prazo', 'reabertura', 'situacao', 'situacao', 'suspenso', 'trafego']","[2, 2, 1, 1, 1, 2, 2, 1, 1]","[]","[]",9,0,9,1
7321,"['circulacao', 'comissao', 'contagioso', 'deslocamento', 'europeu', 'europeu', 'fronteiro', 'inglaterra', 'mutacao', 'saudar', 'viagem', 'viagem']","[1, 1, 1, 1, 2, 2, 1, 1, 1, 1, 2, 2]","[]","[]",12,0,12,1
7322,"['administrativo', 'administrativo', 'adversario', 'congresso', 'decisao', 'estabilidad', 'federar', 'funcionamento', 'lira', 'prioridad', 'rossi', 'servidor', 'servidor', 'temporario', 'tramitar', 'tributario', 'tributario']","[2, 2, 1, 1, 1, 1, 1, 1, 1, 1, 1, 2, 2, 1, 1, 2, 2]","[]","[]",17,0,17,1
7324,"['armazenamento', 'destinar', 'equipamento', 'etapa', 'parcelar', 'pastar', 'preparacao', 'prescricao', 'primario', 'recurso', 'recurso', 'saudar', 'saudar', 'saudar', 'saudar', 'saudar', 'saudar']","[1, 1, 1, 1, 1, 1, 1, 1, 1, 2, 2, 6, 6, 6, 6, 6, 6]","['selecionar']","[1]",17,1,18,1
7325,"['algun', 'confirmado', 'contencao', 'decorrent', 'flexibilizacao', 'sabado', 'sido', 'sociai', 'ultimo']","[1, 1, 1, 1, 1, 1, 1, 1, 1]","[]","[]",9,0,9,1
7326,"['enfermagem', 'enfermagem', 'importancia', 'lesao', 'orientacao', 'orientacao', 'possibilidad', 'sobretudo']","[2, 2, 1, 1, 2, 2, 1, 1]","[]","[]",8,0,8,1
7329,"['acordo', 'acordo', 'apurar', 'argumentar', 'autoridad', 'autoridad', 'autoridad', 'autoridad', 'cooperacao', 'cooperacao', 'coordenar', 'dialogo', 'forcatarefa', 'forcatarefa', 'forcatarefa', 'forcatarefa', 'forcatarefa', 'integrant', 'investigacao', 'investigacao', 'irregularidad', 'irregularidad', 'lewandowski', 'lewandowski', 'mantido', 'ministrar', 'ministrar', 'obtido', 'oficio', 'oficio', 'processo', 'realizacao', 'regrar', 'relativo', 'republico', 'republico', 'ricardo', 'supremo']","[2, 2, 1, 1, 4, 4, 4, 4, 2, 2, 1, 1, 5, 5, 5, 5, 5, 1, 2, 2, 2, 2, 2, 2, 1, 2, 2, 1, 2, 2, 1, 1, 1, 1, 2, 2, 1, 1]","[]","[]",38,0,38,1
7330,"['alvaro', 'alvaro', 'alvaro', 'antonio', 'antonio', 'antonio', 'araujo', 'articulacao', 'carla', 'colunista', 'congresso', 'exministro', 'inicialment', 'machadar', 'ministrar', 'ministrar', 'pastar']","[3, 3, 3, 3, 3, 3, 1, 1, 1, 1, 1, 1, 1, 1, 2, 2, 1]","[]","[]",17,0,17,1
7339,"['inglaterra', 'surtir', 'surtir']","[1, 2, 2]","[]","[]",3,0,3,1
7341,"['adotada', 'alcolumbr', 'alcolumbr', 'alcolumbr', 'alternativo', 'cenario', 'consecutivo', 'constituicao', 'converso', 'cupula', 'demap', 'demrj', 'emendar', 'estrategia', 'iniciativo', 'legislativo', 'legislativo', 'pratico', 'proposto', 'regiao', 'supremo', 'supremo']","[1, 3, 3, 3, 1, 1, 1, 1, 1, 1, 1, 1, 1, 1, 1, 2, 2, 1, 1, 1, 2, 2]","[]","[]",22,0,22,1
7345,"['intensivo', 'internar', 'positivar']","[1, 1, 1]","['imagem']","[1]",3,1,4,1
7346,"['ccj', 'comissao', 'comissao', 'constituicao', 'constituicao', 'emendar', 'justicar', 'proposto', 'proposto', 'proposto', 'rejeitar', 'requerimento', 'tramitacao']","[1, 2, 2, 2, 2, 1, 1, 3, 3, 3, 1, 1, 1]","[]","[]",13,0,13,1
7347,"['antonio', 'augusto', 'autoridad', 'autoridad', 'cerimonia', 'demrj', 'diagnosticar', 'fux', 'fux', 'infectar', 'justicar', 'ministrar', 'ministrar', 'negativar', 'negativar', 'positivar', 'republico', 'supremo', 'supremo']","[1, 1, 2, 2, 1, 1, 1, 2, 2, 1, 1, 2, 2, 2, 2, 1, 1, 2, 2]","[]","[]",19,0,19,1
7351,"['assintomatico', 'possibilidad', 'privilegiar', 'quarentenar']","[1, 1, 1, 1]","['sacar']","[1]",4,1,5,1
7352,"['apoio', 'bruno', 'oficialment', 'resistencia']","[1, 1, 1, 1]","['mencao']","[1]",4,1,5,1
7355,"['anteriorment', 'avancar', 'cepa', 'comorbidad', 'europeu', 'hospitalizacao', 'impactar', 'particularment']","[1, 1, 1, 1, 1, 1, 1, 1]","['circular', 'espalhar']","[1, 1]",8,2,10,1
7358,"['instituto', 'parceria']","[1, 1]","[]","[]",2,0,2,1
7360,"['adicionar', 'atuacao', 'biliao', 'biliao', 'biliao', 'biliao', 'biliao', 'bruto', 'comissao', 'despesa', 'destinar', 'efetividad', 'enfrentamento', 'internar', 'juro', 'pagamento', 'pib', 'pib', 'pib', 'pib', 'preocupacao', 'previsao', 'primario', 'primario', 'reducao', 'saudar', 'temporariament', 'vulneravel']","[1, 1, 5, 5, 5, 5, 5, 1, 1, 1, 1, 1, 1, 1, 1, 1, 4, 4, 4, 4, 1, 1, 2, 2, 1, 1, 1, 1]","[]","[]",28,0,28,1
7361,"['crise', 'domingo', 'folhar', 'integro', 'posturar', 'saudar']","[1, 1, 1, 1, 1, 1]","[]","[]",6,0,6,1
7364,"['congresso', 'crise', 'despesa', 'equilibrio', 'expectativa', 'fase', 'juro', 'juro', 'juro', 'juro', 'monetario', 'quedo', 'reducao', 'reducao', 'reuniao', 'reuniao', 'taxar', 'taxar', 'taxar', 'taxar', 'taxar']","[1, 1, 1, 1, 1, 1, 4, 4, 4, 4, 1, 1, 2, 2, 2, 2, 5, 5, 5, 5, 5]","[]","[]",21,0,21,1
7365,"['augusto', 'batalhar', 'batalhar', 'gabinet', 'heleno', 'heleno', 'ministrar', 'negativar', 'negativar', 'negativar', 'positivar']","[1, 2, 2, 1, 2, 2, 1, 3, 3, 3, 1]","[]","[]",11,0,11,1
7368,"['broadcast', 'demrj', 'dificuldad', 'eventualment', 'facilitar', 'henriqu', 'interpretar', 'plenario', 'reajustar', 'reajustar', 'ricardo', 'servidor', 'vetar', 'vetar', 'vetar']","[1, 1, 1, 1, 1, 1, 1, 1, 2, 2, 1, 1, 3, 3, 3]","[]","[]",15,0,15,1
7370,"['alteracao', 'calendario', 'competicao', 'complicacao', 'epidemiar', 'metropolitano', 'ministrar', 'pastar', 'positivar', 'primeiroministro', 'regiao', 'respiratorio', 'respiratorio', 'saudar', 'saudar', 'toquio']","[1, 1, 1, 1, 1, 1, 1, 1, 1, 1, 1, 2, 2, 2, 2, 1]","[]","[]",16,0,16,1
7372,"['help', 'parceria']","[1, 1]","['ganhar', 'gravacao']","[1, 1]",2,2,4,1
7373,"['crise', 'instituto', 'integro', 'republico']","[1, 1, 1, 1]","[]","[]",4,0,4,1
7375,"['antecipar', 'decisao', 'demandar', 'determinacao', 'feriar', 'feriar', 'infectar', 'justicar', 'necessidad', 'periodo', 'prazo', 'recurso', 'turista', 'varar', 'ventilatorio', 'vieira']","[1, 1, 1, 1, 2, 2, 1, 1, 1, 1, 1, 1, 1, 1, 1, 1]","[]","[]",16,0,16,1
7379,"['economia', 'lavagem', 'mudanca', 'planar', 'sancao', 'transferencia']","[1, 1, 1, 1, 1, 1]","[]","[]",6,0,6,1
7380,"['avancar', 'biliao', 'delacao', 'delacao', 'depoimento', 'entregu', 'marinhar', 'marinhar', 'marinhar', 'pratico', 'remessar']","[1, 1, 2, 2, 1, 1, 3, 3, 3, 1, 1]","[]","[]",11,0,11,1
7382,"['isolar', 'necessario']","[1, 1]","[]","[]",2,0,2,1
7384,"['colleg', 'colleg', 'crescimento', 'fase', 'integro', 'previsao', 'situacao', 'taxar', 'taxar', 'taxar', 'taxar', 'tendencia', 'transmissao', 'transmissao', 'transmissao', 'transmissao']","[2, 2, 1, 1, 1, 1, 1, 4, 4, 4, 4, 1, 4, 4, 4, 4]","[]","[]",16,0,16,1
7386,"['apurar', 'augusto', 'cometido', 'esquema', 'fase', 'henriqu', 'justicar', 'lavagem']","[1, 1, 1, 1, 1, 1, 1, 1]","[]","[]",8,0,8,1
7387,"['acumular', 'arthur', 'congresso', 'investigacao', 'justicar', 'lira', 'lira', 'republico', 'rocha', 'superar']","[1, 1, 1, 1, 1, 2, 2, 1, 1, 1]","[]","[]",10,0,10,1
7388,"['anvisa', 'anvisa', 'autorizacao', 'etapa', 'instituto', 'materiaprima', 'parceria', 'pedido', 'pedido', 'processo', 'resolucao', 'resultado', 'vigilancia']","[2, 2, 1, 1, 1, 1, 1, 2, 2, 1, 1, 1, 1]","[]","[]",13,0,13,1
7389,"['condicao', 'decisao', 'domingo', 'kassio', 'ministrar', 'palacio', 'planalto', 'possibilidad', 'prtb', 'realizacao', 'realizacao', 'supremo']","[1, 1, 1, 1, 1, 1, 1, 1, 1, 2, 2, 1]","[]","[]",12,0,12,1
7390,"['anticorpo', 'anvisa', 'anvisa', 'autorizacao', 'exigencia', 'integro', 'prazo', 'vigilancia']","[1, 2, 2, 1, 1, 1, 1, 1]","[]","[]",8,0,8,1
7391,"['calheiro', 'comissao', 'discussao', 'enfrentamento', 'inquerito', 'mdbal', 'prtb']","[1, 1, 1, 1, 1, 1, 1]","[]","[]",7,0,7,1
7392,"['afp', 'consumidor', 'consumidor', 'especifico', 'reuter']","[1, 2, 2, 1, 1]","['compartilhar', 'enganar', 'usuario', 'usuario']","[1, 1, 2, 2]",5,4,9,1
7393,"['comissao', 'decorrent', 'entendimento', 'mudanca', 'portavoz', 'reuter', 'reuter', 'serao', 'sido']","[1, 1, 1, 1, 1, 2, 2, 1, 1]","[]","[]",9,0,9,1
7394,"['absoluto', 'batalhar', 'henriqu', 'justificativo', 'ministrar', 'ministrar', 'ministrar', 'nelson', 'pastar', 'periodo', 'recordar', 'republico', 'saudar', 'saudar', 'teich', 'teich', 'teich', 'teich']","[1, 1, 1, 1, 3, 3, 3, 1, 1, 1, 1, 1, 2, 2, 4, 4, 4, 4]","[]","[]",18,0,18,1
7395,"['congresso', 'economia', 'gued', 'ministrar', 'parcelar', 'possibilidad']","[1, 1, 1, 1, 1, 1]","[]","[]",6,0,6,1
7396,"['equipamento', 'equipamento', 'isolar', 'necessario', 'saudar']","[2, 2, 1, 1, 1]","[]","[]",5,0,5,1
7397,"['articulacao', 'federar', 'flavio', 'fluminens', 'parceria', 'periodo', 'prioridad']","[1, 1, 1, 1, 1, 1, 1]","[]","[]",7,0,7,1
7401,"['afp', 'autoridad', 'comparacao', 'imunizacao', 'moderno', 'moderno', 'recurso', 'saudar']","[1, 1, 1, 1, 2, 2, 1, 1]","[]","[]",8,0,8,1
7403,"['arthur', 'comissao', 'dificultar', 'integro', 'lira', 'lira', 'lira', 'ppal', 'proposto', 'proposto', 'pslrj', 'regulamentar', 'respostar', 'silveiro', 'supremo', 'supremo']","[1, 1, 1, 1, 3, 3, 3, 1, 2, 2, 1, 1, 1, 1, 2, 2]","['compartilhar']","[1]",16,1,17,1
7406,"['integro', 'justicar', 'magistrado', 'magistrado', 'parceiro', 'preliminar', 'sessao', 'varar']","[1, 1, 2, 2, 1, 1, 1, 1]","['agredir', 'agredir', 'imagem']","[2, 2, 1]",8,3,11,1
7407,"['aglomeracao', 'aglomeracao', 'aglomeracao', 'bbc', 'impactar', 'risco', 'temporada', 'transmissao', 'turistico', 'vespera']","[3, 3, 3, 1, 1, 1, 1, 1, 1, 1]","[]","[]",10,0,10,1
7408,"['client', 'companhia', 'companhia', 'companhia', 'destinar', 'necessidad', 'passageiro', 'periodo', 'portavoz', 'saudar', 'saudar', 'saudar', 'saudar', 'situacao']","[1, 3, 3, 3, 1, 1, 1, 1, 1, 4, 4, 4, 4, 1]","['legendar', 'soldar']","[1, 1]",14,2,16,1
7415,"['aprovacao', 'economia', 'economia', 'economia', 'impactar', 'quedo', 'saudar']","[1, 3, 3, 3, 1, 1, 1]","['arquivar']","[1]",7,1,8,1
7417,"['consolidar', 'liderar', 'saudar', 'saudar', 'subir']","[1, 1, 2, 2, 1]","[]","[]",5,0,5,1
7418,"['consecutivo', 'consorcio', 'decorrencia', 'escalar', 'intervalar', 'levantamento', 'notificar', 'reportar', 'saudar']","[1, 1, 1, 1, 1, 1, 1, 1, 1]","[]","[]",9,0,9,1
7421,"['instituto', 'instituto', 'prazo', 'presenca']","[2, 2, 1, 1]","['sequer']","[1]",4,1,5,1
7427,"['bolsonarista', 'comportamento', 'compromisso', 'crescimento', 'crescimento', 'divergencia', 'quedo']","[1, 1, 1, 2, 2, 1, 1]","['legendar']","[1]",7,1,8,1
7428,"['conformar', 'portavoz']","[1, 1]","['invadir']","[1]",2,1,3,1
7430,"['abordagem', 'acordo', 'especifico', 'exemplo', 'medida', 'necessario', 'prioridad', 'realizacao', 'realizacao', 'serao', 'toquio']","[1, 1, 1, 1, 1, 1, 1, 2, 2, 1, 1]","[]","[]",11,0,11,1
7431,"['internacao', 'necessidad', 'proporcao', 'reducao', 'taxar', 'taxar']","[1, 1, 1, 1, 2, 2]","[]","[]",6,0,6,1
7432,"['afp', 'ambientar', 'habitant', 'margem']","[1, 1, 1, 1]","[]","[]",4,0,4,1
7434,"['domingo', 'domingo', 'estrategia', 'observar', 'planar', 'planar', 'planar', 'reuniao', 'reuniao', 'rigoroso', 'treinamento']","[2, 2, 1, 1, 3, 3, 3, 2, 2, 1, 1]","[]","[]",11,0,11,1
7435,"['aprovacao', 'congresso', 'desenvolvimento', 'destinar', 'estrategia', 'fundeb', 'fundeb', 'fundeb', 'inclusao', 'inclusao', 'justicar', 'manutencao', 'proposto', 'recurso', 'recurso', 'recurso', 'recurso', 'rejeitar', 'substituto']","[1, 1, 1, 1, 1, 3, 3, 3, 2, 2, 1, 1, 1, 4, 4, 4, 4, 1, 1]","[]","[]",19,0,19,1
7441,"['ambito', 'antecipar', 'antecipar', 'apurar', 'argumentar', 'crise', 'inquerito', 'justicar', 'justicar', 'monitoramento', 'monitoramento', 'motivacao', 'planar', 'posicionamento', 'realizacao', 'recurso', 'respostar', 'sobretudo', 'subordinar', 'supremo', 'supremo', 'suspensao']","[1, 2, 2, 1, 1, 1, 1, 2, 2, 2, 2, 1, 1, 1, 1, 1, 1, 1, 1, 2, 2, 1]","['imagem', 'imagem']","[2, 2]",22,2,24,1
7444,"['conformar', 'empatar', 'exprefeito', 'impulsionar', 'levantamento', 'liderar', 'margem', 'nelson', 'nelson', 'tucano']","[1, 1, 1, 1, 1, 1, 1, 2, 2, 1]","[]","[]",10,0,10,1
7446,"['justicar']","[1]","[]","[]",1,0,1,1
7447,"['arthur', 'bancada', 'conjuntar', 'despesa', 'despesa', 'destinar', 'destinar', 'emendar', 'enfrentamento', 'federar', 'lira', 'lira', 'montant', 'orcamentaria', 'orcamentaria', 'ppal', 'recurso', 'totalizar']","[1, 1, 1, 2, 2, 2, 2, 1, 1, 1, 2, 2, 1, 2, 2, 1, 1, 1]","[]","[]",18,0,18,1
7450,"['aglomeracao', 'atendido', 'coletivo', 'equipamento', 'equipamento', 'equipamento', 'equipamento', 'funcionamento', 'quilometro', 'quilometro', 'regiao', 'regiao', 'situacao', 'situacao']","[1, 1, 1, 4, 4, 4, 4, 1, 2, 2, 2, 2, 2, 2]","[]","[]",14,0,14,1
7451,"['almeida', 'ausencia', 'condicao', 'consenso', 'crescimento', 'crise', 'emenda', 'fundacao', 'jurista', 'sido', 'varga']","[1, 1, 1, 1, 1, 1, 1, 1, 1, 1, 1]","['crer']","[1]",11,1,12,1
7454,"['associacao', 'atuacao', 'cerimonia', 'fundacao', 'fundacao', 'integrant']","[1, 1, 1, 2, 2, 1]","['cristao']","[1]",6,1,7,1
7455,"['compromisso', 'compromisso', 'flavio', 'fronteiro', 'globonew', 'imunizacao', 'mandatario', 'mantido', 'ministrar', 'ministrar', 'queiroga', 'queiroga', 'recurso', 'saudar', 'sputnik', 'sputnik', 'unanimidad']","[2, 2, 1, 1, 1, 1, 1, 1, 2, 2, 2, 2, 1, 1, 2, 2, 1]","[]","[]",17,0,17,1
7457,"['adotada', 'aliviar', 'autoridad', 'diplomata', 'diplomata', 'diplomata', 'globonew', 'incerteza', 'restritivo', 'situacao', 'situacao', 'sobretudo', 'surtir', 'surtir']","[1, 1, 1, 3, 3, 3, 1, 1, 1, 2, 2, 1, 2, 2]","['imagem', 'imagem', 'vazio']","[2, 2, 1]",14,3,17,1
7460,"['autoridad', 'autoridad', 'propagacao', 'propagacao', 'sabado', 'sabado']","[2, 2, 2, 2, 2, 2]","['protestar', 'protestar']","[2, 2]",6,2,8,1
7465,"['belgica', 'consorcio', 'consorcio', 'consorcio', 'consorcio', 'correspondent', 'desenvolvido', 'escalar', 'europeu', 'europeu', 'facilitar', 'fase', 'metropolitano', 'periodo', 'regiao']","[1, 4, 4, 4, 4, 1, 1, 1, 2, 2, 1, 1, 1, 1, 1]","['agredir']","[1]",15,1,16,1
7466,"['comparacao', 'correspondent', 'intervalar', 'periodo', 'periodo', 'periodo', 'respiratorio', 'respiratorio']","[1, 1, 1, 3, 3, 3, 2, 2]","['circular', 'compartilhar', 'falsar', 'imagem', 'replicar']","[1, 1, 1, 1, 1]",8,5,13,1
7469,"['adhanom', 'espanha', 'necessidad', 'reportar', 'saudar', 'tedro']","[1, 1, 1, 1, 1, 1]","[]","[]",6,0,6,1
7470,"['academiar', 'crescimento', 'curvo', 'curvo', 'desenvolvimento', 'domingo', 'economia', 'fase', 'flexibilizacao', 'flexibilizacao', 'inclusao', 'palacio', 'parceria', 'planar', 'presenca', 'presenca', 'sabado', 'saudar', 'saudar', 'saudar', 'taxar', 'wilson', 'witzel']","[1, 1, 2, 2, 1, 1, 1, 1, 2, 2, 1, 1, 1, 1, 2, 2, 1, 3, 3, 3, 1, 1, 1]","['bandeiro', 'bandeiro']","[2, 2]",23,2,25,1
7471,"['anvisa', 'aplicacao', 'desenvolvido', 'diariament', 'domingo', 'domingo', 'dosar', 'dosar', 'dosar', 'dosar', 'fase', 'instituto', 'observacao', 'periodo', 'plantao', 'prioridad', 'respostar']","[1, 1, 1, 1, 2, 2, 4, 4, 4, 4, 1, 1, 1, 1, 1, 1, 1]","['checagem', 'preencher', 'questionario', 'verificar']","[1, 1, 1, 1]",17,4,21,1
7476,"['celebrar', 'client', 'crise', 'isolar', 'quarentenar', 'reabertura', 'volumar']","[1, 1, 1, 1, 1, 1, 1]","['cartaz']","[1]",7,1,8,1
7477,"['atuam', 'economia', 'instituto', 'normalment', 'parceiro', 'parceria', 'situacao']","[1, 1, 1, 1, 1, 1, 1]","[]","[]",7,0,7,1
7479,"['acordo', 'atendido', 'decisao', 'dificuldad', 'fase', 'medida', 'portavoz', 'portavoz', 'precaucao', 'tambem', 'tambem']","[1, 1, 1, 1, 1, 1, 2, 2, 1, 2, 2]","[]","[]",11,0,11,1
7483,"['periodo', 'transicao']","[1, 1]","[]","[]",2,0,2,1
7485,"['bastidor', 'congresso', 'dialogo', 'dialogo', 'integrant', 'palacio', 'planalto', 'planalto', 'reajustar', 'reajustar', 'servidor', 'situacao', 'vetar', 'vetar']","[1, 1, 2, 2, 1, 1, 2, 2, 2, 2, 1, 1, 2, 2]","[]","[]",14,0,14,1
7489,"['anteontem', 'anteontem', 'crescimento', 'crescimento', 'decorrencia', 'ritmar', 'ritmar', 'subir', 'subir']","[2, 2, 2, 2, 1, 2, 2, 2, 2]","[]","[]",9,0,9,1
7490,"['condicao', 'diariament', 'elaborar', 'entendimento', 'integro', 'respostar', 'respostar']","[1, 1, 1, 1, 1, 2, 2]","[]","[]",7,0,7,1
7492,"['crise', 'entregu', 'importancia', 'instituto', 'parceria', 'situacao', 'vulnerabilidad']","[1, 1, 1, 1, 1, 1, 1]","['abusar']","[1]",7,1,8,1
7494,"['amplo', 'colleg', 'hospitalizar', 'intensivo', 'internacao', 'necessidad']","[1, 1, 1, 1, 1, 1]","[]","[]",6,0,6,1
7497,"['respostar']","[1]","[]","[]",1,0,1,1
7502,"['acumular', 'antonio', 'chefiar', 'equipamento', 'estrategico', 'gabinet', 'importacao', 'infraestrutura', 'logistico', 'ministrar', 'mudanca', 'mudanca', 'queiroga', 'saudar', 'saudar', 'saudar', 'saudar', 'secretarioexecutivo', 'substituto']","[1, 1, 1, 1, 1, 1, 1, 1, 1, 1, 2, 2, 1, 4, 4, 4, 4, 1, 1]","[]","[]",19,0,19,1
7506,"['absoluto', 'adesao', 'ambientar', 'ambientar', 'ambientar', 'ambientar', 'ambientar', 'ambientar', 'ambientar', 'apreensao', 'aprovacao', 'aprovacao', 'aprovacao', 'argumentar', 'argumentar', 'arthur', 'aspecto', 'ausencia', 'bancada', 'bancada', 'biliao', 'comissao', 'comissao', 'compromisso', 'compromisso', 'concessionario', 'confederacao', 'conjunto', 'consenso', 'consequencia', 'demandar', 'demrj', 'discussao', 'economia', 'edson', 'emendar', 'emendar', 'estrategia', 'excecao', 'exigencia', 'exministro', 'exministro', 'exministro', 'flexibilizacao', 'flexibilizar', 'flexibilizar', 'henriqu', 'impactar', 'impactar', 'impactar', 'impactar', 'impactar', 'impactar', 'impacto', 'impacto', 'infraestrutura', 'infraestrutura', 'iniciativo', 'iniciativo', 'instalacao', 'instituto', 'instituto', 'instituto', 'itamar', 'lira', 'manutencao', 'monitoramento', 'necessidad', 'negativar', 'plenario', 'plenario', 'plenario', 'ppal', 'previo', 'previo', 'previsao', 'previsao', 'privar', 'proposto', 'proposto', 'proposto', 'proposto', 'proposto', 'proposto', 'proposto', 'regrar', 'regrar', 'regrar', 'regrar', 'rejeicao', 'resistencia', 'resolucao', 'rigoroso', 'rigoroso', 'risco', 'significativo', 'significativo', 'sustentabilidad', 'transmissao']","[1, 1, 7, 7, 7, 7, 7, 7, 7, 1, 3, 3, 3, 2, 2, 1, 1, 1, 2, 2, 1, 2, 2, 2, 2, 1, 1, 1, 1, 1, 1, 1, 1, 1, 1, 2, 2, 1, 1, 1, 3, 3, 3, 1, 2, 2, 1, 6, 6, 6, 6, 6, 6, 2, 2, 2, 2, 2, 2, 1, 3, 3, 3, 1, 1, 1, 1, 1, 1, 3, 3, 3, 1, 2, 2, 2, 2, 1, 7, 7, 7, 7, 7, 7, 7, 4, 4, 4, 4, 1, 1, 1, 2, 2, 1, 2, 2, 1, 1]","['barragem', 'ganhar']","[1, 1]",99,2,101,1
7507,"['acordo', 'atendido', 'atuam', 'distrito', 'entregu', 'fundacao', 'instituto', 'milho', 'milho', 'milho', 'oswaldo', 'porqu', 'prioritario', 'sendo', 'serao', 'serao', 'tambem', 'vigilancia']","[1, 1, 1, 1, 1, 1, 1, 3, 3, 3, 1, 1, 1, 1, 2, 2, 1, 1]","[]","[]",18,0,18,1
7508,"['liderar']","[1]","['disfarcar', 'humanar', 'pelar']","[1, 1, 1]",1,3,4,1
7510,"['client', 'companhia', 'comparacao', 'desempenhar', 'estatistico', 'modelo', 'pagamento', 'periodo', 'quedo', 'recuar', 'recuperacao']","[1, 1, 1, 1, 1, 1, 1, 1, 1, 1, 1]","[]","[]",11,0,11,1
7511,"['adversario', 'augusto', 'pslsp', 'republico']","[1, 1, 1, 1]","['replicar']","[1]",4,1,5,1
7513,"['celso', 'decisao', 'informaco', 'informaco', 'possibilidad', 'recebido', 'sido', 'sido', 'sido', 'ultimo']","[1, 1, 2, 2, 1, 1, 3, 3, 3, 1]","['sapato']","[1]",10,1,11,1
7515,"['apreensao', 'autoridad', 'deflagrar', 'fundacao', 'irregularidad', 'ministrar', 'necessario', 'nogueira', 'nogueira', 'saudar', 'suspeito']","[1, 1, 1, 1, 1, 1, 1, 2, 2, 1, 1]","[]","[]",11,0,11,1
7517,"['absoluto', 'saudar']","[1, 1]","[]","[]",2,0,2,1
7520,"['domingo', 'epicentro', 'hubei', 'medida', 'pedido', 'provincia', 'provincia', 'serao', 'surto', 'suspensa', 'temporariament', 'temporariament']","[1, 1, 1, 1, 1, 2, 2, 1, 1, 1, 2, 2]","[]","[]",12,0,12,1
7523,"['atendido', 'atrair', 'bbc', 'dificuldad', 'equipamento', 'estatistico', 'perspectivo', 'presenciar', 'situacao', 'souza', 'temor', 'turma']","[1, 1, 1, 1, 1, 1, 1, 1, 1, 1, 1, 1]","[]","[]",12,0,12,1
7526,"['esforco', 'examinar', 'itamarati', 'itamarati', 'posturar', 'sabatino', 'sabatino', 'situacao']","[1, 1, 2, 2, 1, 2, 2, 1]","[]","[]",8,0,8,1
7527,"['constatar', 'diagnosticar', 'jorg', 'negativar', 'surtir']","[1, 1, 1, 1, 1]","[]","[]",5,0,5,1
7529,"['antecipar', 'autorizacao', 'companhia', 'decisao', 'decisao', 'europeu', 'extraordinario', 'moderno', 'prazo', 'reuniao']","[1, 1, 1, 2, 2, 1, 1, 1, 1, 1]","[]","[]",10,0,10,1
7530,"['autorizacao', 'condicao', 'congresso', 'congresso', 'decisao', 'diretoria', 'entendimento', 'especifico', 'privatizacao', 'tcu', 'vetar']","[1, 1, 2, 2, 1, 1, 1, 1, 1, 1, 1]","[]","[]",11,0,11,1
7531,"['assistencia', 'cometido', 'estimular', 'fundamentar', 'paralisar', 'supremo', 'supremo']","[1, 1, 1, 1, 1, 2, 2]","[]","[]",7,0,7,1
7534,"['destacar']","[1]","[]","[]",1,0,1,1
7537,"['destacar', 'fux', 'fux', 'fux', 'iniciativo', 'iniciativo', 'inquerito', 'inquerito', 'ministrar', 'mudanca', 'patamar', 'plenario', 'plenario', 'plenario', 'prever', 'processo', 'supremo', 'supremo', 'supremo', 'supremo', 'turma', 'unanimidad']","[1, 3, 3, 3, 2, 2, 2, 2, 1, 1, 1, 3, 3, 3, 1, 1, 4, 4, 4, 4, 1, 1]","['imagem']","[1]",22,1,23,1
7538,"['antonio', 'biliao', 'carat', 'cupula', 'decisao', 'inicialment', 'investigacao', 'investigacao', 'investigacao', 'justicar', 'ministrar', 'pagamento', 'recurso', 'saudar', 'saudar', 'temporariament', 'transferencia', 'transferencia']","[1, 1, 1, 1, 1, 1, 3, 3, 3, 1, 1, 1, 1, 2, 2, 1, 2, 2]","['supostament', 'verificar']","[1, 1]",18,2,20,1
7539,"['complicacao']","[1]","[]","[]",1,0,1,1
7540,"['decorrencia', 'oliveira', 'quarentenar']","[1, 1, 1]","['sortir']","[1]",3,1,4,1
7543,"['depoimento', 'dosar', 'estimativo', 'instituto']","[1, 1, 1, 1]","[]","[]",4,0,4,1
7544,"['autoridad', 'celso', 'celso', 'celso', 'celso', 'conflito', 'constituicao', 'especialment', 'fundamentar', 'ideologico', 'limitacao', 'mello', 'mello', 'mello', 'mello', 'ministrar', 'ministrar', 'necessario', 'necessario', 'palacio', 'planalto', 'posicionamento', 'pratico', 'preservacao', 'republico', 'republico', 'republico', 'supremo']","[1, 4, 4, 4, 4, 1, 1, 1, 1, 1, 1, 4, 4, 4, 4, 2, 2, 2, 2, 1, 1, 1, 1, 1, 3, 3, 3, 1]","[]","[]",28,0,28,1
7546,"['crise', 'crise', 'destacar', 'disseminacao', 'economia', 'infectar', 'instituto', 'mandatario', 'preocupacao', 'recuperacao', 'regiao', 'saudar', 'situacao', 'velocidad']","[2, 2, 1, 1, 1, 1, 1, 1, 1, 1, 1, 1, 1, 1]","[]","[]",14,0,14,1
7547,"['contabilizar', 'domingo', 'domingo', 'domingo', 'saudar', 'saudar']","[1, 3, 3, 3, 2, 2]","[]","[]",6,0,6,1
7548,"['anteontem', 'desenvolvimento', 'observar', 'patamar', 'patamar', 'reabertura', 'taxar', 'taxar']","[1, 1, 1, 2, 2, 1, 2, 2]","[]","[]",8,0,8,1
7549,"['calendario', 'contrato', 'espanha', 'fluminens', 'fluminens', 'inglaterra', 'necessario', 'reforcar', 'temporada', 'wellington', 'wellington']","[1, 1, 1, 2, 2, 1, 1, 1, 1, 2, 2]","['chorar']","[1]",11,1,12,1
7551,"['anvisa', 'estrategico', 'jorg', 'nelson', 'saudar', 'teich', 'vigilancia']","[1, 1, 1, 1, 1, 1, 1]","['basto']","[1]",7,1,8,1
7552,"['exministro', 'regrar', 'republico', 'saudar']","[1, 1, 1, 1]","[]","[]",4,0,4,1
7553,"['depoimento', 'exministro', 'folhar', 'folhar', 'gabinet', 'inquerito', 'integro', 'justicar', 'republicanosrj', 'supremo', 'tramitar']","[1, 1, 2, 2, 1, 1, 1, 1, 1, 1, 1]","[]","[]",11,0,11,1
7554,"['atuacao', 'biliao', 'iniciativo', 'saudar', 'saudar']","[1, 1, 1, 2, 2]","[]","[]",5,0,5,1
7555,"['dificuldad', 'especializar', 'internar', 'regiao', 'respirador', 'saudar', 'saudar', 'saudar', 'situacao']","[1, 1, 1, 1, 1, 3, 3, 3, 1]","[]","[]",9,0,9,1
7557,"['crise', 'decisao', 'europeu', 'europeu', 'excecao', 'fronteiro', 'impactar', 'prazo', 'surtir', 'turista', 'viajant']","[1, 1, 2, 2, 1, 1, 1, 1, 1, 1, 1]","[]","[]",11,0,11,1
7558,"['cenario', 'justicar', 'justicar', 'necessario', 'previsto', 'quarentenar', 'regrar']","[1, 2, 2, 1, 1, 1, 1]","[]","[]",7,0,7,1
7562,"['anuncio', 'bancada', 'campino', 'fase', 'indicador', 'ministrar']","[1, 1, 1, 1, 1, 1]","[]","[]",6,0,6,1
7563,"['anuncio', 'colunista', 'cometido', 'congresso', 'decisao', 'economia', 'globonew', 'gued', 'irregularidad', 'ministrar', 'ministrar', 'periodo', 'possibilidad', 'provisorio', 'provisorio', 'punicao', 'supremo', 'sustentabilidad']","[1, 1, 1, 1, 1, 1, 1, 1, 1, 2, 2, 1, 1, 2, 2, 1, 1, 1]","['rosario', 'wagner']","[1, 1]",18,2,20,1
7568,"['alternativo', 'concreto', 'integro', 'medeiro', 'ministrar', 'operacionalizacao', 'palacio', 'planalto', 'planar', 'planar', 'saudar', 'saudar', 'vigilancia']","[1, 1, 1, 1, 1, 1, 1, 1, 2, 2, 2, 2, 1]","[]","[]",13,0,13,1
7574,"['bbc', 'bbc', 'positivar', 'sabado']","[2, 2, 1, 1]","['falsar']","[1]",4,1,5,1
7575,"['folhar', 'interino', 'ministrar', 'ministrar', 'nelson', 'oficialment', 'pastar', 'pastar', 'previsao', 'regiao', 'regiao', 'saudar', 'saudar', 'secretarioexecutivo', 'teich', 'transmissao']","[1, 1, 2, 2, 1, 1, 2, 2, 1, 2, 2, 2, 2, 1, 1, 1]","[]","[]",16,0,16,1
7577,"['apurar', 'cometido', 'enfermagem', 'enfermagem', 'funcao', 'inquerito', 'inquerito', 'instaurar', 'instituto', 'irregularidad', 'justicar', 'realizacao', 'realizacao', 'saudar', 'saudar']","[1, 1, 2, 2, 1, 2, 2, 1, 1, 1, 1, 2, 2, 2, 2]","[]","[]",15,0,15,1
7578,"['aplicacao', 'calculo', 'cepa', 'condicao', 'crise', 'dinamarca', 'disseminacao', 'espanha', 'europeu', 'europeu', 'europeu', 'mutacao', 'periodo', 'regiao', 'risco', 'rotina', 'saudar', 'saudar', 'superar', 'transmissao']","[1, 1, 1, 1, 1, 1, 1, 1, 3, 3, 3, 1, 1, 1, 1, 1, 2, 2, 1, 1]","[]","[]",20,0,20,1
7580,"['quarentenar', 'reabrir', 'saudad', 'saudad']","[1, 1, 2, 2]","['gravacao']","[1]",4,1,5,1
7583,"['crise', 'escalar', 'esforco', 'infeccioso', 'infeccioso', 'journal', 'oficialment', 'planar', 'prazo', 'reuniao', 'saudar', 'superar']","[1, 1, 1, 2, 2, 1, 1, 1, 1, 1, 1, 1]","[]","[]",12,0,12,1
7584,"['converso', 'converso', 'crise', 'desafiar', 'enxergar', 'ideologico', 'interlocutor', 'pastar', 'plano']","[2, 2, 1, 1, 1, 1, 1, 1, 1]","[]","[]",9,0,9,1
7585,"['destinar', 'presenciar']","[1, 1]","['inscricao']","[1]",2,1,3,1
7587,"['ambientar', 'equipamento', 'equipamento', 'isolar', 'ministrar', 'oliveira', 'preservacao', 'ricardo', 'sall']","[1, 2, 2, 1, 1, 1, 1, 1, 1]","['expulsar']","[1]",9,1,10,1
7589,"['coreia', 'coreia', 'dificultar', 'disseminacao', 'epicentro', 'hospitalizar', 'hospitalizar', 'infeccioso', 'infectar', 'infectar', 'institut', 'liderar', 'negativar', 'negativar', 'observar', 'observar', 'periodo', 'possibilidad', 'recuperacao', 'recuperacao', 'regiao', 'significativo', 'taxar', 'taxar']","[2, 2, 1, 1, 1, 2, 2, 1, 2, 2, 1, 1, 2, 2, 2, 2, 1, 1, 2, 2, 1, 1, 2, 2]","['amplament', 'humanar']","[1, 1]",24,2,26,1
7591,"['dosar', 'entendimento', 'entregu', 'etapa', 'fase', 'fase', 'instaurar', 'necessario', 'previsao', 'transferencia']","[1, 1, 1, 1, 2, 2, 1, 1, 1, 1]","[]","[]",10,0,10,1
7592,"['acordo', 'possibilidad', 'proximo', 'servidor', 'servidor', 'servidor', 'wajngarten', 'wajngarten']","[1, 1, 1, 3, 3, 3, 2, 2]","[]","[]",8,0,8,1
7593,"['autoridad', 'biliao', 'cerimonia', 'comprometido', 'fase', 'habitant']","[1, 1, 1, 1, 1, 1]","[]","[]",6,0,6,1
7595,"['alerj', 'alerj', 'cometido', 'comissao', 'integrant', 'irregularidad', 'justicar', 'legislativo', 'notificar', 'unanimidad', 'wilson', 'witzel', 'witzel', 'witzel']","[2, 2, 1, 1, 1, 1, 1, 1, 1, 1, 1, 3, 3, 3]","['sortear', 'sortear']","[2, 2]",14,2,16,1
7599,"['assistencia', 'deteccao', 'impactar', 'infectar', 'inglaterra', 'inglaterra', 'irregularidad', 'isolar', 'obtido', 'obtido', 'portavoz', 'portavoz', 'propagacao', 'rastreamento', 'rastreamento', 'regiao', 'saudar']","[1, 1, 1, 1, 2, 2, 1, 1, 2, 2, 2, 2, 1, 2, 2, 1, 1]","['privacidad']","[1]",17,1,18,1
7603,"['decisao', 'defendido', 'folhar', 'fux', 'fux', 'individuar', 'integrant', 'integro', 'mudanca', 'normalment', 'plenario', 'processo', 'proposto', 'proposto', 'regrar', 'supremo']","[1, 1, 1, 2, 2, 1, 1, 1, 1, 1, 1, 1, 2, 2, 1, 1]","[]","[]",16,0,16,1
7606,"['espanha', 'especifico', 'limitacao', 'regiao', 'situacao']","[1, 1, 1, 1, 1]","[]","[]",5,0,5,1
7607,"['adhanom', 'liderar', 'saudar', 'tedro', 'tedro']","[1, 1, 1, 2, 2]","[]","[]",5,0,5,1
7610,"['oliveira', 'periodo']","[1, 1]","['ganhar', 'visualizacao']","[1, 1]",2,2,4,1
7617,"['necessario', 'transferencia', 'transferir']","[1, 1, 1]","['verdadeiro']","[1]",3,1,4,1
7618,"['congresso', 'crise', 'decorrent', 'pagamento', 'parcelar']","[1, 1, 1, 1, 1]","[]","[]",5,0,5,1
7622,"['autoridad', 'curvo', 'decisao', 'decorrencia', 'espanha', 'intensivo', 'quarentenar']","[1, 1, 1, 1, 1, 1, 1]","[]","[]",7,0,7,1
7630,"['academiar', 'decisao', 'funcionamento', 'funcionamento', 'indicador', 'quedo', 'reabertura', 'sabado', 'saudar', 'taxar']","[1, 1, 2, 2, 1, 1, 1, 1, 1, 1]","[]","[]",10,0,10,1
7631,"['compromisso', 'compromisso', 'dialogo', 'entendimento', 'expansao', 'fornecimento', 'lancamento', 'lancamento', 'preparacao', 'presenca', 'relacao', 'ricardo', 'sall']","[2, 2, 1, 1, 1, 1, 2, 2, 1, 1, 1, 1, 1]","[]","[]",13,0,13,1
7633,"['araujo', 'augusto', 'colaboracao', 'decisao', 'deltan', 'desigu', 'especialment', 'integro', 'interferencia', 'investigacao', 'justicar', 'justicar', 'liderar', 'parceria', 'republico', 'subir']","[1, 1, 1, 1, 1, 1, 1, 1, 1, 1, 2, 2, 1, 1, 1, 1]","[]","[]",16,0,16,1
7638,"['equipamento', 'estrategia', 'intenso', 'justicar', 'justicar', 'paralisar', 'preparacao', 'preventivo', 'realizacao', 'reforcar', 'reuniao']","[1, 1, 1, 2, 2, 1, 1, 1, 1, 1, 1]","['usuario', 'verificacao']","[1, 1]",11,2,13,1
7639,"['determinacao', 'flexibilizacao', 'integro', 'planar', 'prorrogar', 'prorrogar', 'prorrogar', 'quarentenar', 'quarentenar']","[1, 1, 1, 1, 3, 3, 3, 2, 2]","[]","[]",9,0,9,1
7640,"['adulto', 'confirmado', 'entendimento', 'facilitar', 'relacao', 'sorocaba', 'vigilancia']","[1, 1, 1, 1, 1, 1, 1]","[]","[]",7,0,7,1
7641,"['compromisso', 'converso', 'flavio', 'flavio', 'flavio', 'tendencia']","[1, 1, 3, 3, 3, 1]","[]","[]",6,0,6,1
7642,"['consorcio', 'distrito', 'dosar', 'dosar', 'dosar', 'dosar', 'dosar', 'equivalent', 'imunizacao', 'integro', 'reforcar']","[1, 1, 5, 5, 5, 5, 5, 1, 1, 1, 1]","[]","[]",11,0,11,1
7644,"['ambientar', 'decorrencia', 'diariament', 'domingo', 'internar', 'internar', 'reuniao', 'souza']","[1, 1, 1, 1, 2, 2, 1, 1]","[]","[]",8,0,8,1
7645,"['desenvolvimento', 'distrito', 'distrito', 'fundamentar', 'importancia', 'orientacao', 'previsao', 'privar', 'reforcar', 'saudar', 'saudar', 'saudar']","[1, 2, 2, 1, 1, 1, 1, 1, 1, 3, 3, 3]","['versao']","[1]",12,1,13,1
7658,"['projecao']","[1]","[]","[]",1,0,1,1
7660,"['comportamento']","[1]","['incendio']","[1]",1,1,2,1
7661,"['amplo', 'crise', 'decisao', 'desenvolvido', 'dosar', 'impactar', 'imunizacao', 'inedito', 'intensivo', 'isolar', 'parceria', 'velocidad']","[1, 1, 1, 1, 1, 1, 1, 1, 1, 1, 1, 1]","[]","[]",12,0,12,1
7662,"['apurar', 'arthur', 'aurelio', 'barroso', 'conformar', 'constituicao', 'edson', 'exercicio', 'fachin', 'inedito', 'inquerito', 'instaurar', 'intervalar', 'legislativo', 'liderar', 'lira', 'ministrar', 'oficio', 'prever', 'pslrj', 'pslrj', 'silveiro', 'silveiro', 'silveiro', 'supremo']","[1, 1, 1, 1, 1, 1, 1, 1, 1, 1, 1, 1, 1, 1, 1, 1, 1, 1, 1, 2, 2, 3, 3, 3, 1]","['sobrar']","[1]",25,1,26,1
7666,"['cepa', 'fase', 'fase', 'infeccioso', 'infectar', 'liderar', 'mutacao', 'observar', 'periodo', 'proliferacao', 'proliferacao', 'saudar']","[1, 2, 2, 1, 1, 1, 1, 1, 1, 2, 2, 1]","['checar', 'versao']","[1, 1]",12,2,14,1
7668,"['aglomeracao', 'distrito']","[1, 1]","['imagem']","[1]",2,1,3,1
7672,"['avancar', 'demrj', 'disseminacao', 'fundacao', 'mudanca', 'proposto', 'varga']","[1, 1, 1, 1, 1, 1, 1]","['telejorn']","[1]",7,1,8,1
7673,"['estimular', 'julgamento', 'sentenca']","[1, 1, 1]","[]","[]",3,0,3,1
7674,"['atuacao', 'cenario', 'cenario', 'cilindro', 'cilindro', 'cilindro', 'crise', 'infectar', 'internar', 'saudar', 'sindicato', 'universitario', 'varga']","[1, 2, 2, 3, 3, 3, 1, 1, 1, 1, 1, 1, 1]","['vazio']","[1]",13,1,14,1
7675,"['anteriorment', 'autoridad', 'consolidar', 'levantamento', 'saudar', 'saudar', 'superar']","[1, 1, 1, 1, 2, 2, 1]","['verificacao']","[1]",7,1,8,1
7676,"['ambientar', 'implementar', 'reuniao', 'saudar']","[1, 1, 1, 1]","[]","[]",4,0,4,1
7681,"['anvisa', 'autorizacao', 'biliao', 'contrato', 'exigencia', 'iniciativo', 'pastar', 'prever', 'prever', 'previsto', 'provisorio', 'saudar', 'sputnik', 'sputnik', 'sputnik']","[1, 1, 1, 1, 1, 1, 1, 2, 2, 1, 1, 1, 3, 3, 3]","[]","[]",15,0,15,1
7685,"['anvisa', 'autonomia', 'decisao', 'ministrar', 'piorar', 'queiroga', 'saudar', 'saudar', 'saudar', 'vigilancia']","[1, 1, 1, 1, 1, 1, 3, 3, 3, 1]","['compartilhar']","[1]",10,1,11,1
7687,"['boletim', 'colunista', 'escalar', 'internar', 'possibilidad', 'saudar', 'situacao']","[1, 1, 1, 1, 1, 1, 1]","[]","[]",7,0,7,1
7689,"['colombio', 'desenvolvido', 'fronteiro', 'margem', 'saudar']","[1, 1, 1, 1, 1]","[]","[]",5,0,5,1
7691,"['biliao', 'dedicar', 'diretoria', 'expansao', 'instalacao', 'interferencia', 'prazo', 'preliminar', 'prever', 'regrar', 'transmissao']","[1, 1, 1, 1, 1, 1, 1, 1, 1, 1, 1]","['versao', 'versao']","[2, 2]",11,2,13,1
7693,"['carat', 'confirmado', 'correspondent', 'medida', 'pulmonar', 'pulmonar', 'reforca', 'temporario', 'ventilatorio', 'ventilatorio']","[1, 1, 1, 1, 2, 2, 1, 1, 2, 2]","[]","[]",10,0,10,1
7694,"['celso', 'empatar', 'folhar', 'margem']","[1, 1, 1, 1]","[]","[]",4,0,4,1
7695,"['adulto', 'carat', 'conformar', 'correspondent', 'distrito', 'espirito', 'espirito', 'pastar', 'reforcar', 'saudar', 'saudar', 'temporario']","[1, 1, 1, 1, 1, 2, 2, 1, 1, 2, 2, 1]","[]","[]",12,0,12,1
7697,"['aprovacao', 'californio', 'desenvolvimento', 'help', 'lancamento', 'parceria', 'respirador']","[1, 1, 1, 1, 1, 1, 1]","['compartilhar']","[1]",7,1,8,1
7698,"['alternativo', 'ampliacao', 'ampliacao', 'amplo', 'anvisa', 'autorizacao', 'autorizacao', 'condicao', 'contemplar', 'desenvolvimento', 'equipamento', 'escalar', 'escalar', 'especifico', 'esperancar', 'expectativa', 'fase', 'funcao', 'limitacao', 'opcao', 'perspectivo', 'possibilidad', 'possibilidad', 'preocupacao', 'saudar', 'saudar', 'situacao']","[1, 2, 2, 1, 1, 2, 2, 1, 1, 1, 1, 2, 2, 1, 1, 1, 1, 1, 1, 1, 1, 2, 2, 1, 2, 2, 1]","['estomago']","[1]",27,1,28,1
7699,"['desenvolvimento', 'desenvolvimento', 'desenvolvimento', 'desmatamento', 'desmatamento', 'economia', 'economia', 'iniciativo', 'lancamento', 'proferir', 'videoconferencia']","[3, 3, 3, 2, 2, 2, 2, 1, 1, 1, 1]","[]","[]",11,0,11,1
7703,"['carla', 'zambelli']","[1, 1]","[]","[]",2,0,2,1
7704,"['amplo', 'articulacao', 'autoridad', 'batalhar', 'conformar', 'conformar', 'conjuntar', 'desafio', 'destacar', 'distrito', 'elaborar', 'folhar', 'implementacao', 'infancia', 'infancia', 'institut', 'instituto', 'instituto', 'pratico', 'resistencia', 'turma', 'velocidad']","[1, 1, 1, 1, 2, 2, 1, 1, 1, 1, 1, 1, 1, 2, 2, 1, 2, 2, 1, 1, 1, 1]","['acidentar', 'amigar', 'cedula', 'cedula', 'ganhar', 'padrar', 'parir', 'parir']","[1, 1, 2, 2, 1, 1, 2, 2]",22,8,30,1
7705,"['atuacao', 'decisao', 'esquema', 'heleno', 'lavagem', 'martim', 'motivacao', 'ribeiro', 'ricardo']","[1, 1, 1, 1, 1, 1, 1, 1, 1]","[]","[]",9,0,9,1
7706,"['carla', 'previsto', 'saudar', 'sputnik', 'sputnik']","[1, 1, 1, 2, 2]","['verificar']","[1]",5,1,6,1
7709,"['adversario', 'alvorar', 'antonio', 'anuncio', 'argumentar', 'celso', 'martim', 'palacio', 'processo', 'recebido', 'transmissao', 'varga']","[1, 1, 1, 1, 1, 1, 1, 1, 1, 1, 1, 1]","['abusar', 'arquivar', 'ganhar', 'supostament']","[1, 1, 1, 1]",12,4,16,1
7710,"['higienizacao', 'internar', 'positivar', 'positivar', 'ricardo', 'sabado', 'saudar']","[1, 1, 2, 2, 1, 1, 1]","[]","[]",7,0,7,1
7713,"['bruto', 'cenario', 'comparacao', 'cooperacao', 'crise', 'crise', 'desenvolvimento', 'destacar', 'distant', 'economia', 'economia', 'economia', 'economia', 'excecao', 'gued', 'internar', 'mexico', 'ministrar', 'negativar', 'perspectivo', 'pib', 'pib', 'pib', 'piorar', 'quedo', 'quedo', 'recordar', 'recuperacao', 'recuperacao', 'reflexo', 'saudar', 'situacao', 'trimestr', 'trimestr', 'trimestr', 'variacao']","[1, 1, 1, 1, 2, 2, 1, 1, 1, 4, 4, 4, 4, 1, 1, 1, 1, 1, 1, 1, 3, 3, 3, 1, 2, 2, 1, 2, 2, 1, 1, 1, 3, 3, 3, 1]","[]","[]",36,0,36,1
7714,"['anvisa', 'colegio', 'discussao', 'integrant', 'integrant', 'posicionamento', 'proposto', 'reuniao', 'reuniao', 'vigilancia']","[1, 1, 1, 2, 2, 1, 1, 2, 2, 1]","['verificar']","[1]",10,1,11,1
7721,"['alcolumbr', 'biliao', 'biliao', 'biliao', 'biliao', 'congresso', 'congresso', 'demap', 'distrito', 'extraordinario', 'extraordinario', 'extraordinario', 'extraordinario', 'provisorio', 'saudar', 'transferencia']","[1, 4, 4, 4, 4, 2, 2, 1, 1, 4, 4, 4, 4, 1, 1, 1]","[]","[]",16,0,16,1
7724,"['desgast', 'estrategia', 'interlocutor', 'palacio', 'planalto', 'planalto', 'regiao', 'rotina', 'sobretudo']","[1, 1, 1, 1, 2, 2, 1, 1, 1]","['verificar']","[1]",9,1,10,1
7725,"['calheiro', 'calheiro', 'calheiro', 'concreto', 'inquerito', 'inquerito', 'inquerito', 'justicar', 'mdbal', 'paralelo', 'prever', 'recebido', 'supremo']","[3, 3, 3, 1, 3, 3, 3, 1, 1, 1, 1, 1, 1]","[]","[]",13,0,13,1
7727,"['coordenar', 'decisao', 'dosar', 'dosar', 'dosar', 'dosar', 'dosar', 'dosar', 'imunizacao', 'parceria', 'primario', 'reforcar', 'reforcar']","[1, 1, 6, 6, 6, 6, 6, 6, 1, 1, 1, 2, 2]","[]","[]",13,0,13,1
7730,"['ccj', 'constituicao', 'demrj', 'justicar', 'surtir']","[1, 1, 1, 1, 1]","['atirar', 'soldar', 'soldar']","[1, 2, 2]",5,3,8,1
7731,"['academico', 'bbc', 'contemplar', 'disseminacao', 'mandatario', 'mutacao']","[1, 1, 1, 1, 1, 1]","[]","[]",6,0,6,1
7735,"['anteriorment', 'araujo', 'araujo', 'decisao', 'justicar', 'oficio', 'paralelo', 'possibilidad', 'previsto', 'realizacao', 'respectivament', 'respectivament', 'sessao', 'unanimidad']","[1, 2, 2, 1, 1, 1, 1, 1, 1, 1, 2, 2, 1, 1]","[]","[]",14,0,14,1
7736,"['calheiro', 'flavio', 'folhar', 'integro', 'mdbal', 'viagem']","[1, 1, 1, 1, 1, 1]","[]","[]",6,0,6,1
7737,"['caxia', 'caxia', 'caxia', 'caxia', 'desafiar', 'duqu', 'duqu', 'duqu', 'orientacao', 'reclamacao']","[4, 4, 4, 4, 1, 3, 3, 3, 1, 1]","[]","[]",10,0,10,1
7738,"['articulacao', 'colegiado', 'colegiado', 'comissao', 'comissao', 'comissao', 'comissao', 'comissao', 'congresso', 'congresso', 'crise', 'crise', 'destacar', 'determinacao', 'dialogo', 'discussao', 'economia', 'enfrentamento', 'enfrentamento', 'esforco', 'flavia', 'flavia', 'flavia', 'flavia', 'gued', 'humanitario', 'inquerito', 'lira', 'ministrar', 'necessario', 'necessario', 'planalto', 'planar', 'planar', 'ppal', 'presidir', 'recurso', 'recurso', 'sancao', 'saudar', 'saudar', 'supremo']","[1, 2, 2, 5, 5, 5, 5, 5, 2, 2, 2, 2, 1, 1, 1, 1, 1, 2, 2, 1, 4, 4, 4, 4, 1, 1, 1, 1, 1, 2, 2, 1, 2, 2, 1, 1, 2, 2, 1, 2, 2, 1]","[]","[]",42,0,42,1
7739,"['coreia', 'coreia', 'decisao', 'decisao', 'decisao', 'esforco', 'necessario', 'previo', 'quarentenar', 'quarentenar', 'quarentenar', 'viagem', 'visitant', 'visitant']","[2, 2, 3, 3, 3, 1, 1, 1, 3, 3, 3, 1, 2, 2]","['protestar']","[1]",14,1,15,1
7740,"['agravamento', 'colombio', 'confederacao', 'levantamento', 'tornear', 'transferir']","[1, 1, 1, 1, 1, 1]","[]","[]",6,0,6,1
7743,"['destinar', 'dosar', 'dosar', 'esquema', 'esquema', 'esquema', 'esquema', 'federativo', 'instituto', 'materiaprima', 'operacionalizacao', 'pastar', 'planar', 'previsao', 'prioritario', 'saudar']","[1, 2, 2, 4, 4, 4, 4, 1, 1, 1, 1, 1, 1, 1, 1, 1]","[]","[]",16,0,16,1
7744,"['epidemiar', 'habitant', 'sabado', 'saudar', 'subir']","[1, 1, 1, 1, 1]","['soldar']","[1]",5,1,6,1
7745,"['campino', 'sabado']","[1, 1]","[]","[]",2,0,2,1
7747,"['agravamento', 'cenario', 'cenario', 'cenario', 'crise', 'crise', 'crise', 'crise', 'decisao', 'diretoria', 'diretoria', 'economia', 'emergenciai', 'exercicio', 'impactar', 'impactar', 'impacto', 'impacto', 'implementar', 'incerteza', 'incerteza', 'limitacao', 'necessario', 'precisao', 'precisao', 'preparacao', 'preservacao', 'prioritario', 'privar', 'saudar', 'significativo', 'surtir', 'surtir', 'trimestr', 'trimestr']","[1, 3, 3, 3, 4, 4, 4, 4, 1, 2, 2, 1, 1, 1, 2, 2, 2, 2, 1, 2, 2, 1, 1, 2, 2, 1, 1, 1, 1, 1, 1, 2, 2, 2, 2]","[]","[]",35,0,35,1
7749,"['oferecido']","[1]","[]","[]",1,0,1,1
7750,"['alternativo', 'alternativo', 'biliao', 'biliao', 'congresso', 'crise', 'despesa', 'despesa', 'despesa', 'despesa', 'economia', 'economia', 'economia', 'emendar', 'expectativa', 'necessario', 'recurso', 'recurso', 'tcu', 'temporario', 'tesourar', 'transferencia']","[2, 2, 2, 2, 1, 1, 4, 4, 4, 4, 3, 3, 3, 1, 1, 1, 2, 2, 1, 1, 1, 1]","['sobrar']","[1]",22,1,23,1
7752,"['elaborar', 'iniciativo', 'orientacao', 'planar', 'planar', 'previsto', 'prioridad', 'saudar', 'saudar', 'saudar', 'suspeito']","[1, 1, 1, 2, 2, 1, 1, 3, 3, 3, 1]","[]","[]",11,0,11,1
7758,"['apurar', 'argumentar', 'carla', 'decisao', 'disseminacao', 'inquerito', 'inquerito', 'inquerito', 'ministrar', 'ministrar', 'pslsp', 'supremo', 'zambelli']","[1, 1, 1, 1, 1, 3, 3, 3, 2, 2, 1, 1, 1]","['falsar']","[1]",13,1,14,1
7759,"['congresso', 'economia', 'folhar', 'folhar', 'integro', 'pagamento', 'pagamento', 'prorrogacao', 'vetar']","[1, 1, 2, 2, 1, 2, 2, 1, 1]","[]","[]",9,0,9,1
7760,"['autorizacao', 'autorizacao', 'milho', 'milho', 'pfizerbiontech', 'pfizerbiontech', 'pfizerbiontech', 'sendo', 'sendo']","[2, 2, 2, 2, 3, 3, 3, 2, 2]","[]","[]",9,0,9,1
7762,"['adiamento', 'adiamento', 'adiamento', 'calendario', 'competicao', 'presenca', 'sigla']","[3, 3, 3, 1, 1, 1, 1]","[]","[]",7,0,7,1
7766,"['destacar', 'entregu', 'especifico', 'gabbardo', 'instalacao', 'pastar', 'pastar', 'prazo', 'regiao', 'saudar']","[1, 1, 1, 1, 1, 2, 2, 1, 1, 1]","[]","[]",10,0,10,1
7767,"['escassez', 'fluminens', 'fluminens', 'internacao', 'intubacao', 'pastar', 'regiao', 'regiao', 'regiao', 'saudar', 'saudar', 'situacao']","[1, 2, 2, 1, 1, 1, 3, 3, 3, 2, 2, 1]","['verificar']","[1]",12,1,13,1
7768,"['academico', 'ambito', 'aspecto', 'cenario', 'condenacao', 'decisao', 'decisao', 'dedicar', 'edson', 'fachin', 'fachin', 'fachin', 'impactar', 'justicar', 'ministrar', 'pratico', 'supremo']","[1, 1, 1, 1, 1, 2, 2, 1, 1, 3, 3, 3, 1, 1, 1, 1, 1]","[]","[]",17,0,17,1
7771,"['afastamento', 'delacao', 'goncalv', 'goncalv', 'justicar', 'ministrar', 'prorrogar', 'republico', 'saudar', 'temporario', 'wilson', 'witzel']","[1, 1, 2, 2, 1, 1, 1, 1, 1, 1, 1, 1]","[]","[]",12,0,12,1
7772,"['eventualment', 'obtido', 'varar']","[1, 1, 1]","['amplament', 'compartilhar']","[1, 1]",3,2,5,1
7776,"['adiamento', 'aglomeracao', 'cerimonia', 'consumidor', 'decisao', 'dificuldad', 'especializar', 'estabilidad', 'estimativo', 'expectativa', 'renata', 'respostar', 'saudar', 'saudar', 'semestr', 'semestr', 'situacao', 'subir']","[1, 1, 1, 1, 1, 1, 1, 1, 1, 1, 1, 1, 2, 2, 2, 2, 1, 1]","['casamentar', 'casamentar', 'casamentar', 'quinzena']","[3, 3, 3, 1]",18,4,22,1
7778,"['administrativo', 'agravar', 'antecipar', 'antecipar', 'apostar', 'instituto', 'minimizar', 'parceria']","[1, 1, 2, 2, 1, 1, 1, 1]","[]","[]",8,0,8,1
7780,"['comprometido', 'consequencia', 'consumidor', 'consumidor', 'esforco', 'iniciativo', 'isolar', 'lancamento', 'recurso', 'ricardo']","[1, 1, 2, 2, 1, 1, 1, 1, 1, 1]","[]","[]",10,0,10,1
7782,"['ausencia', 'geraldo', 'geraldo', 'guaruja', 'sabado']","[1, 2, 2, 1, 1]","['filmar']","[1]",5,1,6,1
7784,"[]","[]","[]","[]",0,0,0,1
7788,"['afetado', 'desmatamento', 'espirito', 'expressar', 'particularment', 'particularment', 'preocupacao', 'recordar', 'regiao', 'saudar', 'vulneravel', 'vulneravel']","[1, 1, 1, 1, 2, 2, 1, 1, 1, 1, 2, 2]","[]","[]",12,0,12,1
7791,"['afp', 'infectar', 'internar', 'recordar', 'revisar', 'saudar']","[1, 1, 1, 1, 1, 1]","[]","[]",6,0,6,1
7792,"['atuacao', 'augusto', 'comissao', 'folhar', 'republico', 'republico', 'republico', 'saudar', 'situacao', 'sobretudo', 'spaulo']","[1, 1, 1, 1, 3, 3, 3, 1, 1, 1, 1]","['postagen']","[1]",11,1,12,1
7794,"['folhar', 'integro', 'justicar', 'ministrar', 'recurso', 'rejeitar']","[1, 1, 1, 1, 1, 1]","['insinuar']","[1]",6,1,7,1
7798,"['advocaciager', 'alcolumbr', 'augusto', 'autonomia', 'concreto', 'congresso', 'constituicao', 'demap', 'demrj', 'discussao', 'discussao', 'entendimento', 'impactar', 'julgamento', 'legislativo', 'possibilidad', 'possibilidad', 'previsto', 'republico', 'respectivament', 'supremo']","[1, 1, 1, 1, 1, 1, 1, 1, 1, 2, 2, 1, 1, 1, 1, 2, 2, 1, 1, 1, 1]","[]","[]",21,0,21,1
7801,"['antecipar', 'biliao', 'biliao', 'consequencia', 'converso', 'desempenhar', 'enfatizar', 'equivalent', 'expectativa', 'inovacao', 'mantido', 'manutencao', 'mudanca', 'mudanca', 'parceria', 'parceria', 'prever', 'prever', 'previsao', 'ritmar', 'ritmar', 'saudar', 'saudar']","[1, 2, 2, 1, 1, 1, 1, 1, 1, 1, 1, 1, 2, 2, 2, 2, 2, 2, 1, 2, 2, 2, 2]","['minutar']","[1]",23,1,24,1
7803,"['argumentar', 'bastidor', 'concreto', 'cupula', 'domingo', 'ideologico', 'integrant', 'minimizar', 'presenca']","[1, 1, 1, 1, 1, 1, 1, 1, 1]","[]","[]",9,0,9,1
7805,"['augusto', 'diagnosticar', 'heleno', 'infectar', 'palacio', 'planalto', 'planalto', 'portavoz', 'portavoz', 'portavoz', 'positivar', 'preocupacao', 'republico', 'republico']","[1, 1, 1, 1, 1, 2, 2, 3, 3, 3, 1, 1, 2, 2]","[]","[]",14,0,14,1
7806,"['adulto', 'aprovacao', 'folhar', 'levantamento', 'margem', 'regiao', 'spaulo']","[1, 1, 1, 1, 1, 1, 1]","[]","[]",7,0,7,1
7809,"['adicionar', 'antecipar', 'distrito', 'previsao', 'previsto', 'rocha']","[1, 1, 1, 1, 1, 1]","[]","[]",6,0,6,1
7812,"['autoridad', 'bbc', 'diagnosticar', 'epicentro', 'kong', 'quilometro', 'respiratorio', 'sigla', 'surtir', 'suspeito', 'transmissao']","[1, 1, 1, 1, 1, 1, 1, 1, 1, 1, 1]","['espalhar']","[1]",11,1,12,1
7814,"['atendido', 'autoridad', 'autoridad', 'periodo', 'regiao']","[1, 2, 2, 1, 1]","[]","[]",5,0,5,1
7816,"['ambientar', 'ambientar', 'demrj', 'interpretar', 'ministrar', 'ministrar', 'respostar', 'ricardo', 'ricardo', 'sabado', 'sall', 'sall', 'sall']","[2, 2, 1, 1, 2, 2, 1, 2, 2, 1, 3, 3, 3]","[]","[]",13,0,13,1
7817,"['andrea', 'conformar', 'crise', 'decisao']","[1, 1, 1, 1]","[]","[]",4,0,4,1
7819,"['caxia', 'caxia', 'duqu', 'duqu', 'goncalo', 'goncalo', 'investigacao', 'redondo', 'redondo', 'saudar']","[2, 2, 2, 2, 2, 2, 1, 2, 2, 1]","[]","[]",10,0,10,1
7825,"['demmg', 'pacheco', 'pacheco', 'reuniao', 'tambem', 'tambem']","[1, 2, 2, 1, 2, 2]","[]","[]",6,0,6,1
7827,"['exercicio', 'exercicio', 'gabinet', 'prever', 'processo']","[2, 2, 1, 1, 1]","[]","[]",5,0,5,1
7828,"['apostar', 'discussao', 'discussao', 'necessidad', 'ricardo', 'ricardo', 'sabatino']","[1, 2, 2, 1, 2, 2, 1]","['cbn']","[1]",7,1,8,1
7829,"['comissao', 'depoimento', 'exministro', 'inquerito', 'integro', 'lorenzoni', 'ministrar', 'onyx', 'onyx', 'palacio', 'planalto', 'saudar', 'secretariager', 'servidor', 'urbano']","[1, 1, 1, 1, 1, 1, 1, 2, 2, 1, 1, 1, 1, 1, 1]","[]","[]",15,0,15,1
7833,"['espanha', 'espanha', 'fronteiro', 'implementar', 'quarentenar', 'reabrir']","[2, 2, 1, 1, 1, 1]","[]","[]",6,0,6,1
7834,"['comparacao', 'contabilizar', 'diagnosticar', 'equipamento', 'fundacao', 'regiao', 'regiao', 'regiao', 'respectivament', 'respostar', 'saudar', 'saudar', 'saudar', 'sudest', 'varga']","[1, 1, 1, 1, 1, 3, 3, 3, 1, 1, 3, 3, 3, 1, 1]","['questionario']","[1]",15,1,16,1
7835,"['alteracao', 'alteracao']","[2, 2]","['ganhar', 'imagem', 'protestar', 'protestar']","[1, 1, 2, 2]",2,4,6,1
7836,"['dosar', 'imunizacao', 'saudar', 'sputnik']","[1, 1, 1, 1]","[]","[]",4,0,4,1
7850,"['boletim', 'internar', 'metropolitano', 'metropolitano', 'metropolitano', 'oliveira', 'saudar', 'servidor']","[1, 1, 3, 3, 3, 1, 1, 1]","['revoltar']","[1]",8,1,9,1
7851,"['individuar', 'pratico']","[1, 1]","['botao']","[1]",2,1,3,1
7852,"['convencao', 'esperancar', 'habito', 'inedito', 'mudanca', 'piorar', 'piorar']","[1, 1, 1, 1, 1, 2, 2]","['obama', 'obama', 'tampouco']","[2, 2, 1]",7,3,10,1
7854,"['autoridad', 'contrato', 'contrato', 'contrato', 'destinar', 'enfrentamento', 'equilibrio', 'justificativo', 'mantido', 'manutencao', 'prazo', 'proposto', 'prorrogacao', 'prorrogar', 'temporario']","[1, 3, 3, 3, 1, 1, 1, 1, 1, 1, 1, 1, 1, 1, 1]","[]","[]",15,0,15,1
7856,"['impactar', 'inclusao', 'instalacao', 'observar', 'prioritario', 'propagacao', 'regiao', 'saudar', 'saudar', 'visitant']","[1, 1, 1, 1, 1, 1, 1, 2, 2, 1]","['espalhar']","[1]",10,1,11,1
7857,"['aliquota', 'companhia', 'comparacao', 'comparacao', 'conformar', 'consolidar', 'desempenhar', 'despesa', 'despesa', 'impactar', 'impactar', 'juro', 'juro', 'negativar', 'periodo', 'periodo', 'ppa', 'ppa', 'quedo', 'reportar', 'reportar', 'taxar', 'taxar', 'tributario', 'trimestr']","[1, 1, 2, 2, 1, 1, 1, 2, 2, 2, 2, 2, 2, 1, 2, 2, 2, 2, 1, 2, 2, 2, 2, 1, 1]","[]","[]",25,0,25,1
7859,"['agravamento', 'cerimonia', 'palacio', 'planalto', 'planalto', 'prescricao', 'respostar', 'saudar']","[1, 1, 1, 2, 2, 1, 1, 1]","[]","[]",8,0,8,1
7860,"['adiamento', 'adiamento', 'consumidor', 'consumidor', 'realizacao', 'sancao', 'vetar', 'vulnerabilidad']","[2, 2, 2, 2, 1, 1, 1, 1]","[]","[]",8,0,8,1
7861,"['adicionar', 'adotada', 'ambientar', 'crescimento', 'desenvolvimento', 'economia', 'economia', 'economia', 'economia', 'economia', 'estrategia', 'estrategico', 'exministro', 'expectativa', 'impacto', 'infraestrutura', 'infraestrutura', 'iniciativo', 'mudanca', 'mudanca', 'pib', 'pib', 'recuperacao', 'recurso', 'recurso', 'ufrj']","[1, 1, 1, 1, 1, 5, 5, 5, 5, 5, 1, 1, 1, 1, 1, 2, 2, 1, 2, 2, 2, 2, 1, 2, 2, 1]","[]","[]",26,0,26,1
7863,"['apurar', 'apurar', 'conformar', 'exigencia', 'imunizacao', 'iniciativo', 'necessario', 'privar', 'privar', 'saudar', 'tcu', 'tcu']","[2, 2, 1, 1, 1, 1, 1, 2, 2, 1, 2, 2]","[]","[]",12,0,12,1
7865,"['comissao', 'externo', 'risco']","[1, 1, 1]","[]","[]",3,0,3,1
7867,"['alteracao', 'alteracao', 'boletim', 'desempenhar', 'deteccao', 'epidemiologico', 'epidemiologico', 'intenso', 'investigacao', 'investigacao', 'notificar', 'observar', 'pastar', 'periodo', 'respiratorio', 'saudar', 'saudar', 'saudar', 'saudar', 'saudar', 'saudar', 'vigilancia', 'vigilancia']","[2, 2, 1, 1, 1, 2, 2, 1, 2, 2, 1, 1, 1, 1, 1, 6, 6, 6, 6, 6, 6, 2, 2]","['amplament']","[1]",23,1,24,1
7868,"['anvisa', 'aplicacao', 'caxia', 'caxia', 'duqu', 'duqu', 'fluminens', 'sabado', 'vigilancia']","[1, 1, 2, 2, 2, 2, 1, 1, 1]","['circular']","[1]",9,1,10,1
7869,"['avancar', 'campino', 'disseminacao', 'integrant', 'metropolitano', 'parceria', 'regiao', 'saudar', 'sorocaba', 'sorocaba']","[1, 1, 1, 1, 1, 1, 1, 1, 2, 2]","[]","[]",10,0,10,1
7870,"['conjuntar', 'pratico', 'pratico']","[1, 2, 2]","['captar', 'vazar', 'vazar']","[1, 2, 2]",3,3,6,1
7875,"['contabilizar', 'periodo', 'portavoz', 'saudar', 'saudar', 'saudar']","[1, 1, 1, 3, 3, 3]","[]","[]",6,0,6,1
7879,"['anteontem', 'aumento', 'calamidad', 'confirmado', 'geografia', 'habitant', 'ibg', 'instituto', 'medida', 'medida', 'prioridad', 'proximo', 'resultado', 'situacao']","[1, 1, 1, 1, 1, 1, 1, 1, 2, 2, 1, 1, 1, 1]","[]","[]",14,0,14,1
7882,"['arrecadar', 'colaborar', 'diariament', 'dificuldad', 'integrant', 'portavoz', 'rotina', 'saudar', 'subir', 'wilson']","[1, 1, 1, 1, 1, 1, 1, 1, 1, 1]","[]","[]",10,0,10,1
7884,"['anteriorment', 'circulacao', 'comunitario', 'epidemiologico', 'infectar', 'infectar', 'intensivo', 'internar', 'investigacao', 'provincia', 'reportar', 'saudar']","[1, 1, 1, 1, 2, 2, 1, 1, 1, 1, 1, 1]","['verificar']","[1]",12,1,13,1
7885,"['depoimento', 'preconceito']","[1, 1]","['usuario']","[1]",2,1,3,1
7888,"['condicao', 'consorcio', 'consorcio', 'estabilidad', 'levantamento', 'quedo', 'sabado', 'saudar', 'subir', 'variacao', 'variacao', 'variacao']","[1, 2, 2, 1, 1, 1, 1, 1, 1, 3, 3, 3]","[]","[]",12,0,12,1
7889,"['adicionar', 'aprovacao', 'autoridad', 'autoridad', 'companhia', 'decorrent', 'orientacao', 'propagacao', 'proposto', 'revisar', 'risco', 'risco', 'risco', 'significativo', 'suspenso', 'trafego', 'treinamento', 'tripulacao', 'viagem']","[1, 1, 2, 2, 1, 1, 1, 1, 1, 1, 3, 3, 3, 1, 1, 1, 1, 1, 1]","[]","[]",19,0,19,1
7892,"['academiar', 'anticorpo', 'fundacao', 'instituto', 'ufrj']","[1, 1, 1, 1, 1]","['verificar']","[1]",5,1,6,1
7897,"['argumentar', 'bbc', 'disseminacao', 'funcionamento', 'necessidad', 'preocupacao']","[1, 1, 1, 1, 1, 1]","['bandeiro']","[1]",6,1,7,1
7901,"['desenvolvimento', 'iniciativo', 'previsao', 'recarregar', 'reconhecimento', 'saudar', 'taxar']","[1, 1, 1, 1, 1, 1, 1]","[]","[]",7,0,7,1
7902,"['anvisa', 'anvisa', 'anvisa', 'argumentar', 'autoridad', 'consorcio', 'importacao', 'importacao', 'importacao', 'regiao', 'saudar', 'situacao', 'sputnik', 'vetar', 'vigilancia']","[3, 3, 3, 1, 1, 1, 3, 3, 3, 1, 1, 1, 1, 1, 1]","[]","[]",15,0,15,1
7903,"['exministro', 'henriqu', 'saudar']","[1, 1, 1]","[]","[]",3,0,3,1
7905,"['adicionar', 'desenvolvimento', 'desenvolvimento', 'desenvolvimento', 'merkel', 'merkel', 'monetario', 'situacao', 'videoconferencia']","[1, 3, 3, 3, 2, 2, 1, 1, 1]","[]","[]",9,0,9,1
7908,"['demandar', 'orientacao', 'privar', 'quadro', 'recurso', 'saudar', 'saudar']","[1, 1, 1, 1, 1, 2, 2]","[]","[]",7,0,7,1
7909,"['advocaciager', 'apurar', 'autonomia', 'autoridad', 'celso', 'celso', 'dialogo', 'entregu', 'exministro', 'exministro', 'inquerito', 'mello', 'mello', 'ministrar', 'presenca', 'republico', 'reuniao', 'reuniao', 'reuniao', 'reuniao', 'supremo']","[1, 1, 1, 1, 2, 2, 1, 1, 2, 2, 1, 2, 2, 1, 1, 1, 4, 4, 4, 4, 1]","['amigar', 'gravacao']","[1, 1]",21,2,23,1
7910,"['aliviar', 'ambientar', 'cenario', 'client', 'companhia', 'comunitario', 'coordenar', 'coordenar', 'domingo', 'esperancar', 'expectativa', 'feriar', 'folhar', 'habitant', 'ibg', 'importancia', 'margem', 'pratico', 'provisorio', 'quilometro', 'quilometro', 'reforcar', 'regiao', 'saneamento', 'saudar', 'subir']","[1, 1, 1, 1, 1, 1, 2, 2, 1, 1, 1, 1, 1, 1, 1, 1, 1, 1, 1, 2, 2, 1, 1, 1, 1, 1]","['camiseta']","[1]",26,1,27,1
7912,"['concreto', 'desafiar']","[1, 1]","['basto', 'fraudar']","[1, 1]",2,2,4,1
7914,"['atrasar', 'atrasar', 'autorizacao', 'carat', 'cepa', 'contagioso', 'decisao', 'decisao', 'federativo', 'justicar', 'mutacao', 'mutacao', 'passageiro', 'regiao', 'republico', 'saudar', 'suspenso', 'temporario', 'viajant']","[2, 2, 1, 1, 1, 1, 2, 2, 1, 1, 2, 2, 1, 1, 1, 1, 1, 1, 1]","[]","[]",19,0,19,1
7918,"['anticorpo', 'antonio', 'argumentar', 'biliao', 'campino', 'conjuntar', 'desafiar', 'desenvolvido', 'desenvolvimento', 'destacar', 'economia', 'enfrentamento', 'exportacao', 'imunizacao', 'infectar', 'instituto', 'jorg', 'moderno', 'parceiro', 'periodo', 'positivar', 'possibilidad', 'prazo']","[1, 1, 1, 1, 1, 1, 1, 1, 1, 1, 1, 1, 1, 1, 1, 1, 1, 1, 1, 1, 1, 1, 1]","[]","[]",23,0,23,1
7919,"['afetado', 'apostar', 'assintomatico', 'converso', 'desenvolvido', 'gripezinha', 'interino', 'mergulhar', 'ministrar', 'ministrar', 'ministrar', 'pratico', 'reafirmar', 'reforcar', 'saudar', 'saudar']","[1, 1, 1, 1, 1, 1, 1, 1, 3, 3, 3, 1, 1, 1, 2, 2]","['disfarcar', 'pego']","[1, 1]",16,2,18,1
7920,"['adiamento', 'adicionar', 'domingo', 'isolar', 'positivar']","[1, 1, 1, 1, 1]","[]","[]",5,0,5,1
7922,"['acompanhamento', 'antonio', 'circulacao', 'descumprir', 'deslocamento', 'inovacao', 'movimentacao', 'movimentacao', 'orientacao', 'parceria', 'quarentenar', 'recurso', 'urbano']","[1, 1, 1, 1, 1, 1, 2, 2, 1, 1, 1, 1, 1]","[]","[]",13,0,13,1
7924,"['adotada', 'crise', 'infectar', 'orientacao', 'propagacao', 'saudar', 'saudar', 'suspeito']","[1, 1, 1, 1, 1, 2, 2, 1]","[]","[]",8,0,8,1
7927,"['assintomatico', 'assintomatico', 'assintomatico', 'assintomatico', 'comorbidad', 'coreia', 'coreia', 'desenvolvimento', 'disseminacao', 'hipertensao', 'independentement', 'infectar', 'isolar', 'isolar', 'isolar', 'liderar', 'molecular', 'necessario', 'negativar', 'observar', 'positivar', 'positivar', 'respectivament', 'subir', 'taxar', 'transmissao', 'vigilancia']","[4, 4, 4, 4, 1, 2, 2, 1, 1, 1, 1, 1, 3, 3, 3, 1, 1, 1, 1, 1, 2, 2, 1, 1, 1, 1, 1]","[]","[]",27,0,27,1
7928,"['equipamento', 'reforcar', 'reforcar']","[1, 2, 2]","['compartilhar', 'ganhar', 'ganhar', 'imagem', 'imagem', 'legendar']","[1, 2, 2, 2, 2, 1]",3,6,9,1
7931,"['aglomeracao', 'calheiro', 'calheiro', 'comissao', 'comissao', 'conformar', 'demmg', 'enfrentamento', 'estimular', 'inquerito', 'mdbal', 'minimizar', 'pacheco']","[1, 2, 2, 2, 2, 1, 1, 1, 1, 1, 1, 1, 1]","[]","[]",13,0,13,1
7937,"['atuacao', 'broadcast', 'comprometido', 'comprometido', 'conformar', 'constituicao', 'destacar', 'edson', 'fachin', 'ideologico', 'ideologico', 'liderar', 'logistico', 'minimizar', 'ministrar', 'pastar', 'supremo']","[1, 1, 2, 2, 1, 1, 1, 1, 1, 2, 2, 1, 1, 1, 1, 1, 1]","[]","[]",17,0,17,1
7939,"['comportamento', 'esperancar', 'importancia', 'rocha']","[1, 1, 1, 1]","['espalhar']","[1]",4,1,5,1
7940,"['apreensao', 'atuacao', 'contrato', 'decisao', 'deflagrar', 'desvio', 'esquema', 'investigacao', 'justicar', 'ministrar', 'ministrar', 'ministrar', 'saudar']","[1, 1, 1, 1, 1, 1, 1, 1, 1, 3, 3, 3, 1]","[]","[]",13,0,13,1
7941,"['araujo', 'araujo', 'comissao', 'posicionamento', 'sessao']","[2, 2, 1, 1, 1]","['vazar', 'vazar']","[2, 2]",5,2,7,1
7944,"['atrasar', 'consequencia', 'suspensao']","[1, 1, 1]","[]","[]",3,0,3,1
7945,"['aprovacao', 'crise', 'folhar', 'inquerito', 'interferencia', 'levantamento', 'levantamento', 'margem', 'republico', 'reuniao', 'spaulo', 'supremo']","[1, 1, 1, 1, 1, 2, 2, 1, 1, 1, 1, 1]","['gravacao']","[1]",12,1,13,1
7947,"['anuncio', 'aprovacao', 'autoridad', 'concreto', 'desenvolvido', 'sputnik', 'suspeito']","[1, 1, 1, 1, 1, 1, 1]","[]","[]",7,0,7,1
7948,"['ambito', 'decisao', 'dialogo', 'folhar', 'integro', 'lewandowski', 'ministrar', 'ricardo', 'supremo']","[1, 1, 1, 1, 1, 1, 1, 1, 1]","[]","[]",9,0,9,1
7952,"['augusto', 'colaboracao', 'delacao', 'delacao', 'depoimento', 'edson', 'exgovernador', 'exgovernador', 'fachin', 'fachin', 'julgamento', 'justicar', 'ministrar', 'plenario', 'recurso', 'republico', 'republico', 'supremo', 'turma']","[1, 1, 2, 2, 1, 1, 2, 2, 2, 2, 1, 1, 1, 1, 1, 2, 2, 1, 1]","[]","[]",19,0,19,1
7954,"['conformar', 'consorcio', 'dosar', 'dosar', 'dosar', 'equivalent', 'levantamento', 'saudar']","[1, 1, 3, 3, 3, 1, 1, 1]","[]","[]",8,0,8,1
7955,"['armazenamento', 'cilindro', 'cilindro', 'cilindro', 'constatar', 'constatar', 'saudar', 'saudar', 'saudar']","[1, 3, 3, 3, 2, 2, 3, 3, 3]","['verificar']","[1]",9,1,10,1
7956,"['autoridad', 'barroso', 'barroso', 'barroso', 'entendimento', 'entendimento', 'improbidad', 'julgamento', 'ministrar', 'ministrar', 'precaucao', 'provisorio', 'punicao', 'saudar', 'supremo', 'suspenso']","[1, 3, 3, 3, 2, 2, 1, 1, 2, 2, 1, 1, 1, 1, 1, 1]","[]","[]",16,0,16,1
7959,"['alternativo', 'expectativa', 'precisao', 'velocidad', 'viagem']","[1, 1, 1, 1, 1]","[]","[]",5,0,5,1
7962,"['avancar', 'avancar', 'compromisso', 'destacar', 'fase', 'iniciativo', 'instalacao', 'interino', 'ministrar', 'ministrar', 'moderno', 'prazo', 'precisao', 'precisao', 'precisao', 'reforcar', 'sabado', 'saudar', 'saudar', 'saudar', 'saudar', 'ufrj']","[2, 2, 1, 1, 1, 1, 1, 1, 2, 2, 1, 1, 3, 3, 3, 1, 1, 4, 4, 4, 4, 1]","['ganhar']","[1]",22,1,23,1
7963,"['afastamento', 'alckmin', 'alckmin', 'alckmin', 'alckmin', 'alckmin', 'alckmin', 'cerimonia', 'geraldo', 'henriqu', 'intervalar', 'processo', 'sentenca']","[1, 6, 6, 6, 6, 6, 6, 1, 1, 1, 1, 1, 1]","['ganhar', 'ganhar']","[2, 2]",13,2,15,1
7964,"['afetado', 'decorrencia', 'desembarcar', 'equipamento', 'impactar', 'incerteza', 'infectar', 'passageiro', 'passageiro', 'quarentenar', 'surtir', 'turista', 'viagem']","[1, 1, 1, 1, 1, 1, 1, 2, 2, 1, 1, 1, 1]","['vazio']","[1]",13,1,14,1
7965,"['epidemiar', 'estatistico', 'fase', 'habitant', 'infectar', 'preocupacao', 'situacao', 'superar']","[1, 1, 1, 1, 1, 1, 1, 1]","['equador']","[1]",8,1,9,1
7966,"['distrito', 'dosar', 'esquema', 'fase', 'igualitario', 'instituto', 'necessario', 'operacionalizacao', 'pastar', 'pastar', 'periodo', 'planar', 'publicoalvo', 'remessar', 'saudar', 'saudar', 'vigilancia']","[1, 1, 1, 1, 1, 1, 1, 1, 2, 2, 1, 1, 1, 1, 2, 2, 1]","[]","[]",17,0,17,1
7968,"['adiamento', 'competicao', 'competicao', 'destacar', 'quilometro', 'rotina', 'situacao', 'souza', 'temporada', 'toquio', 'treinamento', 'treinar']","[1, 2, 2, 1, 1, 1, 1, 1, 1, 1, 1, 1]","['espalhar']","[1]",12,1,13,1
7969,"['atrasar', 'decisao', 'exministro', 'globonew', 'henriqu', 'ministrar', 'ministrar', 'mudanca', 'queiroga', 'saudar', 'saudar', 'saudar', 'saudar']","[1, 1, 1, 1, 1, 2, 2, 1, 1, 4, 4, 4, 4]","['disfarcar']","[1]",13,1,14,1
7970,"['celebrar', 'colombio', 'domingo', 'domingo', 'esquema', 'flexibilizacao', 'flexibilizar', 'legislativo', 'quarentenar']","[1, 1, 2, 2, 1, 1, 1, 1, 1]","['venezuelano']","[1]",9,1,10,1
7971,"['edson', 'fachin', 'fachin', 'folhar', 'integrant', 'integro', 'julgamento', 'magistrado', 'ministrar', 'supremo']","[1, 2, 2, 1, 1, 1, 1, 1, 1, 1]","[]","[]",10,0,10,1
7976,"['destacar', 'destacar', 'panamericana', 'saudar', 'transmissao']","[2, 2, 1, 1, 1]","[]","[]",5,0,5,1
7977,"['republico']","[1]","[]","[]",1,0,1,1
7979,"['aliviar', 'economia', 'economia', 'planar', 'primeiroministro', 'propagacao', 'regiao', 'relaxamento', 'relaxamento']","[1, 2, 2, 1, 1, 1, 1, 2, 2]","[]","[]",9,0,9,1
7986,"['argumentar', 'aspecto', 'manutencao', 'presenciar', 'prioridad', 'saudar', 'saudar', 'sugestao', 'suspensao']","[1, 1, 1, 1, 1, 2, 2, 1, 1]","[]","[]",9,0,9,1
7991,"['economia', 'heleno', 'instituto', 'instituto', 'integrant', 'lorenzoni', 'nomeacao', 'nomeacao', 'oliveira', 'pedido', 'reforca', 'resultado', 'souza', 'tambem']","[1, 1, 2, 2, 1, 1, 2, 2, 1, 1, 1, 1, 1, 1]","[]","[]",14,0,14,1
7992,"['apreensao', 'aprovacao', 'autoridad', 'autoridad', 'autoridad', 'cometido', 'constituicao', 'emendar', 'emendar', 'emendar', 'emendar', 'facilitar', 'investigacao', 'periodo', 'prever', 'privilegiar', 'privilegiar', 'privilegiar', 'proposto', 'republico', 'supremo']","[1, 1, 3, 3, 3, 1, 1, 4, 4, 4, 4, 1, 1, 1, 1, 3, 3, 3, 1, 1, 1]","[]","[]",21,0,21,1
7993,"['adotada', 'atrair', 'cepa', 'comportamento', 'contagioso', 'desafiar', 'especialment', 'genoma', 'hospitalizacao', 'impactar', 'infeccioso', 'journal', 'ministrar', 'minoria', 'moderno', 'mudanca', 'mutacao', 'mutacao', 'mutacao', 'mutacao', 'preliminar', 'preocupacao', 'sequenciamento']","[1, 1, 1, 1, 1, 1, 1, 1, 1, 1, 1, 1, 1, 1, 1, 1, 4, 4, 4, 4, 1, 1, 1]","['replicar', 'verificar']","[1, 1]",23,2,25,1
7995,"['adversario', 'andrea', 'andrea', 'notificar']","[1, 2, 2, 1]","['atribuir']","[1]",4,1,5,1
7997,"['impactar', 'medida', 'passageiro', 'portavoz', 'sido', 'viagem']","[1, 1, 1, 1, 1, 1]","[]","[]",6,0,6,1
7999,"['instituto', 'oferecido', 'prazo', 'saudar', 'temporario']","[1, 1, 1, 1, 1]","['clicar', 'inscricao']","[1, 1]",5,2,7,1
8001,"['client', 'client', 'client', 'client', 'distrito', 'juro', 'planar', 'videoconferencia']","[4, 4, 4, 4, 1, 1, 1, 1]","[]","[]",8,0,8,1
8003,"['arthur', 'atendido', 'domingo', 'expectativa', 'funcionamento', 'intensivo', 'recordar']","[1, 1, 1, 1, 1, 1, 1]","[]","[]",7,0,7,1
8004,"['expectativa', 'prioritario', 'proposto', 'proposto', 'saudar', 'saudar', 'saudar']","[1, 1, 2, 2, 3, 3, 3]","[]","[]",7,0,7,1
8010,"['aglomeracao', 'circulacao', 'orientacao', 'planar', 'prazo', 'quarentenar', 'regiao', 'saudar', 'saudar']","[1, 1, 1, 1, 1, 1, 1, 2, 2]","[]","[]",9,0,9,1
8011,"['constatar', 'proporcao']","[1, 1]","[]","[]",2,0,2,1
8012,"['celebrar', 'compromisso', 'consolidar', 'expectativa', 'flavio', 'inquerito', 'kassio', 'kassio', 'kassio', 'kassio', 'nogueira', 'prazo', 'processo', 'republico', 'situacao', 'supremo', 'supremo', 'supremo', 'supremo', 'supremo', 'supremo']","[1, 1, 1, 1, 1, 1, 4, 4, 4, 4, 1, 1, 1, 1, 1, 6, 6, 6, 6, 6, 6]","['abencoar', 'lustrar']","[1, 1]",21,2,23,1
8014,"['alerj', 'deflagrar', 'dificultar', 'esquema', 'fabricio', 'flavio', 'fluminens', 'investigacao', 'oliveira', 'parceria', 'queiroz', 'queiroz', 'rachadinha', 'regiao']","[1, 1, 1, 1, 1, 1, 1, 1, 1, 1, 2, 2, 1, 1]","[]","[]",14,0,14,1
8018,"['aglomeracao', 'celebrar', 'impacto', 'periodo', 'propagacao', 'provincia', 'quarentenar', 'reportar', 'respiratorio']","[1, 1, 1, 1, 1, 1, 1, 1, 1]","[]","[]",9,0,9,1
8019,"['alteracao', 'calculo', 'calculo', 'circulacao', 'consorcio', 'diariament', 'dosar', 'dosar', 'enxergar', 'equivalent', 'escassez', 'estabilidad', 'estatistico', 'folhar', 'inconsistencia', 'iniciativo', 'ministrar', 'mudanca', 'notificar', 'pastar', 'plantao', 'quedo', 'recordar', 'recurso', 'reflexo', 'sabado', 'sabado', 'saudar', 'saudar', 'saudar', 'spaulo', 'tendencia', 'tendencia']","[1, 2, 2, 1, 1, 1, 2, 2, 1, 1, 1, 1, 1, 1, 1, 1, 1, 1, 1, 1, 1, 1, 1, 1, 1, 2, 2, 3, 3, 3, 1, 2, 2]","[]","[]",33,0,33,1
8020,"['afetado', 'autoridad', 'balancar', 'portavoz', 'recordar', 'recordar', 'saudar']","[1, 1, 1, 1, 2, 2, 1]","[]","[]",7,0,7,1
8022,"['apurar', 'atuacao', 'avancar', 'decisao', 'defendido', 'integro', 'internacao', 'orientacao', 'periodo', 'reuniao', 'reuniao']","[1, 1, 1, 1, 1, 1, 1, 1, 1, 2, 2]","[]","[]",11,0,11,1
8026,"['determinacao', 'internacao', 'internar', 'motivacao', 'periodo', 'quadro', 'quadro']","[1, 1, 1, 1, 1, 2, 2]","[]","[]",7,0,7,1
8030,"['congresso', 'enxergar', 'estrategia', 'exjuiz', 'exjuiz', 'exministro', 'exministro', 'justicar', 'ministrar', 'palacio', 'planalto', 'planalto', 'reforcar']","[1, 1, 1, 2, 2, 2, 2, 1, 1, 1, 2, 2, 1]","['imagem']","[1]",13,1,14,1
8032,"['eventualment', 'importancia', 'interferencia', 'palacio', 'planalto']","[1, 1, 1, 1, 1]","[]","[]",5,0,5,1
8034,"['acordo', 'avancar', 'companhia', 'congresso', 'desenvolvimento', 'expressar', 'fase', 'fornecimento', 'inicialment', 'moderno', 'moderno']","[1, 1, 1, 1, 1, 1, 1, 1, 1, 2, 2]","[]","[]",11,0,11,1
8035,"['autoridad', 'autoridad', 'decisao', 'dialogo', 'justicar', 'ricardo', 'varar', 'videoconferencia']","[2, 2, 1, 1, 1, 1, 1, 1]","['copiar', 'invadir', 'telegram']","[1, 1, 1]",8,3,11,1
8037,"['ambientar', 'arrecadacao', 'biliao', 'biliao', 'biliao', 'crise', 'crise', 'emergenciai', 'enfrentamento', 'europeu', 'inedito', 'iniciativo', 'iniciativo', 'pagamento', 'pib', 'prazo', 'privar', 'quarentenar', 'sabado', 'saudar']","[1, 1, 3, 3, 3, 2, 2, 1, 1, 1, 1, 2, 2, 1, 1, 1, 1, 1, 1, 1]","[]","[]",20,0,20,1
8039,"['avancar', 'desenvolvido', 'desenvolvimento', 'escalar', 'imunizacao', 'liderar', 'parceria', 'reuter', 'reuter', 'saudar']","[1, 1, 1, 1, 1, 1, 1, 2, 2, 1]","[]","[]",10,0,10,1
8040,"['afetado', 'afp', 'cepa', 'crise', 'cupula', 'desafiar', 'europeu', 'europeu', 'fronteiro', 'oficialment', 'reuniao', 'reuniao', 'videoconferencia']","[1, 1, 1, 1, 1, 1, 2, 2, 1, 1, 2, 2, 1]","[]","[]",13,0,13,1
8041,"['crise', 'depoimento', 'exministro', 'fase', 'investigacao', 'pastar', 'recurso', 'recurso', 'saudar', 'saudar']","[1, 1, 1, 1, 1, 1, 2, 2, 2, 2]","['ganhar']","[1]",10,1,11,1
8042,"['reuter']","[1]","[]","[]",1,0,1,1
8043,"['aglomeracao', 'circulacao', 'circulacao', 'exemplo', 'flavio', 'periodo', 'piorar', 'preocupacao', 'pulmo', 'tambem', 'tendencia']","[1, 2, 2, 1, 1, 1, 1, 1, 1, 1, 1]","[]","[]",11,0,11,1
8044,"['congresso', 'contribuicao', 'definitivo', 'prever', 'proposto', 'provisorio', 'provisorio', 'reducao', 'reducao', 'sessao']","[1, 1, 1, 1, 1, 2, 2, 2, 2, 1]","[]","[]",10,0,10,1
8045,"['bandeirant', 'concedido', 'economia', 'especializar', 'liderar', 'orientacao', 'orientacao', 'orientacao', 'palacio', 'preservacao', 'republico', 'republico', 'saudar']","[1, 1, 1, 1, 1, 3, 3, 3, 1, 1, 2, 2, 1]","[]","[]",13,0,13,1
8046,"['instituto', 'instituto', 'instituto', 'oferecido', 'oficio', 'previsao', 'proposto', 'randolf', 'saudar', 'trimestr']","[3, 3, 3, 1, 1, 1, 1, 1, 1, 1]","[]","[]",10,0,10,1
8049,"['antecipar', 'espanha', 'espanha', 'inglaterra', 'isolar', 'quarentenar', 'regiao', 'taxar', 'viajant']","[1, 2, 2, 1, 1, 1, 1, 1, 1]","[]","[]",9,0,9,1
8055,"['atendido', 'autoridad', 'autorizacao', 'decisao', 'discussao', 'entendimento', 'extraordinario', 'julgamento', 'julgamento', 'pagamento', 'plenario', 'previo', 'recurso', 'regiao', 'reuniao', 'sindicato', 'supremo']","[1, 1, 1, 1, 1, 1, 1, 2, 2, 1, 1, 1, 1, 1, 1, 1, 1]","['transposicao']","[1]",17,1,18,1
8056,"['cerimonia', 'compromisso', 'compromisso', 'surtir']","[1, 2, 2, 1]","[]","[]",4,0,4,1
8058,"['absoluto', 'associacao', 'comparacao', 'crescimento', 'estatistico', 'geografia', 'ibg', 'instituto', 'instituto', 'periodo']","[1, 1, 1, 1, 1, 1, 1, 2, 2, 1]","[]","[]",10,0,10,1
8061,"['arrecadacao', 'bruto', 'bruto', 'contrato', 'federar', 'jornada', 'opcao', 'pagamento', 'prever', 'privar', 'privar', 'proposto', 'reducao', 'regrar', 'suspensao', 'temporario']","[1, 2, 2, 1, 1, 1, 1, 1, 1, 2, 2, 1, 1, 1, 1, 1]","[]","[]",16,0,16,1
8063,"['almeida', 'biliao', 'biliao', 'contribuicao', 'despesa', 'despesa', 'enfrentamento', 'estimativo', 'impactar', 'juro', 'primario', 'primario', 'primario', 'primario', 'primario', 'revisar', 'superar', 'tesourar']","[1, 2, 2, 1, 2, 2, 1, 1, 1, 1, 5, 5, 5, 5, 5, 1, 1, 1]","[]","[]",18,0,18,1
8066,"['ambientar', 'ambientar', 'conservacao', 'instituto', 'instituto', 'recurso', 'reducao', 'reducao', 'republico', 'servidor', 'servidor', 'servidor']","[2, 2, 1, 2, 2, 1, 2, 2, 1, 3, 3, 3]","[]","[]",12,0,12,1
8067,"['positivar', 'reuniao', 'reuniao', 'submetido', 'suspenso']","[1, 2, 2, 1, 1]","[]","[]",5,0,5,1
8068,"['estrategico', 'habitant', 'regiao']","[1, 1, 1]","['ilustrar', 'revoltar']","[1, 1]",3,2,5,1
8069,"['celso', 'reafirmar', 'recurso']","[1, 1, 1]","['atribuir']","[1]",3,1,4,1
8070,"['avancar', 'calculo', 'calculo', 'calculo', 'cenario', 'consorcio', 'destacar', 'diariament', 'dosar', 'dosar', 'enxergar', 'equivalent', 'escassez', 'esperancar', 'estabilidad', 'estatistico', 'federativo', 'flexibilizacao', 'folhar', 'impulsionar', 'infectar', 'instituto', 'internacao', 'margem', 'plantao', 'possibilidad', 'projeco', 'projeco', 'quedo', 'quedo', 'recurso', 'reducao', 'saudar', 'saudar', 'spaulo', 'taxar', 'tendencia', 'tendencia', 'tendencia', 'totalizar', 'transmissao', 'variacao']","[1, 3, 3, 3, 1, 1, 1, 1, 2, 2, 1, 1, 1, 1, 1, 1, 1, 1, 1, 1, 1, 1, 1, 1, 1, 1, 2, 2, 2, 2, 1, 1, 2, 2, 1, 1, 3, 3, 3, 1, 1, 1]","[]","[]",42,0,42,1
8071,"['periferia', 'periferia', 'precandidato', 'saudar', 'tucano']","[2, 2, 1, 1, 1]","[]","[]",5,0,5,1
8072,"['atuacao', 'edson', 'especialment', 'fachin', 'impactar', 'julgamento', 'mudanca', 'plenario', 'supremo', 'unanimidad']","[1, 1, 1, 1, 1, 1, 1, 1, 1, 1]","[]","[]",10,0,10,1
8073,"['comissao', 'confederacao', 'congresso', 'demanda', 'emergenciai', 'enfrentamento', 'medida', 'plano', 'plano', 'risco']","[1, 1, 1, 1, 1, 1, 1, 2, 2, 1]","[]","[]",10,0,10,1
8075,"['anuncio', 'anuncio', 'anuncio', 'apostar', 'importancia', 'importancia', 'necessario', 'ricardo', 'risco', 'situacao', 'sorocaba']","[3, 3, 3, 1, 2, 2, 1, 1, 1, 1, 1]","['caixao', 'caixao', 'circular', 'espalhar', 'imagem', 'imagem', 'imagem']","[2, 2, 1, 1, 3, 3, 3]",11,7,18,1
8077,"['acumular', 'decorrencia', 'expressivo', 'fluminens', 'investigacao', 'levantamento']","[1, 1, 1, 1, 1, 1]","[]","[]",6,0,6,1
8078,"[]","[]","[]","[]",0,0,0,1
8080,"['anteriorment', 'atuacao', 'autoridad', 'crise', 'entregu', 'epidemiologico', 'inquerito', 'investigacao', 'none', 'none', 'none', 'pedido', 'pedido', 'pedido', 'plano', 'plano', 'preliminar', 'preliminar', 'prioridad', 'relacao', 'sido', 'situacao']","[1, 1, 1, 1, 1, 1, 1, 1, 3, 3, 3, 3, 3, 3, 2, 2, 2, 2, 1, 1, 1, 1]","['arquivar', 'versao']","[1, 1]",22,2,24,1
8086,"['conflito', 'instituto', 'mexico', 'mexico', 'mexico']","[1, 1, 3, 3, 3]","['quantum']","[1]",5,1,6,1
8087,"['concorrent', 'dosar', 'inicialment', 'oficialment']","[1, 1, 1, 1]","[]","[]",4,0,4,1
8091,"['arthur', 'lira', 'recurso', 'resistencia', 'rocha']","[1, 1, 1, 1, 1]","[]","[]",5,0,5,1
8094,"['atuam', 'boletim', 'epidemiologico', 'infectar', 'infectar', 'infectar', 'infectar', 'intensivo', 'internacao', 'saudar', 'saudar', 'ventilacao']","[1, 1, 1, 4, 4, 4, 4, 1, 1, 2, 2, 1]","['menino']","[1]",12,1,13,1
8095,"['afp', 'contribuicao', 'equipamento', 'equipamento', 'espanha', 'espanha', 'europeu', 'europeu', 'gabinet', 'humanitario', 'humanitario', 'humanitario', 'implementar', 'sabado', 'saneamento', 'suprimento']","[1, 1, 2, 2, 2, 2, 2, 2, 1, 3, 3, 3, 1, 1, 1, 1]","[]","[]",16,0,16,1
8096,"['adesao', 'adesao', 'apurar', 'articulacao', 'articulacao', 'comissao', 'decisao', 'desafiar', 'inquerito', 'ministrar', 'necessario', 'pacheco', 'planalto', 'plenario', 'plenario', 'requerimento', 'requerimento', 'saudar', 'supremo', 'supremo']","[2, 2, 1, 2, 2, 1, 1, 1, 1, 1, 1, 1, 1, 2, 2, 2, 2, 1, 2, 2]","['legendar']","[1]",20,1,21,1
8098,"['consorcio', 'diariament', 'epidemia', 'levantamento', 'michael', 'monitoramento', 'profissionai', 'situacao']","[1, 1, 1, 1, 1, 1, 1, 1]","[]","[]",8,0,8,1
8099,"['administrativo', 'argumentar', 'cnmp', 'cnmp', 'exercicio', 'inquerito', 'investigacao', 'julgamento', 'julgamento', 'justicar', 'pulmonar', 'suspensao', 'turma', 'ventilador']","[1, 1, 2, 2, 1, 1, 1, 2, 2, 1, 1, 1, 1, 1]","[]","[]",14,0,14,1
8100,"['depoimento', 'gabinet', 'inicialment', 'paralelo', 'plenario', 'respostar', 'saudar']","[1, 1, 1, 1, 1, 1, 1]","[]","[]",7,0,7,1
8105,"['anuncio', 'conformar', 'intensivo', 'internacao', 'martim', 'oficialment', 'projeco', 'quadro', 'reuniao', 'saudar', 'saudar']","[1, 1, 1, 1, 1, 1, 1, 1, 1, 2, 2]","['tumulo']","[1]",11,1,12,1
8106,"['academico', 'alunar', 'destacar', 'entendimento', 'espanha', 'kassio', 'magistrado', 'paralelo', 'randolf', 'randolf', 'universitario']","[1, 1, 1, 1, 1, 1, 1, 1, 2, 2, 1]","['atribuir', 'realment']","[1, 1]",11,2,13,1
8109,"['autoridad', 'colleg', 'condicao', 'exministro']","[1, 1, 1, 1]","['manipulacao', 'misturar']","[1, 1]",4,2,6,1
8111,"['intensivo', 'intensivo', 'intubacao', 'intubacao', 'preocupacao', 'respirador']","[2, 2, 2, 2, 1, 1]","['compartilhar', 'pelar']","[1, 1]",6,2,8,1
8112,"['anticorpo', 'anticorpo', 'anticorpo', 'desenvolvido', 'etapa', 'fase', 'fase', 'imunizacao', 'parceria', 'respectivament', 'respostar']","[3, 3, 3, 1, 1, 2, 2, 1, 1, 1, 1]","[]","[]",11,0,11,1
8113,"['disseminacao', 'equivalent', 'mergulhar', 'quedo']","[1, 1, 1, 1]","[]","[]",4,0,4,1
8123,"['congresso', 'congresso', 'discussao', 'estrategia', 'estrategia', 'importancia', 'porqu', 'proprio', 'sendo']","[2, 2, 1, 2, 2, 1, 1, 1, 1]","[]","[]",9,0,9,1
8128,"['elaborar', 'implementar', 'infectar', 'infectar', 'planar', 'prever', 'prever', 'quarentenar', 'quarentenar', 'quarentenar', 'rastreamento', 'reuniao']","[1, 1, 2, 2, 1, 2, 2, 3, 3, 3, 1, 1]","[]","[]",12,0,12,1
8129,"['mudanca']","[1]","['bandeiro', 'imagem', 'imagem']","[1, 2, 2]",1,3,4,1
8130,"['posicionamento', 'saudar']","[1, 1]","['compartilhar', 'imagem']","[1, 1]",2,2,4,1
8131,"['jornada', 'porqu', 'relacao']","[1, 1, 1]","[]","[]",3,0,3,1
8132,"['competicao', 'decisao', 'economia', 'enxergar', 'europeu', 'iniciativo', 'necessario', 'possibilidad', 'preocupacao', 'realizacao', 'saudar', 'suspenso', 'tornear', 'treinamento', 'treino', 'viagem']","[1, 1, 1, 1, 1, 1, 1, 1, 1, 1, 1, 1, 1, 1, 1, 1]","[]","[]",16,0,16,1
8133,"['arthur', 'broadcast', 'colegiado', 'comissao', 'congresso', 'flavia', 'instalacao', 'jantar', 'legislativo', 'lira', 'lira', 'ppal', 'prioridad', 'sabado', 'sessao']","[1, 1, 1, 1, 1, 1, 1, 1, 1, 2, 2, 1, 1, 1, 1]","['biblia', 'soltar']","[1, 1]",15,2,17,1
8134,"['adotada', 'circulacao', 'conjuntar', 'decisao', 'gripezinha', 'possibilidad', 'quarentenar', 'republico', 'saudar', 'situacao', 'situacao']","[1, 1, 1, 1, 1, 1, 1, 1, 1, 2, 2]","['cbn']","[1]",11,1,12,1
8136,"['anuncio', 'biliao', 'decorrencia', 'mandatario', 'reuniao', 'videoconferencia']","[1, 1, 1, 1, 1, 1]","[]","[]",6,0,6,1
8139,"['condicao', 'exercicio', 'exercicio', 'necessario', 'quarentenar', 'sabado', 'sabado', 'superar']","[1, 2, 2, 1, 1, 2, 2, 1]","['circular']","[1]",8,1,9,1
8142,"['broadcast', 'comparacao', 'confederacao', 'disseminacao', 'estrategia', 'respostar', 'restritivo']","[1, 1, 1, 1, 1, 1, 1]","['compartilhar', 'filmar']","[1, 1]",7,2,9,1
8143,"['acompanhamento', 'autorizacao', 'fase', 'fluminens', 'instituto', 'intensivo', 'intenso', 'internar', 'negativar', 'transferir', 'vigilancia', 'vigilancia']","[1, 1, 1, 1, 1, 1, 1, 1, 1, 1, 2, 2]","['amigar', 'camisa']","[1, 1]",12,2,14,1
8144,"['avancar', 'circulacao', 'constituicao', 'integro', 'investigacao', 'manutencao', 'palacio', 'planalto', 'supremo']","[1, 1, 1, 1, 1, 1, 1, 1, 1]","[]","[]",9,0,9,1
8145,"['dinamarca', 'fronteiro', 'habitant', 'infectar', 'temporada', 'temporada', 'turista', 'turista', 'turista', 'turistico', 'viagem']","[1, 1, 1, 1, 2, 2, 3, 3, 3, 1, 1]","['espalhar']","[1]",11,1,12,1
8146,"['antonio', 'cenario', 'cnmp', 'cnmp', 'economia', 'impactar', 'justicar', 'pereira', 'prever', 'saudar', 'servidor']","[1, 1, 2, 2, 1, 1, 1, 1, 1, 1, 1]","[]","[]",11,0,11,1
8148,"['biliao', 'biliao', 'biliao', 'biliao', 'biliao', 'destinar', 'economia', 'economia', 'epidemiar', 'epidemiar', 'inicialment', 'ministrar', 'planar', 'prever', 'prever', 'totalizar']","[5, 5, 5, 5, 5, 1, 2, 2, 2, 2, 1, 1, 1, 2, 2, 1]","['manobrar']","[1]",16,1,17,1
8149,"[]","[]","['mencao']","[1]",0,1,1,1
8155,"['estimativo', 'imunizacao', 'inicialment', 'intensivo', 'prever', 'prever', 'saudar', 'saudar', 'subir']","[1, 1, 1, 1, 2, 2, 2, 2, 1]","[]","[]",9,0,9,1
8157,"['atendido', 'comorbidad', 'contabilizar', 'folhar', 'infectar', 'internar', 'privar', 'saudar', 'spaulo']","[1, 1, 1, 1, 1, 1, 1, 1, 1]","[]","[]",9,0,9,1
8159,"['anticorpo', 'necessidad']","[1, 1]","['libertador']","[1]",2,1,3,1
8161,"['preocupacao', 'treino']","[1, 1]","[]","[]",2,0,2,1
8164,"['edson', 'interpretar', 'ministrar', 'palacio', 'planalto', 'recebido', 'saudar']","[1, 1, 1, 1, 1, 1, 1]","[]","[]",7,0,7,1
8165,"['amplo', 'biliao', 'broadcast', 'decisao', 'desenvolvimento', 'inovacao', 'recurso', 'recurso', 'recurso', 'republico', 'vetar', 'vetar', 'vetar']","[1, 1, 1, 1, 1, 1, 3, 3, 3, 1, 3, 3, 3]","[]","[]",13,0,13,1
8168,"['anvisa', 'desenvolvido', 'instituto', 'instituto', 'pedido', 'submetido', 'vigilancia']","[1, 1, 2, 2, 1, 1, 1]","[]","[]",7,0,7,1
8171,"[]","[]","[]","[]",0,0,0,1
8172,"['planar', 'prioritario', 'saudar']","[1, 1, 1]","[]","[]",3,0,3,1
8173,"['boletim', 'boletim', 'cirurgico', 'implementar', 'integro', 'internacao', 'internar', 'ministrar', 'ministrar', 'negativar', 'previsao', 'sabado', 'significativo', 'supremo', 'suspeito']","[2, 2, 1, 1, 1, 1, 1, 2, 2, 1, 1, 1, 1, 1, 1]","[]","[]",15,0,15,1
8174,"['folhar', 'parceria', 'realizacao', 'saudar', 'saudar', 'saudar', 'spaulo']","[1, 1, 1, 3, 3, 3, 1]","[]","[]",7,0,7,1
8175,"['celebrar', 'circulacao', 'companhia', 'machadar', 'machadar', 'ministrar', 'possibilidad', 'transmissao', 'viagem', 'voo']","[1, 1, 1, 2, 2, 1, 1, 1, 1, 1]","[]","[]",10,0,10,1
8180,"['adhanom', 'compromisso', 'contencao', 'contencao', 'destacar', 'diagnosticar', 'diplomata', 'equilibrio', 'isolar', 'necessario', 'preocupacao', 'reuniao', 'saudar', 'saudar', 'situacao', 'tedro', 'transmissao', 'vigilancia']","[1, 1, 2, 2, 1, 1, 1, 1, 1, 1, 1, 1, 2, 2, 1, 1, 1, 1]","[]","[]",18,0,18,1
8181,"['amplo', 'amplo', 'arthur', 'converso', 'demrj', 'estimular', 'estimular', 'estimular', 'estimular', 'liderar', 'lira', 'ppal']","[2, 2, 1, 1, 1, 4, 4, 4, 4, 1, 1, 1]","[]","[]",12,0,12,1
8182,"['conformar', 'distrito', 'excecao', 'flavio', 'juro', 'juro', 'juro', 'juro', 'levantamento', 'republicanosrj', 'taxar', 'taxar', 'taxar', 'taxar']","[1, 1, 1, 1, 4, 4, 4, 4, 1, 1, 4, 4, 4, 4]","[]","[]",14,0,14,1
8184,"['rocha', 'sabado', 'suprimento']","[1, 1, 1]","[]","[]",3,0,3,1
8186,"['internacao', 'internar', 'internar']","[1, 2, 2]","[]","[]",3,0,3,1
8188,"['agravamento', 'alternativo', 'amplo', 'argumentar', 'atuacao', 'batalhar', 'cenario', 'compilar', 'coordenar', 'crise', 'decisao', 'desempenhar', 'dialogo', 'dialogo', 'dialogo', 'dificultar', 'disseminacao', 'elaborar', 'esperancar', 'esperancar', 'esperancar', 'esperancar', 'estrategia', 'implementacao', 'liderar', 'ministrar', 'nomeacao', 'orientacao', 'pastar', 'perspectivo', 'possibilidad', 'propagacao', 'rastreamento', 'recurso', 'rejeitar', 'republico', 'respostar', 'respostar', 'revisar', 'saudar', 'saudar', 'saudar', 'saudar', 'supremo', 'testagem']","[1, 1, 1, 1, 1, 1, 1, 1, 1, 1, 1, 1, 3, 3, 3, 1, 1, 1, 4, 4, 4, 4, 1, 1, 1, 1, 1, 1, 1, 1, 1, 1, 1, 1, 1, 1, 2, 2, 1, 4, 4, 4, 4, 1, 1]","['compartilhar']","[1]",45,1,46,1
8190,"['anteontem', 'anteontem', 'californio', 'crescimento', 'crescimento', 'decorrencia', 'ritmar', 'ritmar', 'subir', 'subir']","[2, 2, 1, 2, 2, 1, 2, 2, 2, 2]","[]","[]",10,0,10,1
8191,"['concedido', 'condicao', 'justicar', 'parceria', 'possibilidad', 'regulamentar', 'semestr']","[1, 1, 1, 1, 1, 1, 1]","[]","[]",7,0,7,1
8197,"['aglomeracao', 'integrant', 'sabado']","[1, 1, 1]","['espancar', 'garganta']","[1, 1]",3,2,5,1
8198,"['congresso', 'destinar', 'emprestimo', 'emprestimo', 'emprestimo', 'emprestimo', 'juro', 'pagamento', 'prazo', 'taxar']","[1, 1, 4, 4, 4, 4, 1, 1, 1, 1]","[]","[]",10,0,10,1
8199,"['periodo', 'recordar', 'saudar', 'saudar', 'saudar', 'subir']","[1, 1, 3, 3, 3, 1]","[]","[]",6,0,6,1
8202,"['congresso']","[1]","[]","[]",1,0,1,1
8206,"['infectar', 'monitoramento', 'mutacao', 'notificar', 'saudar', 'transmissao', 'variacao']","[1, 1, 1, 1, 1, 1, 1]","[]","[]",7,0,7,1
8207,"['converso']","[1]","[]","[]",1,0,1,1
8209,"['extraordinario', 'necessario', 'prazo', 'recuperacao', 'sustentabilidad']","[1, 1, 1, 1, 1]","[]","[]",5,0,5,1
8210,"['levantamento', 'liderar', 'proposto', 'respostar']","[1, 1, 1, 1]","['wagner']","[1]",4,1,5,1
8212,"['adversario', 'associacao', 'henriqu', 'integro', 'opcao', 'tucano', 'tucano']","[1, 1, 1, 1, 1, 2, 2]","['realment']","[1]",7,1,8,1
8213,"['fabricio', 'flavio', 'flavio', 'folhar', 'gabinet', 'gabinet', 'integro', 'investigacao', 'legislativo', 'queiroz', 'queiroz', 'queiroz', 'republicanosrj']","[1, 2, 2, 1, 2, 2, 1, 1, 1, 3, 3, 3, 1]","[]","[]",13,0,13,1
8215,"['acordo', 'escassez', 'fornecimento', 'fornecimento', 'interrupcao', 'milho', 'previsao', 'quatro', 'risco']","[1, 1, 2, 2, 1, 1, 1, 1, 1]","[]","[]",9,0,9,1
8217,"['aprovacao', 'aprovacao', 'economia', 'folhar', 'gued', 'instituto', 'ministrar', 'pagamento', 'posturar', 'subir']","[2, 2, 1, 1, 1, 1, 1, 1, 1, 1]","[]","[]",10,0,10,1
8219,"['anteriorment', 'colaboracao', 'complicacao', 'diagnosticar', 'liderar', 'moderno', 'recuperacao']","[1, 1, 1, 1, 1, 1, 1]","['espalhar']","[1]",7,1,8,1
8220,"['acordo', 'acordo', 'acordo', 'ambientar', 'aplicacao', 'augusto', 'autoridad', 'biliao', 'biliao', 'decisao', 'delacao', 'destinar', 'destinar', 'desvio', 'entregu', 'equipamento', 'exministro', 'exministro', 'fundacao', 'inicialment', 'justicar', 'justicar', 'justicar', 'justicar', 'justicar', 'levantamento', 'ministrar', 'ministrar', 'monitoramento', 'oswaldo', 'prever', 'prever', 'pulmonar', 'pulmonar', 'recurso', 'recurso', 'recurso', 'republico', 'respirador', 'respirador', 'saudar', 'saudar', 'saudar', 'saudar', 'sentenca', 'supremo', 'universitario', 'vieira']","[3, 3, 3, 1, 1, 1, 1, 2, 2, 1, 1, 2, 2, 1, 1, 1, 2, 2, 1, 1, 5, 5, 5, 5, 5, 1, 2, 2, 1, 1, 2, 2, 2, 2, 3, 3, 3, 1, 2, 2, 4, 4, 4, 4, 1, 1, 1, 1]","[]","[]",48,0,48,1
8222,"['afetado', 'aliviar', 'anuncio', 'anuncio', 'crise', 'destinar', 'etapa', 'periodo', 'planar', 'quarentenar', 'quarentenar', 'recuperacao', 'recuperacao', 'videoconferencia']","[1, 1, 2, 2, 1, 1, 1, 1, 1, 2, 2, 2, 2, 1]","[]","[]",14,0,14,1
8224,"['respostar']","[1]","[]","[]",1,0,1,1
8225,"['calamidad', 'confirmado', 'congresso', 'distrito', 'distrito', 'domingo', 'economia', 'monitoramento', 'relacao', 'suspeito', 'ultimo']","[1, 1, 1, 2, 2, 1, 1, 1, 1, 1, 1]","[]","[]",11,0,11,1
8227,"[]","[]","[]","[]",0,0,0,1
8230,"['anuncio', 'journal', 'publicitario']","[1, 1, 1]","['privacidad']","[1]",3,1,4,1
8231,"['adotada', 'anvisa', 'anvisa', 'cenario', 'prazo', 'vigilancia', 'vigilancia']","[1, 2, 2, 1, 1, 2, 2]","['cuspir']","[1]",7,1,8,1
8233,"['anvisa', 'anvisa', 'argumentar', 'consorcio', 'consorcio', 'decisao', 'exministro', 'importacao', 'iniciativo', 'machadar', 'machadar', 'motivacao', 'regiao', 'sputnik', 'vetar', 'vigilancia']","[2, 2, 1, 2, 2, 1, 1, 1, 1, 2, 2, 1, 1, 1, 1, 1]","[]","[]",16,0,16,1
8234,"['antonio', 'arthur', 'celso', 'domingo', 'empatar', 'empatar', 'empatar', 'exgovernador', 'margem', 'margem', 'margem', 'margem', 'margem', 'spaulo', 'tatto']","[1, 1, 1, 1, 3, 3, 3, 1, 5, 5, 5, 5, 5, 1, 1]","['numericament']","[1]",15,1,16,1
8235,"['condicao', 'flavio', 'liderar', 'liderar', 'monitoramento', 'posturar', 'saudar', 'treinamento']","[1, 1, 2, 2, 1, 1, 1, 1]","['libertador']","[1]",8,1,9,1
8237,"['anvisa', 'decisao', 'disseminacao', 'flavia', 'vigilancia']","[1, 1, 1, 1, 1]","['circular', 'compartilhar', 'imagem', 'parir']","[1, 1, 1, 1]",5,4,9,1
8242,"['autoridad', 'preventivo', 'propagacao', 'provincia', 'quarentenar']","[1, 1, 1, 1, 1]","[]","[]",5,0,5,1
8244,"['autoridad', 'domingo', 'embora', 'milho', 'provincia', 'proximo', 'sido', 'temor', 'tendencia']","[1, 1, 1, 1, 1, 1, 1, 1, 1]","[]","[]",9,0,9,1
8245,"['comorbidad', 'complicacao', 'condicao', 'condicao', 'decorrent', 'dificuldad', 'intubacao', 'piorar', 'respiratorio', 'saudar', 'ventilador']","[1, 1, 2, 2, 1, 1, 1, 1, 1, 1, 1]","['insinuar']","[1]",11,1,12,1
8247,"['intensivo', 'ministrar', 'piorar']","[1, 1, 1]","[]","[]",3,0,3,1
8248,"['aglomeracao', 'ambientar', 'colaboracao', 'espanha', 'espanha', 'europeu', 'europeu', 'europeu', 'excecao', 'fronteiro', 'fronteiro', 'primeiroministro', 'reabrir', 'reforcar', 'sabado', 'vulneravel']","[1, 1, 1, 2, 2, 3, 3, 3, 1, 2, 2, 1, 1, 1, 1, 1]","['circular']","[1]",16,1,17,1
8254,"['equivalent', 'fronteiro', 'infraestrutura', 'quilometro', 'regiao']","[1, 1, 1, 1, 1]","[]","[]",5,0,5,1
8256,"['aglomeracao', 'aglomeracao', 'ambientar', 'atuacao', 'atuacao', 'atuacao', 'barroso', 'colegiado', 'colegiado', 'cometido', 'decisao', 'demandar', 'demmg', 'depoimento', 'entendimento', 'especialment', 'especifico', 'funcionamento', 'governista', 'instalacao', 'instalacao', 'investigacao', 'martim', 'martim', 'nogueira', 'normalment', 'pacheco', 'pacheco', 'possibilidad', 'prazo', 'previsao', 'reforcar', 'regrar', 'supremo']","[2, 2, 1, 3, 3, 3, 1, 2, 2, 1, 1, 1, 1, 1, 1, 1, 1, 1, 1, 2, 2, 1, 2, 2, 1, 1, 2, 2, 1, 1, 1, 1, 1, 1]","[]","[]",34,0,34,1
8257,"['arthur', 'chefiar', 'cnj', 'demmg', 'enfrentamento', 'extraordinario', 'imunizacao', 'justicar', 'lira', 'lira', 'ministrar', 'ministrar', 'ministrar', 'ministrar', 'ministrar', 'pacheco', 'pacheco', 'palacio', 'pastar', 'pastar', 'planalto', 'presenca', 'prever', 'previsao', 'previsao', 'queiroga', 'queiroga', 'queiroga', 'queiroga', 'republico', 'reuniao', 'reuniao', 'saudar', 'saudar', 'saudar', 'saudar', 'saudar', 'secretarioexecutivo', 'semestr', 'semestr', 'semestr', 'totalizar', 'vespera']","[1, 1, 1, 1, 1, 1, 1, 1, 2, 2, 5, 5, 5, 5, 5, 2, 2, 1, 2, 2, 1, 1, 1, 2, 2, 4, 4, 4, 4, 1, 2, 2, 5, 5, 5, 5, 5, 1, 3, 3, 3, 1, 1]","[]","[]",43,0,43,1
8259,"['apurar', 'consecutivo', 'consecutivo', 'consorcio', 'consorcio', 'domingo', 'domingo', 'domingo', 'saudar', 'superar', 'tendencia']","[1, 2, 2, 2, 2, 3, 3, 3, 1, 1, 1]","[]","[]",11,0,11,1
8260,"['condenacao', 'especifico', 'isolar', 'justicar', 'kong', 'kong', 'kong', 'punicao', 'quarentenar', 'regrar', 'restritivo', 'restritivo', 'viajant']","[1, 1, 1, 1, 3, 3, 3, 1, 1, 1, 2, 2, 1]","['enderecar', 'enderecar']","[2, 2]",13,2,15,1
8264,"['comunitario', 'enquadrar', 'henriqu', 'ministrar', 'pastar', 'previo', 'realizacao', 'saudar', 'saudar', 'saudar', 'suspeito', 'testagem', 'transmissao', 'vigilancia', 'vigilancia']","[1, 1, 1, 1, 1, 1, 1, 3, 3, 3, 1, 1, 1, 2, 2]","[]","[]",15,0,15,1
8266,"['biliao', 'fux', 'fux', 'ministrar', 'ministrar', 'prorrogacao', 'recuperacao', 'supremo', 'suspenso', 'tesourar']","[1, 2, 2, 2, 2, 1, 1, 1, 1, 1]","[]","[]",10,0,10,1
8269,"['epidemiar', 'habito', 'saudar']","[1, 1, 1]","[]","[]",3,0,3,1
8271,"['conformar', 'converso', 'converso', 'curvo', 'decisao', 'diminuicao', 'ministrar', 'necessidad', 'pagamento', 'saudar', 'supremo']","[1, 2, 2, 1, 1, 1, 1, 1, 1, 1, 1]","['crer', 'realment']","[1, 1]",11,2,13,1
8278,"['comissao', 'comissao', 'constituicao', 'desempenhar', 'disseminacao', 'epidemiar', 'europeu', 'europeu', 'europeu', 'externo', 'externo', 'monitoramento', 'mudanca', 'portavoz', 'portavoz', 'proposto', 'reuter']","[2, 2, 1, 1, 1, 1, 3, 3, 3, 2, 2, 1, 1, 2, 2, 1, 1]","['espalhar']","[1]",17,1,18,1
8281,"['afastamento', 'afastamento', 'apreensao', 'decisao', 'decisao', 'decisao', 'goncalv', 'goncalv', 'goncalv', 'justicar', 'ministrar', 'ministrar', 'ministrar', 'necessario', 'sessao', 'sessao', 'wilson', 'witzel', 'witzel', 'witzel']","[2, 2, 1, 3, 3, 3, 3, 3, 3, 1, 3, 3, 3, 1, 2, 2, 1, 3, 3, 3]","[]","[]",20,0,20,1
8282,"['carla', 'comissao', 'crise', 'saudar', 'saudar']","[1, 1, 1, 2, 2]","['lixar']","[1]",5,1,6,1
8285,"['incerteza', 'opcao']","[1, 1]","[]","[]",2,0,2,1
8286,"['anvisa', 'anvisa', 'autoridad', 'autorizacao', 'autorizacao', 'desenvolvido', 'desenvolvido', 'especialment', 'importacao', 'importacao', 'imunizacao', 'instituto', 'insuficient', 'lewandowski', 'lewandowski', 'lewandowski', 'ministrar', 'ministrar', 'observar', 'planar', 'prazo', 'propagacao', 'reforcar', 'ricardo', 'ricardo', 'sputnik', 'sputnik', 'supremo', 'vigilancia']","[2, 2, 1, 2, 2, 2, 2, 1, 2, 2, 1, 1, 1, 3, 3, 3, 2, 2, 1, 1, 1, 1, 1, 2, 2, 2, 2, 1, 1]","[]","[]",29,0,29,1
8287,"['autoridad', 'comparacao', 'decorrencia', 'desenvolvido', 'dosar', 'dosar', 'hospitalizar', 'levantamento', 'moderno']","[1, 1, 1, 1, 2, 2, 1, 1, 1]","[]","[]",9,0,9,1
8289,"['alternativo', 'conformar', 'decisao', 'decisao', 'decisao', 'decisao', 'descumprimento', 'hospitalizar', 'justicar', 'magistrado', 'saudar', 'sentenca', 'transferencia', 'transferencia', 'transferir', 'transferir', 'varar']","[1, 1, 4, 4, 4, 4, 1, 1, 1, 1, 1, 1, 2, 2, 2, 2, 1]","[]","[]",17,0,17,1
8294,"['arthur', 'bancada', 'decisao', 'decisao', 'lira', 'lira', 'plenario', 'possibilidad', 'possibilidad', 'supremo']","[1, 1, 2, 2, 2, 2, 1, 2, 2, 1]","[]","[]",10,0,10,1
8295,"['conselho', 'decisao', 'decisao', 'decisao', 'diretoria', 'processo']","[1, 3, 3, 3, 1, 1]","[]","[]",6,0,6,1
8298,"['atendido', 'colegio', 'distrito', 'folhar', 'integro', 'oficio', 'requerimento', 'requerimento']","[1, 1, 1, 1, 1, 1, 2, 2]","[]","[]",8,0,8,1
8299,"['crise', 'dificuldad', 'reuniao']","[1, 1, 1]","['realment']","[1]",3,1,4,1
8301,"['avancar', 'desgastar', 'desmatamento', 'folhar', 'integro', 'mandatario', 'preservacao', 'preservar']","[1, 1, 1, 1, 1, 1, 1, 1]","[]","[]",8,0,8,1
8302,"['calculo', 'consequencia', 'crescimento', 'economia', 'economia', 'impactar', 'impactar', 'mexico', 'monetario', 'perspectivo', 'pib', 'prever', 'proporcao', 'quedo', 'quedo', 'respectivament', 'surtir']","[1, 1, 1, 2, 2, 2, 2, 1, 1, 1, 1, 1, 1, 2, 2, 1, 1]","[]","[]",17,0,17,1
8303,"['alteracao', 'complicacao', 'dificuldad', 'inedito', 'infectar', 'infectar', 'infectar', 'mudanca']","[1, 1, 1, 1, 3, 3, 3, 1]","[]","[]",8,0,8,1
8305,"['anteriorment', 'augusto', 'azevedo', 'crise', 'destacar', 'ministrar', 'ministrar', 'ministrar', 'republico', 'sobretudo']","[1, 1, 1, 1, 1, 3, 3, 3, 1, 1]","['indignacao', 'indignacao']","[2, 2]",10,2,12,1
8307,"['araujo', 'consumidor', 'parceria']","[1, 1, 1]","[]","[]",3,0,3,1
8308,"['apurar', 'celso', 'celso', 'depoimento', 'depoimento', 'inquerito', 'inquerito', 'inquerito', 'mello', 'mello', 'ministrar', 'ministrar', 'ministrar', 'ministrar', 'plenario', 'plenario', 'posicionamento', 'recurso', 'rejeitar', 'supremo']","[1, 2, 2, 2, 2, 3, 3, 3, 2, 2, 4, 4, 4, 4, 2, 2, 1, 1, 1, 1]","[]","[]",20,0,20,1
8309,"['avancar', 'importancia', 'isolar', 'letalidad', 'molecular', 'rastreamento', 'realizacao', 'realizacao', 'saudar', 'saudar', 'secretarioexecutivo']","[1, 1, 1, 1, 1, 1, 2, 2, 2, 2, 1]","[]","[]",11,0,11,1
8311,"['exercicio', 'externo', 'variacao', 'variacao']","[1, 1, 2, 2]","[]","[]",4,0,4,1
8312,"['bruno', 'proximo', 'quatro', 'ricardo']","[1, 1, 1, 1]","['crech', 'renunciar']","[1, 1]",4,2,6,1
8313,"['argumentar', 'lorenzoni', 'ministrar', 'onyx', 'onyx', 'possibilidad', 'reducao', 'republico', 'restritivo', 'secretariager', 'transmissao', 'transmissao', 'urbano']","[1, 1, 1, 2, 2, 1, 1, 1, 1, 1, 2, 2, 1]","['circular']","[1]",13,1,14,1
8316,"['anticorpo', 'infectar', 'observar', 'observar', 'respostar', 'significativo']","[1, 1, 2, 2, 1, 1]","['amplament', 'nasal']","[1, 1]",6,2,8,1
8317,"['apurar', 'conduta', 'constituicao', 'enquadrar', 'entendimento', 'expectativa', 'fase', 'tramitar']","[1, 1, 1, 1, 1, 1, 1, 1]","['greve', 'instrucao']","[1, 1]",8,2,10,1
8320,"['alckmin', 'ausencia', 'colegiado', 'contrato', 'contrato', 'contrato', 'decisao', 'entregu', 'exgovernador', 'geraldo', 'improbidad', 'sentenca', 'sessao']","[1, 1, 1, 3, 3, 3, 1, 1, 1, 1, 1, 1, 1]","[]","[]",13,0,13,1
8322,"['consolidar', 'consorcio', 'curvo', 'estabilidad', 'infectar', 'levantamento', 'quedo', 'quedo', 'quedo', 'saudar', 'situacao', 'tendencia', 'variacao', 'variacao']","[1, 1, 1, 1, 1, 1, 3, 3, 3, 1, 1, 1, 2, 2]","[]","[]",14,0,14,1
8324,"['aplicacao', 'irregularidad', 'julgamento', 'recurso', 'recurso', 'rejeitar', 'sigla']","[1, 1, 1, 2, 2, 1, 1]","[]","[]",7,0,7,1
8326,"['atendido', 'distrito', 'esquema', 'estrategia', 'observar', 'orientacao', 'prioritario', 'reuniao', 'revisar', 'saudar', 'saudar', 'vigilancia']","[1, 1, 1, 1, 1, 1, 1, 1, 1, 2, 2, 1]","[]","[]",12,0,12,1
8327,"['converso', 'henriqu', 'saudar']","[1, 1, 1]","[]","[]",3,0,3,1
8328,"['destaca', 'higienizacao', 'instituto', 'instituto', 'tambem', 'urbano']","[1, 1, 2, 2, 1, 1]","['preencher']","[1]",6,1,7,1
8329,"['atrasar', 'balancar', 'balancar', 'compilar', 'deteccao', 'dificuldad', 'notificar', 'respiratorio', 'saudar', 'saudar', 'suspeito', 'suspeito', 'suspeito', 'viagem']","[1, 2, 2, 1, 1, 1, 1, 1, 2, 2, 3, 3, 3, 1]","[]","[]",14,0,14,1
8332,"['alcolumbr', 'congresso', 'demap', 'demrj', 'legislativo']","[1, 1, 1, 1, 1]","[]","[]",5,0,5,1
8333,"['comissao', 'companhia', 'decisao', 'decisao', 'delacao', 'delacao', 'dificuldad', 'especializar', 'exgovernador', 'gabinet', 'geraldo', 'improbidad', 'legislativo', 'magistrado', 'magistrado', 'pagamento', 'parcelar', 'reuniao', 'transferencia', 'varar']","[1, 1, 2, 2, 2, 2, 1, 1, 1, 1, 1, 1, 1, 2, 2, 1, 1, 1, 1, 1]","[]","[]",20,0,20,1
8337,"['colunista', 'justicar']","[1, 1]","[]","[]",2,0,2,1
8338,"['carat', 'crise', 'desafiar', 'divergencia', 'feriar', 'integrant', 'integrant', 'planalto', 'silveiro', 'silveiro', 'supremo', 'temor']","[1, 1, 1, 1, 1, 2, 2, 1, 2, 2, 1, 1]","[]","[]",12,0,12,1
8339,"['agravamento', 'anteriorment', 'anticorpo', 'argumentar', 'cepa', 'cepa', 'circulacao', 'colaboracao', 'consorcio', 'contabilizar', 'depressa', 'desenvolvimento', 'destacar', 'destacar', 'disseminacao', 'facilitar', 'genoma', 'importancia', 'infectar', 'infectar', 'instituto', 'metropolitano', 'molecular', 'mutacao', 'mutacao', 'mutacao', 'mutacao', 'mutacao', 'mutacao', 'mutacao', 'notificar', 'observar', 'oficialment', 'periodo', 'preocupacao', 'recordar', 'reforcar', 'regiao', 'regiao', 'saudar', 'sigla', 'totalizar', 'transmissao', 'transmissao', 'transmissao', 'vigilancia']","[1, 1, 1, 1, 2, 2, 1, 1, 1, 1, 1, 1, 2, 2, 1, 1, 1, 1, 2, 2, 1, 1, 1, 7, 7, 7, 7, 7, 7, 7, 1, 1, 1, 1, 1, 1, 1, 2, 2, 1, 1, 1, 3, 3, 3, 1]","['compartilhar', 'replicar']","[1, 1]",46,2,48,1
8340,"['fase', 'remessar', 'sigla', 'submetido']","[1, 1, 1, 1]","['versao']","[1]",4,1,5,1
8344,"['cometido', 'exercicio', 'expectativa', 'flavio', 'funcao', 'funcao', 'humberto', 'justicar', 'ministrar', 'privilegiar', 'privilegiar', 'rachadinha', 'rachadinha', 'republicanosrj', 'republico', 'supremo', 'turma']","[1, 1, 1, 1, 2, 2, 1, 1, 1, 2, 2, 2, 2, 1, 1, 1, 1]","[]","[]",17,0,17,1
8345,"['ampliacao', 'consorcio', 'coreia', 'distrito', 'igualitario', 'instituto', 'previsao', 'prioritario', 'remessar', 'remessar', 'sabado', 'saudar', 'saudar', 'saudar', 'vigilancia']","[1, 1, 1, 1, 1, 1, 1, 1, 2, 2, 1, 3, 3, 3, 1]","[]","[]",15,0,15,1
8346,"['assistencia', 'assistencia', 'assistencia', 'conformar', 'desembarcar', 'dificuldad', 'dificuldad', 'distrito', 'enfrentamento', 'enfrentamento', 'equipamento', 'equipamento', 'equipamento', 'equipamento', 'estrategico', 'infectar', 'infectar', 'pulmonar', 'pulmonar', 'pulmonar', 'pulmonar', 'reforcar', 'reforcar', 'respiratorio', 'respiratorio', 'saudar', 'saudar', 'saudar', 'saudar', 'saudar', 'saudar', 'suportar', 'transmissao', 'velocidad', 'ventilador', 'ventilador', 'ventilador', 'ventilador', 'ventilador', 'ventilatorio']","[3, 3, 3, 1, 1, 2, 2, 1, 2, 2, 4, 4, 4, 4, 1, 2, 2, 4, 4, 4, 4, 2, 2, 2, 2, 6, 6, 6, 6, 6, 6, 1, 1, 1, 5, 5, 5, 5, 5, 1]","['ganhar']","[1]",40,1,41,1
8351,"['boletim', 'condicao', 'contabilizar', 'contabilizar', 'contagioso', 'crescimento', 'crescimento', 'curvo', 'curvo', 'domingo', 'epidemiologico', 'epidemiologico', 'impactar', 'indicador', 'patamar', 'quarentenar', 'reabertura', 'reducao', 'relaxamento', 'salao', 'saudar', 'tendencia', 'tendencia', 'totalizar', 'totalizar']","[1, 1, 2, 2, 1, 2, 2, 2, 2, 1, 2, 2, 1, 1, 1, 1, 1, 1, 1, 1, 1, 2, 2, 2, 2]","['quinzena']","[1]",25,1,26,1
8353,"['alergia', 'aprovacao', 'contrato', 'infeccioso', 'infeccioso', 'instituto', 'necessidad', 'reforcar']","[1, 1, 1, 2, 2, 1, 1, 1]","[]","[]",8,0,8,1
8355,"['conformar', 'consorcio', 'correspondent', 'dosar', 'dosar', 'dosar', 'levantamento', 'saudar']","[1, 1, 1, 3, 3, 3, 1, 1]","[]","[]",8,0,8,1
8356,"['epidemiar', 'isolar', 'reforcar', 'reforcar', 'regrar', 'surtir']","[1, 1, 2, 2, 1, 1]","['amigar']","[1]",6,1,7,1
8358,"['adotada', 'consecutivo', 'consecutivo', 'diminuicao', 'implementar', 'individuar', 'justificativo', 'relaxar', 'rigoroso', 'rigoroso', 'saudar', 'saudar', 'tedro']","[1, 2, 2, 1, 1, 1, 1, 1, 2, 2, 2, 2, 1]","['atribuir']","[1]",13,1,14,1
8360,"['afetado', 'afp', 'enquadrar', 'europeu', 'europeu', 'habitant', 'habitant', 'necessario', 'preocupacao', 'regiao', 'saudar', 'situacao', 'situacao', 'tendencia', 'vigilancia']","[1, 1, 1, 2, 2, 2, 2, 1, 1, 1, 1, 2, 2, 1, 1]","[]","[]",15,0,15,1
8362,"['crise', 'destinar', 'diariament', 'etapa', 'fundacao', 'guarulho', 'imunizacao', 'justicar', 'ministrar', 'oswaldo', 'prioridad', 'saudar', 'saudar', 'saudar', 'saudar', 'voo']","[1, 1, 1, 1, 1, 1, 1, 1, 1, 1, 1, 4, 4, 4, 4, 1]","[]","[]",16,0,16,1
8363,"['alcolumbr', 'alcolumbr', 'alcolumbr', 'ausencia', 'deltan', 'destacar', 'federar', 'forcatarefa', 'justicar', 'justicar', 'oferecido', 'supremo']","[3, 3, 3, 1, 1, 1, 1, 1, 2, 2, 1, 1]","[]","[]",12,0,12,1
8364,"['academico', 'ambientar', 'ambientar', 'ambientar', 'ambientar', 'ambientar', 'aplicacao', 'autorizacao', 'autorizacao', 'autorizacao', 'chefiar', 'compilar', 'conservacao', 'decisao', 'desmatamento', 'desmatamento', 'desmatamento', 'desmatamento', 'destacar', 'destacar', 'facilitar', 'federar', 'flexibilizacao', 'impactar', 'instituto', 'instituto', 'liderar', 'ministrar', 'mudanca', 'periodo', 'periodo', 'pratico', 'preservacao', 'proposto', 'recurso', 'reducao', 'regiao', 'regrar', 'relativo', 'respostar', 'reuniao', 'ricardo', 'sall', 'servidor', 'substituicao', 'taxar', 'triagem', 'ufrj']","[1, 5, 5, 5, 5, 5, 1, 3, 3, 3, 1, 1, 1, 1, 4, 4, 4, 4, 2, 2, 1, 1, 1, 1, 2, 2, 1, 1, 1, 2, 2, 1, 1, 1, 1, 1, 1, 1, 1, 1, 1, 1, 1, 1, 1, 1, 1, 1]","[]","[]",48,0,48,1
8366,"['acompanhamento', 'comparacao', 'domingo', 'epidemiar', 'letalidad', 'sabado', 'saudar', 'subir']","[1, 1, 1, 1, 1, 1, 1, 1]","[]","[]",8,0,8,1
8367,"['acompanhamento', 'balancar', 'saudar', 'saudar']","[1, 1, 2, 2]","[]","[]",4,0,4,1
8368,"['infectar', 'infectar', 'inglaterra', 'positivar', 'quarentenar', 'quarentenar', 'suspenso']","[2, 2, 1, 1, 2, 2, 1]","[]","[]",7,0,7,1
8369,"['fez', 'proximo', 'turma']","[1, 1, 1]","[]","[]",3,0,3,1
8371,"['desempenhar', 'economia', 'parcelar']","[1, 1, 1]","[]","[]",3,0,3,1
8378,"['atuam', 'conselho', 'curso', 'curso', 'imunizacao', 'imunizacao', 'milho', 'parceria', 'profissionai']","[1, 1, 2, 2, 2, 2, 1, 1, 1]","[]","[]",9,0,9,1
8381,"['aglomeracao', 'disseminacao', 'domingo', 'domingo', 'sabado', 'sabado', 'saudar', 'saudar', 'situacao', 'taxar']","[1, 1, 2, 2, 2, 2, 2, 2, 1, 1]","[]","[]",10,0,10,1
8384,"['concedido', 'destacar', 'diariament', 'infectar', 'prever', 'saudar', 'taxar']","[1, 1, 1, 1, 1, 1, 1]","[]","[]",7,0,7,1
8385,"['exgovernador', 'exministro', 'inquerito', 'inquerito', 'justicar', 'mendonca', 'ministrar', 'republico', 'secretariager']","[1, 1, 2, 2, 1, 1, 1, 1, 1]","[]","[]",9,0,9,1
8387,"['comunitario', 'regrar', 'relaxamento', 'saudar', 'surto', 'suspeito', 'transmissao', 'transmissao']","[1, 1, 1, 1, 1, 1, 2, 2]","[]","[]",8,0,8,1
8389,"['arthur', 'conduta', 'decisao', 'lira', 'mantido', 'manutencao', 'ministrar', 'ppal', 'pslrj', 'silveiro', 'silveiro', 'supremo']","[1, 1, 1, 1, 1, 1, 1, 1, 1, 2, 2, 1]","[]","[]",12,0,12,1
8399,"['complicacao', 'confederacao', 'domingo', 'internar', 'julgamento', 'piorar', 'saudar', 'saudar', 'situacao']","[1, 1, 1, 1, 1, 1, 2, 2, 1]","[]","[]",9,0,9,1
8401,"['apurar', 'espirito', 'periferia', 'reuniao']","[1, 1, 1, 1]","[]","[]",4,0,4,1
8404,"['republico', 'respostar']","[1, 1]","['menino']","[1]",2,1,3,1
8406,"['assistencia', 'conduta', 'especializar', 'fluxo', 'habito', 'implementacao', 'implementacao', 'internacao', 'internacao', 'jornada', 'mudanca', 'parceria', 'permanencia', 'permanencia', 'permanencia', 'pratico', 'regiao', 'rotina', 'saudar', 'saudar', 'saudar', 'saudar', 'situacao', 'situacao']","[1, 1, 1, 1, 1, 2, 2, 2, 2, 1, 1, 1, 3, 3, 3, 1, 1, 1, 4, 4, 4, 4, 2, 2]","['vazio', 'vazio', 'visualizar']","[2, 2, 1]",24,3,27,1
8407,"['distrito', 'justicar', 'ministrar', 'previsto', 'republico', 'supremo']","[1, 1, 1, 1, 1, 1]","[]","[]",6,0,6,1
8409,"['periodo', 'servidor', 'servidor']","[1, 2, 2]","['sequer']","[1]",3,1,4,1
8410,"['crise', 'henriqu', 'nelson', 'pratico', 'saudar', 'saudar', 'subordinar', 'teich', 'transmissao', 'vespera']","[1, 1, 1, 1, 2, 2, 1, 1, 1, 1]","[]","[]",10,0,10,1
8411,"['adotada', 'epidemiar', 'europeu', 'europeu', 'instaurar', 'necessario', 'primeiroministro', 'unanimidad']","[1, 1, 2, 2, 1, 1, 1, 1]","[]","[]",8,0,8,1
8413,"['reforcar', 'situacao', 'vulneravel']","[1, 1, 1]","[]","[]",3,0,3,1
8416,"['epicentro', 'epidemia', 'habitant', 'medida', 'preocupacao', 'provincia', 'provincia', 'provincia', 'provincia', 'regiao', 'tambem']","[1, 1, 1, 1, 1, 4, 4, 4, 4, 1, 1]","[]","[]",11,0,11,1
8418,"['alckmin', 'alckmin', 'alckmin', 'exgovernador', 'exgovernador', 'forcatarefa', 'geraldo', 'ideologico', 'inquerito', 'justicar', 'justicar', 'lavagem', 'lavagem', 'tucano']","[3, 3, 3, 2, 2, 1, 1, 1, 1, 2, 2, 2, 2, 1]","[]","[]",14,0,14,1
8419,"['espanha', 'hospitalizar', 'instituto', 'levantamento', 'saudar', 'saudar']","[1, 1, 1, 1, 2, 2]","[]","[]",6,0,6,1
8420,"['balancar', 'consorcio', 'distrito', 'dosar', 'dosar', 'folhar', 'parceria', 'sabado', 'spaulo', 'spaulo']","[1, 1, 1, 2, 2, 1, 1, 1, 2, 2]","[]","[]",10,0,10,1
8422,"['carla', 'gabinet', 'julgamento']","[1, 1, 1]","['abortar', 'estuprar', 'menino', 'minutar', 'vazar']","[1, 1, 1, 1, 1]",3,5,8,1
8427,"['aglomeracao', 'aglomeracao', 'complicacao', 'epidemiologico', 'impactar', 'percepcao', 'percepcao', 'risco', 'temporada', 'transmissao', 'turistico', 'universitario', 'vespera']","[2, 2, 1, 1, 1, 2, 2, 1, 1, 1, 1, 1, 1]","['amigar']","[1]",13,1,14,1
8432,"['diagnosticar', 'saudar']","[1, 1]","[]","[]",2,0,2,1
8434,"['bolsonarista', 'mandatario', 'sociai']","[1, 1, 1]","[]","[]",3,0,3,1
8438,"['acompanhamento', 'precisao', 'presenca', 'presenca', 'regiao', 'reportar', 'saneamento', 'saudar', 'situacao']","[1, 1, 2, 2, 1, 1, 1, 1, 1]","[]","[]",9,0,9,1
8439,"['comissao', 'comissao', 'investigacao', 'saudar', 'saudar', 'viagem']","[2, 2, 1, 2, 2, 1]","[]","[]",6,0,6,1
8440,"['californio', 'epicentro', 'florido', 'hospitalizacao', 'reportar', 'reportar', 'reuter', 'reuter', 'subir', 'subir', 'surtir']","[1, 1, 1, 1, 2, 2, 2, 2, 2, 2, 1]","[]","[]",11,0,11,1
8444,"['adhanom', 'colaborar', 'expressar', 'saudar', 'tedro']","[1, 1, 1, 1, 1]","[]","[]",5,0,5,1
8446,"['arrecadar', 'colleg', 'condicao', 'decisao', 'especializar', 'inglaterra', 'modelo', 'preparacao']","[1, 1, 1, 1, 1, 1, 1, 1]","[]","[]",8,0,8,1
8447,"['regiao', 'saudar', 'saudar', 'saudar', 'saudar']","[1, 4, 4, 4, 4]","[]","[]",5,0,5,1
8448,"['concorrent', 'concorrent', 'converso', 'oficialment', 'periodo', 'risco', 'treino']","[2, 2, 1, 1, 1, 1, 1]","['estranhar']","[1]",7,1,8,1
8450,"['barroso', 'disseminacao', 'integro', 'ministrar', 'parceria', 'suspeito']","[1, 1, 1, 1, 1, 1]","[]","[]",6,0,6,1
8451,"['carla', 'colunista', 'decisao', 'pagamento', 'provisorio']","[1, 1, 1, 1, 1]","[]","[]",5,0,5,1
8452,"['barroso', 'decisao', 'decisao', 'julgamento', 'julgamento', 'julgamento', 'ministrar', 'recurso', 'tramitar']","[1, 2, 2, 3, 3, 3, 1, 1, 1]","['abusar', 'arquivar']","[1, 1]",9,2,11,1
8453,"['conformar', 'funcao', 'globonew', 'globonew', 'instituto', 'justicar', 'pratico']","[1, 1, 2, 2, 1, 1, 1]","['imagem']","[1]",7,1,8,1
8454,"['adulto', 'autonomia', 'autonomia', 'autorizacao', 'carat', 'cenario', 'contemplar', 'decorrencia', 'demandar', 'enfrentamento', 'enfrentamento', 'infraestrutura', 'necessario', 'necessario', 'recurso', 'saudar', 'saudar', 'saudar', 'saudar', 'saudar', 'temporario']","[1, 2, 2, 1, 1, 1, 1, 1, 1, 2, 2, 1, 2, 2, 1, 5, 5, 5, 5, 5, 1]","[]","[]",21,0,21,1
8455,"['imunizacao', 'reuniao']","[1, 1]","[]","[]",2,0,2,1
8457,"['anticorpo', 'desenvolvido', 'estagio', 'estagio', 'fase', 'imunizacao', 'infectar', 'infectar', 'moderno', 'normalment', 'observar']","[1, 1, 2, 2, 1, 1, 2, 2, 1, 1, 1]","[]","[]",11,0,11,1
8458,"['acordo', 'aprovacao', 'associacao', 'bbc', 'concreto', 'confederacao', 'congresso', 'conjuntar', 'converso', 'intenso', 'liderar', 'motivacao', 'mudanca', 'necessidad', 'percepcao']","[1, 1, 1, 1, 1, 1, 1, 1, 1, 1, 1, 1, 1, 1, 1]","[]","[]",15,0,15,1
8460,"['balancar', 'consequencia', 'destacar', 'domingo', 'domingo', 'epidemiar', 'hospitalizar', 'hospitalizar', 'internar', 'quedo', 'quedo', 'reducao', 'respirador', 'saudar']","[1, 1, 1, 2, 2, 1, 2, 2, 1, 2, 2, 1, 1, 1]","[]","[]",14,0,14,1
8461,"['araujo', 'autoridad', 'bbc', 'bbc', 'conselho', 'cooperacao', 'desenvolvimento', 'ernesto', 'medida', 'mendonca', 'monitoramento', 'posicionamento', 'situacao']","[1, 1, 2, 2, 1, 1, 1, 1, 1, 1, 1, 1, 1]","[]","[]",13,0,13,1
8464,"['aspecto', 'cnj', 'condicao', 'contencao', 'decisao', 'enfrentamento', 'fux', 'fux', 'impactar', 'justicar', 'manutencao', 'ministrar', 'ministrar', 'necessario', 'situacao', 'sobretudo', 'urbano', 'vulnerabilidad']","[1, 1, 1, 1, 1, 1, 2, 2, 1, 1, 1, 2, 2, 1, 1, 1, 1, 1]","[]","[]",18,0,18,1
8470,"['saudar', 'saudar', 'subir', 'totalizar']","[2, 2, 1, 1]","[]","[]",4,0,4,1
8471,"['anvisa', 'bolsonarista', 'conformar', 'internar', 'republico', 'vigilancia']","[1, 1, 1, 1, 1, 1]","['postagen']","[1]",6,1,7,1
8472,"['adhanom', 'biliao', 'biliao', 'iniciativo', 'parceria', 'presenca', 'saudar', 'tedro', 'tedro']","[1, 2, 2, 1, 1, 1, 1, 2, 2]","[]","[]",9,0,9,1
8481,"['comorbidad', 'especialment', 'hipertensao', 'hospitalizacao', 'impactar', 'imunizacao', 'imunizacao', 'imunizacao', 'inclusao', 'planar', 'prioridad', 'prioritario', 'prioritario', 'saudar']","[1, 1, 1, 1, 1, 3, 3, 3, 1, 1, 1, 2, 2, 1]","[]","[]",14,0,14,1
8483,"['celso', 'folhar', 'rejeitar', 'spaulo']","[1, 1, 1, 1]","['renunciar']","[1]",4,1,5,1
8484,"['bolsonarista', 'fabricio', 'impulsionar', 'sigla']","[1, 1, 1, 1]","['soldar']","[1]",4,1,5,1
8488,"['empatar', 'margem', 'respectivament']","[1, 1, 1]","['numericament']","[1]",3,1,4,1
8489,"['oficio', 'pastar', 'reforcar', 'republico', 'saudar', 'saudar', 'saudar', 'volumar', 'volumar']","[1, 1, 1, 1, 3, 3, 3, 2, 2]","[]","[]",9,0,9,1
8490,"['crise', 'destacar', 'estatistico', 'minoria', 'minoria', 'sigla']","[1, 1, 1, 2, 2, 1]","[]","[]",6,0,6,1
8491,"['destinar', 'processo', 'proposto']","[1, 1, 1]","[]","[]",3,0,3,1
8493,"['antonio', 'colunista', 'complicacao', 'converso', 'exministro', 'lorenzoni', 'onyx', 'onyx', 'pastar', 'republico', 'republico', 'souza']","[1, 1, 1, 1, 1, 1, 2, 2, 1, 2, 2, 1]","[]","[]",12,0,12,1
8494,"['agravamento', 'chefiar', 'decisao', 'epidemiar', 'epidemiar', 'fronteiro', 'presenca', 'privar', 'propagacao', 'saudar', 'suspenso', 'turista', 'viagem', 'viagem']","[1, 1, 1, 2, 2, 1, 1, 1, 1, 1, 1, 1, 2, 2]","['amplament']","[1]",14,1,15,1
8496,"['afastamento', 'apurar', 'congresso', 'destinar', 'exercicio', 'recurso', 'roraima', 'supremo']","[1, 1, 1, 1, 1, 1, 1, 1]","['cedula']","[1]",8,1,9,1
8498,"['autoridad', 'colombio', 'desgastar', 'especifico', 'ministrar', 'ministrar', 'republico', 'supremo']","[1, 1, 1, 1, 2, 2, 1, 1]","['equador']","[1]",8,1,9,1
8499,"['alteracao', 'desenvolvimento', 'desenvolvimento', 'gabbardo', 'gabbardo', 'gabbardo', 'instituto', 'parceria']","[1, 2, 2, 3, 3, 3, 1, 1]","[]","[]",8,0,8,1
8501,"['coreia', 'infectar', 'reabrir', 'transmissao']","[1, 1, 1, 1]","[]","[]",4,0,4,1
8505,"['administrativo', 'antonio', 'antonio', 'argumentar', 'celso', 'concessionario', 'contrato', 'contrato', 'decisao', 'entendimento', 'improbidad', 'irregularidad', 'julgamento', 'justicar', 'magistrado', 'metropolitano', 'notificar', 'recurso', 'rejeicao', 'rejeitar']","[1, 2, 2, 1, 1, 1, 2, 2, 1, 1, 1, 1, 1, 1, 1, 1, 1, 1, 1, 1]","[]","[]",20,0,20,1
8508,"['consenso', 'crise', 'decisao', 'destac', 'embora', 'instituto', 'mantido', 'medida', 'modelo', 'modelo', 'possibilidad', 'presenca', 'recuar', 'serao', 'tambem', 'tambem', 'vigilancia']","[1, 1, 1, 1, 1, 1, 1, 1, 2, 2, 1, 1, 1, 1, 2, 2, 1]","[]","[]",17,0,17,1
8510,"['crise', 'economia', 'economia', 'impactar', 'planar', 'preocupacao', 'reducao']","[1, 2, 2, 1, 1, 1, 1]","['circular']","[1]",7,1,8,1
8514,"['atuacao', 'julgamento', 'justicar', 'observar', 'servidor', 'servidor', 'supremo', 'suspensao']","[1, 1, 1, 1, 2, 2, 1, 1]","['compartilhar']","[1]",8,1,9,1
8515,"['ambito', 'apreensao', 'contrato', 'equipamento', 'esquema', 'fase', 'forcatarefa', 'investigacao', 'irregularidad', 'nomeacao', 'preventivo', 'respirador', 'respirador', 'saudar', 'saudar', 'suspeito']","[1, 1, 1, 1, 1, 1, 1, 1, 1, 1, 1, 2, 2, 2, 2, 1]","['fraudar', 'ganhar']","[1, 1]",16,2,18,1
8516,"['argumentar', 'associacao', 'decisao', 'decisao', 'distrito', 'justicar']","[1, 1, 2, 2, 1, 1]","[]","[]",6,0,6,1
8517,"['diretoria', 'interino', 'ministrar', 'ministrar', 'nomeacao', 'nomeacao', 'saudar', 'saudar']","[1, 1, 2, 2, 2, 2, 2, 2]","[]","[]",8,0,8,1
8518,"['kassio', 'sabatino', 'supremo']","[1, 1, 1]","[]","[]",3,0,3,1
8520,"['adicionar', 'antonio', 'celebrar', 'isolar', 'positivar', 'quarentenar']","[1, 1, 1, 1, 1, 1]","[]","[]",6,0,6,1
8524,"['administrativo', 'administrativo', 'contrato', 'jornada', 'periodo', 'suspenso']","[2, 2, 1, 1, 1, 1]","[]","[]",6,0,6,1
8525,"['convencao', 'fundacao', 'precandidato', 'republico']","[1, 1, 1, 1]","['legendar']","[1]",4,1,5,1
8529,"['justicar']","[1]","['manchet']","[1]",1,1,2,1
8530,"['flavio', 'pslsp', 'republicanosrj']","[1, 1, 1]","['compartilhar']","[1]",3,1,4,1
8531,"['celebrar', 'companhia', 'crise', 'observar']","[1, 1, 1, 1]","[]","[]",4,0,4,1
8532,"['administrativo', 'argumentar', 'augusto', 'decisao', 'economia', 'estabilidad', 'impactar', 'justicar', 'lesao', 'lesao', 'necessario', 'pagamento', 'pagamento', 'pagamento', 'parcelar', 'parcelar', 'prorrogar', 'reflexo', 'regiao', 'ricardo', 'suspensao', 'varar']","[1, 1, 1, 1, 1, 1, 1, 1, 2, 2, 1, 3, 3, 3, 2, 2, 1, 1, 1, 1, 1, 1]","[]","[]",22,0,22,1
8536,"['azevedo', 'crise', 'cupula', 'ernesto', 'exonerar', 'inedito', 'ministrar', 'ministrar', 'ministrar', 'reuniao']","[1, 1, 1, 1, 1, 1, 3, 3, 3, 1]","[]","[]",10,0,10,1
8537,"['anteriorment', 'comorbidad', 'comorbidad', 'contemplar', 'dosar', 'especialment', 'hospitalizacao', 'impactar', 'imunizacao', 'iniciativo', 'operacionalizacao', 'planar', 'saudar', 'saudar']","[1, 2, 2, 1, 1, 1, 1, 1, 1, 1, 1, 1, 2, 2]","[]","[]",14,0,14,1
8540,"['apurar', 'enfermagem', 'pagamento', 'piorar', 'saudar', 'saudar', 'saudar']","[1, 1, 1, 1, 3, 3, 3]","['desligar']","[1]",7,1,8,1
8541,"['ambientar', 'comissao', 'integro', 'ministrar', 'ricardo', 'ricardo', 'sall', 'sall']","[1, 1, 1, 1, 2, 2, 2, 2]","[]","[]",8,0,8,1
8544,"['alcolumbr', 'alcolumbr', 'biliao', 'biliao', 'congresso', 'congresso', 'demap', 'economia', 'emendar', 'mantido', 'orcamentaria', 'palacio', 'planalto', 'reducao', 'regulamentar', 'vetar']","[2, 2, 2, 2, 2, 2, 1, 1, 1, 1, 1, 1, 1, 1, 1, 1]","[]","[]",16,0,16,1
8547,"['ansiedad', 'crise', 'marilia', 'presenca', 'regiao', 'saudad', 'saudar', 'temporariament']","[1, 1, 1, 1, 1, 1, 1, 1]","[]","[]",8,0,8,1
8548,"['anvisa', 'aprovacao', 'desenvolvido', 'esperancar', 'esperancar', 'esperancar', 'fundacao', 'fundacao', 'instituto', 'oswaldo', 'prever', 'prever', 'saudar', 'saudar', 'semestr', 'semestr', 'situacao', 'transferencia', 'vigilancia']","[1, 1, 1, 3, 3, 3, 2, 2, 1, 1, 2, 2, 2, 2, 2, 2, 1, 1, 1]","[]","[]",19,0,19,1
8549,"['aplicacao', 'argumentar', 'decisao', 'hospitalizar', 'orientacao', 'pastar', 'saudar', 'saudar', 'saudar']","[1, 1, 1, 1, 1, 1, 3, 3, 3]","['verificar']","[1]",9,1,10,1
8550,"['boletim', 'cepa', 'comportamento', 'epidemiologico', 'precaucao', 'quadro', 'risco', 'risco', 'risco', 'risco', 'risco']","[1, 1, 1, 1, 1, 1, 5, 5, 5, 5, 5]","[]","[]",11,0,11,1
8552,"['azevedo', 'ideologico', 'ideologico', 'lorenzoni', 'ministrar', 'ministrar', 'ministrar', 'onyx', 'palacio', 'percepcao', 'planalto']","[1, 2, 2, 1, 3, 3, 3, 1, 1, 1, 1]","[]","[]",11,0,11,1
8553,"['companhia', 'vulnerabilidad']","[1, 1]","[]","[]",2,0,2,1
8554,"['apreensao', 'apurar', 'bolsonarista', 'bolsonarista', 'domingo', 'inquerito', 'inquerito', 'investigacao', 'ministrar', 'oswaldo', 'republico', 'supremo', 'supremo', 'temporario']","[1, 1, 2, 2, 1, 2, 2, 1, 1, 1, 1, 2, 2, 1]","[]","[]",14,0,14,1
8556,"['condicao', 'destacar', 'intensivo', 'preocupacao']","[1, 1, 1, 1]","[]","[]",4,0,4,1
8558,"['boletim', 'caxia', 'caxia', 'duqu', 'duqu', 'funcao', 'goncalo', 'goncalo', 'periodo', 'redondo', 'saudar', 'suspeito']","[1, 2, 2, 2, 2, 1, 2, 2, 1, 1, 1, 1]","[]","[]",12,0,12,1
8559,"['celebrar', 'conflito', 'crise', 'crise', 'enxergar', 'liderar', 'necessidad', 'presenca', 'videoconferencia']","[1, 1, 2, 2, 1, 1, 1, 1, 1]","[]","[]",9,0,9,1
8561,"['academiar', 'estatistico', 'geografia', 'ibg', 'impacto', 'iniciativo', 'instituto', 'privar', 'privar', 'substituicao']","[1, 1, 1, 1, 1, 1, 1, 2, 2, 1]","['ideologia']","[1]",10,1,11,1
8562,"['absoluto', 'alcolumbr', 'alcolumbr', 'alcolumbr', 'alcolumbr', 'ambito', 'bandeirant', 'congresso', 'congresso', 'congresso', 'consecutivo', 'demap', 'palacio', 'planalto', 'possibilidad', 'republico']","[1, 4, 4, 4, 4, 1, 1, 3, 3, 3, 1, 1, 1, 1, 1, 1]","[]","[]",16,0,16,1
8563,"['dosar', 'dosar', 'hospitalizar', 'moderno']","[2, 2, 1, 1]","[]","[]",4,0,4,1
8564,"['argumentar', 'calendario', 'cerimoni', 'cerimonia', 'etapa', 'etapa', 'habito', 'implementacao', 'mudanca', 'mudanca', 'situacao', 'tendencia']","[1, 1, 1, 1, 2, 2, 1, 1, 2, 2, 1, 1]","['desfilar']","[1]",12,1,13,1
8565,"['disseminacao', 'espanha', 'temporada', 'transferencia']","[1, 1, 1, 1]","['parir']","[1]",4,1,5,1
8566,"['abordagem', 'equivalent', 'flexibilizacao', 'ministrar', 'ministrar', 'necessario', 'nelson', 'observar', 'orientacao', 'orientacao', 'relaxar', 'relaxar', 'saudar', 'teich', 'teich']","[1, 1, 1, 2, 2, 1, 1, 1, 2, 2, 2, 2, 1, 2, 2]","[]","[]",15,0,15,1
8567,"['decorrencia', 'habitant', 'habitant', 'mexico', 'taxar']","[1, 2, 2, 1, 1]","[]","[]",5,0,5,1
8570,"['ambientar', 'araujo', 'araujo', 'araujo', 'araujo', 'ausencia', 'cerimonia', 'cooperacao', 'diplomata', 'ernesto', 'ernesto', 'ernesto', 'especialment', 'ideologico', 'ideologico', 'integrant', 'itamarati', 'itamarati', 'palacio', 'parceiro', 'parceiro', 'pereira', 'planalto', 'posturar', 'presenca', 'pslsp', 'saudar', 'videoconferencia', 'videoconferencia']","[1, 4, 4, 4, 4, 1, 1, 1, 1, 3, 3, 3, 1, 2, 2, 1, 2, 2, 1, 2, 2, 1, 1, 1, 1, 1, 1, 2, 2]","['imagem']","[1]",29,1,30,1
8572,"['circulacao', 'economia', 'espanha', 'espanha', 'fronteiro', 'gabinet', 'inedito', 'portavoz', 'primeiroministro', 'prorrogacao', 'prorrogar', 'quarentenar', 'relaxar', 'reuniao', 'taxar', 'turista', 'viajant', 'voo']","[1, 1, 2, 2, 1, 1, 1, 1, 1, 1, 1, 1, 1, 1, 1, 1, 1, 1]","[]","[]",18,0,18,1
8574,"['aprovacao', 'constituicao', 'crise', 'descumprimento', 'despesa', 'emendar', 'enfrentamento', 'facilitar', 'mudanca', 'necessario', 'proposto', 'proposto', 'proposto', 'proposto', 'punicao', 'recurso', 'regrar']","[1, 1, 1, 1, 1, 1, 1, 1, 1, 1, 4, 4, 4, 4, 1, 1, 1]","['misturar']","[1]",17,1,18,1
8575,"['afetado', 'anvisa', 'congresso', 'cooperacao', 'domingo', 'fluxo', 'oficio', 'oficio', 'rocha', 'vigilancia']","[1, 1, 1, 1, 1, 1, 2, 2, 1, 1]","[]","[]",10,0,10,1
8578,"['administrativo', 'augusto', 'colegiado', 'integrant', 'integrant', 'minoria', 'republico', 'republico', 'republico']","[1, 1, 1, 2, 2, 1, 3, 3, 3]","[]","[]",9,0,9,1
8579,"['crise', 'demrj', 'destacar', 'discussao', 'globonew']","[1, 1, 1, 1, 1]","[]","[]",5,0,5,1
8580,"['antecipar', 'calendario', 'calendario', 'inicialment', 'prever']","[1, 2, 2, 1, 1]","[]","[]",5,0,5,1
8581,"['alvorar', 'coordenar', 'decisao', 'demmg', 'enfrentamento', 'pacheco', 'pacheco', 'palacio', 'republico', 'republico', 'reuniao', 'reuniao', 'vespera']","[1, 1, 1, 1, 1, 2, 2, 1, 2, 2, 2, 2, 1]","[]","[]",13,0,13,1
8583,"['alerj', 'concedido', 'conjuntar', 'depoimento', 'depoimento', 'flavio', 'henriqu', 'inquerito', 'interferencia', 'legislativo', 'oliveira', 'reforcar', 'suspeito']","[1, 1, 1, 2, 2, 1, 1, 1, 1, 1, 1, 1, 1]","[]","[]",13,0,13,1
8584,"['economia', 'inicialment', 'pagamento', 'prorrogar', 'transferencia']","[1, 1, 1, 1, 1]","[]","[]",5,0,5,1
8586,"[]","[]","[]","[]",0,0,0,1
8587,"['destacar', 'ventilacao', 'ventilacao']","[1, 2, 2]","[]","[]",3,0,3,1
8590,"['ambientar', 'ambientar', 'congresso', 'descumprimento', 'inovacao', 'ministrar', 'pratico', 'recurso', 'ricardo', 'sall', 'servidor', 'supremo']","[2, 2, 1, 1, 1, 1, 1, 1, 1, 1, 1, 1]","[]","[]",12,0,12,1
8592,"['circulacao', 'disseminacao', 'folhar', 'mandatario', 'reclamacao']","[1, 1, 1, 1, 1]","[]","[]",5,0,5,1
8593,"['apurar', 'cenario', 'competicao', 'competicao', 'crise', 'decorrencia', 'defendido', 'minimizar', 'planar', 'pratico', 'reducao', 'situacao', 'situacao']","[1, 1, 2, 2, 1, 1, 1, 1, 1, 1, 1, 2, 2]","['imagem']","[1]",13,1,14,1
8595,"['afastamento', 'afastamento', 'antonio', 'araujo', 'decisao', 'decisao', 'decisao', 'goncalv', 'goncalv', 'goncalv', 'humberto', 'justicar', 'martim', 'ministrar', 'ministrar', 'ministrar', 'necessario', 'preventivo', 'sessao', 'sessao', 'sessao', 'videoconferencia', 'wilson', 'wilson', 'witzel', 'witzel', 'witzel', 'witzel', 'witzel', 'witzel']","[2, 2, 1, 1, 3, 3, 3, 3, 3, 3, 1, 1, 1, 3, 3, 3, 1, 1, 3, 3, 3, 1, 2, 2, 6, 6, 6, 6, 6, 6]","['imagem']","[1]",30,1,31,1
8596,"['amplo', 'amplo', 'assistencia', 'decorrent', 'demandar', 'emendar', 'especifico', 'importancia', 'importancia', 'manutencao', 'saudar', 'saudar', 'saudar', 'suportar', 'surtir']","[2, 2, 1, 1, 1, 1, 1, 2, 2, 1, 3, 3, 3, 1, 1]","['implantar']","[1]",15,1,16,1
8598,"['ambito', 'inconsistencia', 'integro', 'irregularidad', 'operacionalizacao', 'saudar', 'suspeito']","[1, 1, 1, 1, 1, 1, 1]","[]","[]",7,0,7,1
8599,"['afp', 'demandar', 'demandar', 'piorar', 'prever']","[1, 2, 2, 1, 1]","[]","[]",5,0,5,1
8601,"['adesao', 'autoridad', 'consorcio', 'crise', 'epidemiar', 'instituto', 'patamar', 'republico', 'situacao', 'superar']","[1, 1, 1, 1, 1, 1, 1, 1, 1, 1]","[]","[]",10,0,10,1
8603,"['arthur', 'curvo', 'curvo', 'decisao', 'decisao', 'demmg', 'fux', 'lira', 'lira', 'ministrar', 'pacheco', 'plenario', 'ppal', 'pslrj', 'silveiro', 'silveiro', 'supremo', 'supremo', 'unanimidad']","[1, 2, 2, 2, 2, 1, 1, 2, 2, 1, 1, 1, 1, 1, 2, 2, 2, 2, 1]","[]","[]",19,0,19,1
8604,"['agravar', 'cenario', 'condicao', 'condicao', 'conjuntar', 'demandar', 'depressao', 'depressao', 'desafio', 'dificuldad', 'enfatizar', 'especifico', 'estimular', 'exercicio', 'hipertensao', 'importancia', 'investigacao', 'journal', 'liderar', 'limitacao', 'mergulhar', 'mudanca', 'parceiro', 'parceiro', 'periodo', 'piorar', 'quadro', 'saudar', 'saudar', 'saudar', 'situacao', 'situacao', 'sugestao', 'suportar', 'taxar']","[1, 1, 2, 2, 1, 1, 2, 2, 1, 1, 1, 1, 1, 1, 1, 1, 1, 1, 1, 1, 1, 1, 2, 2, 1, 1, 1, 3, 3, 3, 2, 2, 1, 1, 1]","[]","[]",35,0,35,1
8608,"['associacao', 'definitivo', 'necessidad', 'orientacao', 'pratico', 'pratico', 'reforcar', 'saudar']","[1, 1, 1, 1, 2, 2, 1, 1]","['compartilhar']","[1]",8,1,9,1
8611,"['ambientar', 'arthur', 'entendimento', 'epidemiologico', 'epidemiologico', 'estatistico', 'estrategico', 'exministro', 'painel', 'painel', 'saudar', 'saudar', 'saudar', 'saudar', 'saudar', 'vigilancia']","[1, 1, 1, 2, 2, 1, 1, 1, 2, 2, 5, 5, 5, 5, 5, 1]","['acidentar', 'fraudar', 'insinuar']","[1, 1, 1]",16,3,19,1
8612,"['competicao', 'competicao', 'decisao', 'domingo', 'domingo', 'domingo', 'ministrar', 'ministrar', 'ministrar', 'organizador', 'prever', 'regrar', 'regrar', 'temporada', 'temporada', 'tornear', 'vespera']","[2, 2, 1, 3, 3, 3, 3, 3, 3, 1, 1, 2, 2, 2, 2, 1, 1]","[]","[]",17,0,17,1
8614,"['desafio', 'destacar', 'dificultar', 'escassez', 'europeu', 'incerteza', 'observar', 'redondo', 'suprimento', 'surtir', 'surtir']","[1, 1, 1, 1, 1, 1, 1, 1, 1, 2, 2]","[]","[]",11,0,11,1
8615,"['convencao', 'funcao', 'inedito', 'recordar', 'regrar', 'subir']","[1, 1, 1, 1, 1, 1]","['obama', 'obama']","[2, 2]",6,2,8,1
8616,"['anvisa', 'aplicacao', 'aprovacao', 'argumentar', 'atrasar', 'autoridad', 'autorizacao', 'autorizacao', 'avancar', 'avancar', 'bastidor', 'calheiro', 'calheiro', 'calheiro', 'calheiro', 'calheiro', 'comissao', 'comissao', 'concedido', 'congresso', 'contrato', 'cupula', 'depoimento', 'depoimento', 'depoimento', 'depoimento', 'depoimento', 'depoimento', 'destinar', 'dosar', 'dosar', 'facilitar', 'fornecimento', 'fornecimento', 'fundacao', 'gabinet', 'governista', 'governista', 'importacao', 'inicialment', 'integrant', 'martim', 'martim', 'martim', 'martim', 'mdbal', 'mdbal', 'mdbal', 'necessario', 'oswaldo', 'palacio', 'palacio', 'paralelo', 'pastar', 'periodo', 'planalto', 'planalto', 'possibilidad', 'posturar', 'presenca', 'prever', 'prever', 'processo', 'propagacao', 'proposto', 'proposto', 'provisorio', 'provisorio', 'randolf', 'randolf', 'randolf', 'randolf', 'randolf', 'recebido', 'remessar', 'republicanosrj', 'republicanosrj', 'republico', 'republico', 'republico', 'republico', 'requerimento', 'requerimento', 'requerimento', 'requerimento', 'requerimento', 'requerimento', 'requerimento', 'requerimento', 'respostar', 'respostar', 'respostar', 'reuniao', 'reuniao', 'reuniao', 'reuniao', 'reuniao', 'reuniao', 'reuniao', 'reuniao', 'reuniao', 'reuniao', 'saudar', 'saudar', 'saudar', 'secom', 'secom', 'sessao', 'sessao', 'suspeito', 'trimestr', 'trimestr', 'trimestr', 'vieira', 'wajngarten', 'wajngarten', 'wajngarten', 'wajngarten', 'wajngarten', 'wajngarten', 'wajngarten', 'wajngarten', 'wajngarten', 'wajngarten', 'wajngarten', 'wajngarten', 'wajngarten', 'wajngarten', 'wajngarten', 'wajngarten', 'wajngarten', 'wajngarten', 'wajngarten', 'wajngarten', 'wajngarten', 'wajngarten']","[1, 1, 1, 1, 1, 1, 2, 2, 2, 2, 1, 5, 5, 5, 5, 5, 2, 2, 1, 1, 1, 1, 6, 6, 6, 6, 6, 6, 1, 2, 2, 1, 2, 2, 1, 1, 2, 2, 1, 1, 1, 4, 4, 4, 4, 3, 3, 3, 1, 1, 2, 2, 1, 1, 1, 2, 2, 1, 1, 1, 2, 2, 1, 1, 2, 2, 2, 2, 5, 5, 5, 5, 5, 1, 1, 2, 2, 4, 4, 4, 4, 8, 8, 8, 8, 8, 8, 8, 8, 3, 3, 3, 10, 10, 10, 10, 10, 10, 10, 10, 10, 10, 3, 3, 3, 2, 2, 2, 2, 1, 3, 3, 3, 1, 22, 22, 22, 22, 22, 22, 22, 22, 22, 22, 22, 22, 22, 22, 22, 22, 22, 22, 22, 22, 22, 22]","['mentiroso', 'narrativo', 'supostament']","[1, 1, 1]",136,3,139,1
8621,"['autoridad', 'comparacao', 'infectar', 'reforcar', 'reforcar', 'respostar', 'saudar']","[1, 1, 1, 2, 2, 1, 1]","['vitaminar', 'vitaminar', 'vitaminar', 'vitaminar']","[4, 4, 4, 4]",7,4,11,1
8624,"['ambito', 'condenacao', 'edson', 'fachin', 'jurista', 'mantido', 'ministrar', 'paralelo', 'prazo', 'prazo', 'prescricao', 'processo', 'proferir', 'proferir', 'sentenca', 'sentenca', 'supremo', 'varar']","[1, 1, 1, 1, 1, 1, 1, 1, 2, 2, 1, 1, 2, 2, 2, 2, 1, 1]","['atribuir']","[1]",18,1,19,1
8626,"['biliao', 'constatar', 'contencao', 'fluminens', 'impactar', 'impactar', 'instituto', 'mudanca', 'oswaldo', 'parceria', 'presenca', 'saneamento', 'saneamento', 'saneamento', 'saneamento', 'saudar', 'saudar']","[1, 1, 1, 1, 2, 2, 1, 1, 1, 1, 1, 4, 4, 4, 4, 2, 2]","[]","[]",17,0,17,1
8627,"['afp', 'afp', 'demandar', 'epidemiar', 'infectar', 'provincia', 'rotina']","[2, 2, 1, 1, 1, 1, 1]","[]","[]",7,0,7,1
8629,"['ausencia', 'decisao', 'decisao', 'decisao', 'epidemiologico', 'orientacao', 'reducao', 'risco', 'situacao']","[1, 3, 3, 3, 1, 1, 1, 1, 1]","['compartilhar', 'compartilhar']","[2, 2]",9,2,11,1
8630,"['domingo', 'espanha', 'infectar', 'recordar']","[1, 1, 1, 1]","[]","[]",4,0,4,1
8631,"['arrecadacao', 'biliao', 'economia', 'economia', 'economia', 'economia', 'gued', 'gued', 'gued', 'gued', 'integro', 'mantido', 'mantido', 'ministrar', 'ministrar', 'projecao', 'recuperacao', 'recuperacao', 'subir', 'subir']","[1, 1, 4, 4, 4, 4, 4, 4, 4, 4, 1, 2, 2, 2, 2, 1, 2, 2, 2, 2]","['imagem']","[1]",20,1,21,1
8633,"['autorizacao', 'chefiar', 'conformar', 'domingo', 'nomeacao', 'republico', 'varar']","[1, 1, 1, 1, 1, 1, 1]","[]","[]",7,0,7,1
8634,"['cenario', 'cerimonia', 'destacar', 'domingo', 'domingo', 'expectativa', 'importancia', 'jorg', 'mudanca', 'oliveira', 'periodo', 'presenca', 'presidir', 'propagacao', 'situacao']","[1, 1, 1, 2, 2, 1, 1, 1, 1, 1, 1, 1, 1, 1, 1]","['padrar']","[1]",15,1,16,1
8636,"['empatar', 'tucano']","[1, 1]","[]","[]",2,0,2,1
8637,"['apurar', 'esquema', 'esquema', 'fabricio', 'flavio', 'flavio', 'flavio', 'flavio', 'gabinet', 'gabinet', 'investigacao', 'julgamento', 'julgamento', 'justicar', 'legislativo', 'ministrar', 'ministrar', 'processo', 'queiroz', 'rachadinha', 'rachadinha', 'recurso', 'recurso', 'republicanosrj', 'resolucao', 'ribeiro', 'sessao', 'sessao', 'turma', 'turma']","[1, 2, 2, 1, 4, 4, 4, 4, 2, 2, 1, 2, 2, 1, 1, 2, 2, 1, 1, 2, 2, 2, 2, 1, 1, 1, 2, 2, 2, 2]","[]","[]",30,0,30,1
8638,"['aliquota', 'anuncio', 'biliao', 'biliao', 'conjuntar', 'contribuicao', 'contribuicao', 'contribuicao', 'crise', 'disseminacao', 'fluxo', 'impactar', 'iniciativo', 'palacio', 'planalto', 'prazo', 'prorrogacao', 'reuter', 'tributario']","[1, 1, 2, 2, 1, 3, 3, 3, 1, 1, 1, 1, 1, 1, 1, 1, 1, 1, 1]","[]","[]",19,0,19,1
8639,"['anteriorment', 'interino', 'interino', 'ministrar', 'ministrar', 'nelson', 'nomeacao', 'pastar', 'pastar', 'republico', 'saudar', 'saudar', 'saudar', 'teich']","[1, 2, 2, 2, 2, 1, 1, 2, 2, 1, 3, 3, 3, 1]","[]","[]",14,0,14,1
8643,"['administrativo', 'contabilizar', 'desempenhar', 'economia', 'federar', 'federar', 'federar', 'federar', 'pastar', 'servidor', 'servidor', 'servidor', 'servidor']","[1, 1, 1, 1, 4, 4, 4, 4, 1, 4, 4, 4, 4]","[]","[]",13,0,13,1
8644,"['notificar', 'regiao', 'regiao', 'reuter', 'reuter', 'sabado', 'superar']","[1, 2, 2, 2, 2, 1, 1]","[]","[]",7,0,7,1
8647,"[]","[]","['intitular', 'visualizacao']","[1, 1]",0,2,2,1
8648,"['coletivo', 'coletivo', 'condicao', 'corpu', 'decisao', 'decisao', 'demandar', 'desvio', 'fabricio', 'flavio', 'fundamentar', 'habea', 'humanitario', 'inquerito', 'justicar', 'justicar', 'justificativo', 'legislativo', 'ministrar', 'oliveira', 'plantao', 'preventivo', 'preventivo', 'preventivo', 'queiroz', 'queiroz', 'queiroz', 'recurso', 'saudar', 'situacao', 'situacao', 'substituicao', 'transferir']","[2, 2, 1, 1, 2, 2, 1, 1, 1, 1, 1, 1, 1, 1, 2, 2, 1, 1, 1, 1, 1, 3, 3, 3, 3, 3, 3, 1, 1, 2, 2, 1, 1]","[]","[]",33,0,33,1
8650,"['ambientar', 'apurar', 'apurar', 'bastidor', 'bolsonarista', 'bolsonarista', 'congresso', 'depoimento', 'depoimento', 'inquerito', 'integrant', 'interferencia', 'julgamento', 'julgamento', 'oficialment', 'prever', 'previsto', 'pslrj', 'sessao', 'silveiro', 'silveiro', 'supremo', 'supremo', 'tendencia']","[1, 2, 2, 1, 2, 2, 1, 2, 2, 1, 1, 1, 2, 2, 1, 1, 1, 1, 1, 2, 2, 2, 2, 1]","[]","[]",24,0,24,1
8652,"['ampliacao', 'bolsonarista', 'bolsonarista', 'claudio', 'fundacao', 'impulsionar', 'levantamento', 'parcelar', 'prtb', 'republico', 'varga']","[1, 2, 2, 1, 1, 1, 1, 1, 1, 1, 1]","[]","[]",11,0,11,1
8656,"['autoridad', 'cerimonia', 'consecutivo', 'domingo', 'fornecimento', 'integro', 'mandatario', 'sabado']","[1, 1, 1, 1, 1, 1, 1, 1]","[]","[]",8,0,8,1
8657,"['acompanhamento', 'anvisa', 'anvisa', 'comissao', 'congresso', 'desenvolvimento', 'interino', 'interino', 'ministrar', 'ministrar', 'requerimento', 'respostar', 'reuniao', 'saudar', 'situacao', 'vigilancia']","[1, 2, 2, 1, 1, 1, 2, 2, 2, 2, 1, 1, 1, 1, 1, 1]","[]","[]",16,0,16,1
8658,"['circulacao', 'enfrentamento', 'manutencao', 'proposto', 'provisorio', 'provisorio', 'regrar', 'rejeitar', 'supremo']","[1, 1, 1, 1, 2, 2, 1, 1, 1]","[]","[]",9,0,9,1
8663,"['autorizacao', 'calendario', 'oficialment', 'pastar', 'previsto', 'requerimento', 'situacao']","[1, 1, 1, 1, 1, 1, 1]","[]","[]",7,0,7,1
8665,"['autoridad', 'medida', 'prazo', 'situacao', 'sociai', 'tambem']","[1, 1, 1, 1, 1, 1]","[]","[]",6,0,6,1
8667,"['anuncio', 'atrasar', 'desenvolvido', 'imunizacao', 'instituto', 'materiaprima', 'parceria', 'previsto', 'remessar', 'temporario']","[1, 1, 1, 1, 1, 1, 1, 1, 1, 1]","[]","[]",10,0,10,1
8671,"['afetado', 'armazenamento', 'client', 'client', 'client', 'companhia', 'companhia', 'consumidor', 'especializar', 'justicar', 'notificar', 'suportar']","[1, 1, 3, 3, 3, 2, 2, 1, 1, 1, 1, 1]","[]","[]",12,0,12,1
8680,"['client', 'condicao', 'quarentenar', 'regiao', 'regrar']","[1, 1, 1, 1, 1]","['protestar']","[1]",5,1,6,1
8681,"['decisao', 'depoimento', 'exministro', 'exministro', 'henriqu', 'paralelo', 'presenca', 'reuniao', 'reuniao', 'saudar', 'saudar']","[1, 1, 2, 2, 1, 1, 1, 2, 2, 2, 2]","[]","[]",11,0,11,1
8683,"['atuacao', 'barroso', 'barroso', 'barroso', 'barroso', 'dificuldad', 'domingo', 'globonew', 'intenso', 'minimizar', 'parceria', 'parceria', 'preocupacao', 'preventivo', 'sabado', 'saudar']","[1, 4, 4, 4, 4, 1, 1, 1, 1, 1, 2, 2, 1, 1, 1, 1]","[]","[]",16,0,16,1
8684,"['ansiedad', 'consolidar', 'crise', 'crise', 'desafio', 'equilibrio', 'impactar', 'importancia', 'importancia', 'inedito', 'moderno', 'periodo', 'periodo', 'periodo', 'saudar']","[1, 1, 2, 2, 1, 1, 1, 2, 2, 1, 1, 3, 3, 3, 1]","['realment']","[1]",15,1,16,1
8686,"['aprovacao', 'autorizacao', 'desenvolvido', 'imunizacao', 'ministrar', 'ministrar', 'saudar']","[1, 1, 1, 1, 2, 2, 1]","[]","[]",7,0,7,1
8690,"['afetado', 'necessario', 'suportar']","[1, 1, 1]","['usuario', 'versao', 'versao']","[1, 2, 2]",3,3,6,1
8691,"['acordo', 'boletim', 'contabilizar', 'decorrencia', 'espanha', 'europeu', 'ministrar', 'necessidad', 'passageiro', 'quarentenar', 'reabertura', 'saudar', 'subir', 'viagem']","[1, 1, 1, 1, 1, 1, 1, 1, 1, 1, 1, 1, 1, 1]","[]","[]",14,0,14,1
8694,"['prever']","[1]","[]","[]",1,0,1,1
8697,"['aglomeracao', 'complicacao', 'diagnosticar', 'jorg', 'margem', 'sabado', 'sabado']","[1, 1, 1, 1, 1, 2, 2]","['amigar', 'amigar', 'amigar', 'sacar']","[3, 3, 3, 1]",7,4,11,1
8698,"['agravamento', 'avancar', 'conformar', 'decisao', 'espirito', 'funcionamento', 'funcionamento', 'inicialment', 'integro', 'manutencao', 'manutencao', 'reducao', 'risco', 'ritmar', 'saudar', 'saudar', 'saudar', 'sputnik']","[1, 1, 1, 1, 1, 2, 2, 1, 1, 2, 2, 1, 1, 1, 3, 3, 3, 1]","[]","[]",18,0,18,1
8699,"['adulto', 'decorrencia', 'especialment', 'medida', 'milho', 'necessidad', 'parcela', 'proximo', 'recurso', 'roraima', 'sendo']","[1, 1, 1, 1, 1, 1, 1, 1, 1, 1, 1]","[]","[]",11,0,11,1
8700,"['concedido', 'henriqu', 'republico', 'tucano']","[1, 1, 1, 1]","[]","[]",4,0,4,1
8703,"['afp', 'antonio', 'autoridad', 'decisao', 'europeu', 'gabinet', 'negativar', 'palacio', 'positivar', 'primeiroministro', 'quarentenar', 'sabado', 'saudar', 'semestr']","[1, 1, 1, 1, 1, 1, 1, 1, 1, 1, 1, 1, 1, 1]","[]","[]",14,0,14,1
8704,"['apurar', 'biliao', 'biliao', 'biliao', 'biliao', 'comissao', 'conformar', 'congresso', 'cronica', 'destinar', 'determinacao', 'domingo', 'domingo', 'emendar', 'emendar', 'emendar', 'enfrentamento', 'enfrentamento', 'estimular', 'fase', 'henriqu', 'ministrar', 'ministrar', 'pastar', 'recurso', 'recurso', 'regrar', 'restritivo', 'saudar', 'saudar', 'saudar', 'saudar']","[1, 4, 4, 4, 4, 1, 1, 1, 1, 1, 1, 2, 2, 3, 3, 3, 2, 2, 1, 1, 1, 2, 2, 1, 2, 2, 1, 1, 4, 4, 4, 4]","[]","[]",32,0,32,1
8707,"['complicacao', 'conformar', 'decorrencia', 'domingo', 'domingo', 'exercicio', 'intensivo', 'internar', 'periodo', 'quedo', 'regiao', 'regiao', 'transferir']","[1, 1, 1, 2, 2, 1, 1, 1, 1, 1, 2, 2, 1]","['disseminar']","[1]",13,1,14,1
8717,"['inedito', 'infectar', 'infectar', 'observar', 'respiratorio', 'sarampo', 'transmissao']","[1, 2, 2, 1, 1, 1, 1]","['imagem', 'imagem', 'imagem', 'imagem', 'imagem', 'imagem', 'visualizar']","[6, 6, 6, 6, 6, 6, 1]",7,7,14,1
8718,"['assintomatico', 'autoridad', 'constatar', 'diagnosticar', 'dificuldad', 'estimativo', 'expectativa', 'periodo', 'regiao', 'respiratorio', 'saudar', 'saudar', 'vigilancia', 'vigilancia']","[1, 1, 1, 1, 1, 1, 1, 1, 1, 1, 2, 2, 2, 2]","[]","[]",14,0,14,1
8719,"['aplicacao', 'atuam', 'destinar', 'destinar', 'distrito', 'dosar', 'federativo', 'fundacao', 'igualitario', 'instituto', 'materiaprima', 'oswaldo', 'parcelar', 'recebido', 'remessar', 'roraima', 'saudar', 'saudar', 'saudar', 'vigilancia']","[1, 1, 2, 2, 1, 1, 1, 1, 1, 1, 1, 1, 1, 1, 1, 1, 3, 3, 3, 1]","[]","[]",20,0,20,1
8720,"['assistencia', 'cenario', 'contemplar', 'decorrent', 'decorrent', 'destinar', 'especializar', 'estimular', 'necessidad', 'pratico', 'primario', 'recurso', 'reforcar', 'saudar', 'saudar', 'saudar', 'saudar', 'saudar', 'saudar', 'saudar', 'saudar', 'saudar']","[1, 1, 1, 2, 2, 1, 1, 1, 1, 1, 1, 1, 1, 9, 9, 9, 9, 9, 9, 9, 9, 9]","['usuario']","[1]",22,1,23,1
8725,"['academiar', 'cerimonia', 'epicentro', 'mexico']","[1, 1, 1, 1]","[]","[]",4,0,4,1
8726,"['distrito', 'domingo', 'oferecido', 'positivar', 'quarentenar', 'regiao', 'sudest', 'temporario']","[1, 1, 1, 1, 1, 1, 1, 1]","[]","[]",8,0,8,1
8727,"['adulto', 'almeida', 'domingo', 'dosar', 'esperancar', 'expectativa', 'heleno', 'imunizacao', 'inedito', 'ministrar', 'queiroga', 'queiroga', 'saudar']","[1, 1, 1, 1, 1, 1, 1, 1, 1, 1, 2, 2, 1]","[]","[]",13,0,13,1
8729,"['ambientar', 'cenario', 'funcionamento', 'iniciativo', 'intensivo', 'prever', 'prever', 'privar', 'realizacao', 'sabado', 'saudar', 'subir', 'suspensao']","[1, 1, 1, 1, 1, 2, 2, 1, 1, 1, 1, 1, 1]","[]","[]",13,0,13,1
8730,"['academiar', 'biliao', 'biliao', 'desenvolvimento', 'destacar', 'estagio', 'observar', 'percepcao', 'possibilidad', 'rocha', 'rocha', 'rocha', 'rocha']","[1, 2, 2, 1, 1, 1, 1, 1, 1, 4, 4, 4, 4]","['amplament']","[1]",13,1,14,1
8731,"['balancar', 'henriqu', 'ministrar', 'ministrar', 'orientacao', 'pastar', 'saudar']","[1, 1, 2, 2, 1, 1, 1]","[]","[]",7,0,7,1
8733,"[]","[]","[]","[]",0,0,0,1
8734,"['atuam', 'diminuicao', 'necessidad']","[1, 1, 1]","[]","[]",3,0,3,1
8735,"['europeu', 'inconsistencia', 'kassio', 'ministrar', 'ministrar', 'obtido', 'republico', 'supremo', 'supremo', 'supremo']","[1, 1, 1, 2, 2, 1, 1, 3, 3, 3]","['amigar']","[1]",10,1,11,1
8741,"['anuncio', 'conduta', 'decisao', 'justicar', 'justicar', 'metropolitano', 'preventivo', 'preventivo', 'preventivo', 'proferir', 'regiao', 'resolucao', 'respectivament', 'respirador', 'respirador']","[1, 1, 1, 2, 2, 1, 3, 3, 3, 1, 1, 1, 1, 2, 2]","['auditoria', 'enganir', 'filmar', 'gravacao', 'imagem', 'inscricao', 'legendar', 'postagen']","[1, 1, 1, 1, 1, 1, 1, 1]",15,8,23,1
8742,"['absoluto', 'adhanom', 'instituto', 'monitoramento', 'saudar', 'tedro']","[1, 1, 1, 1, 1, 1]","[]","[]",6,0,6,1
8743,"['comissao', 'opcao', 'opcao', 'opcao', 'respostar', 'saudar', 'saudar', 'saudar', 'saudar']","[1, 3, 3, 3, 1, 4, 4, 4, 4]","[]","[]",9,0,9,1
8748,"['alternativo', 'araujo', 'azevedo', 'ernesto', 'itamarati', 'ministrar', 'ministrar', 'mudanca', 'quedo', 'vieira']","[1, 1, 1, 1, 1, 2, 2, 1, 1, 1]","[]","[]",10,0,10,1
8750,"['associacao', 'associacao', 'carat', 'cnmp', 'cnmp', 'cnmp', 'cnmp', 'conduta', 'conduta', 'especialment', 'examinar', 'justicar', 'justicar', 'justicar', 'presidir', 'presidir', 'situacao']","[2, 2, 1, 4, 4, 4, 4, 2, 2, 1, 1, 3, 3, 3, 2, 2, 1]","['imagem', 'postagen']","[1, 1]",17,2,19,1
8754,"['bbc', 'distrito', 'hipertensao']","[1, 1, 1]","[]","[]",3,0,3,1
8756,"['demandar', 'escassez', 'estagio', 'estimativo', 'estimativo', 'impactar', 'modelo', 'recebido', 'recordar', 'superar', 'trimestr', 'trimestr']","[1, 1, 1, 2, 2, 1, 1, 1, 1, 1, 2, 2]","[]","[]",12,0,12,1
8758,"['atendido', 'desenvolvimento', 'destac', 'processo', 'recebido', 'regiao', 'regiao', 'regiao', 'ribeiro', 'secretarioexecutivo', 'sendo', 'sorocaba', 'tambem', 'tambem', 'tambem', 'transferencia']","[1, 1, 1, 1, 1, 3, 3, 3, 1, 1, 1, 1, 3, 3, 3, 1]","[]","[]",16,0,16,1
8759,"['cardiologista', 'cardiologista', 'possibilidad', 'precaucao', 'queiroga', 'saudar']","[2, 2, 1, 1, 1, 1]","[]","[]",6,0,6,1
8762,"['disseminacao', 'regiao', 'surtir', 'temporariament', 'turista']","[1, 1, 1, 1, 1]","['espalhar']","[1]",5,1,6,1
8764,"['antonio', 'antonio', 'crise', 'jorg', 'tambem']","[2, 2, 1, 1, 1]","['imagem', 'soltar']","[1, 1]",5,2,7,1
8766,"['arrecadar', 'arrecadar', 'equipamento', 'iniciativo', 'necessidad', 'organizador', 'realizacao', 'recurso', 'regiao']","[2, 2, 1, 1, 1, 1, 1, 1, 1]","['camiseta']","[1]",9,1,10,1
8767,"['subir']","[1]","['usuario']","[1]",1,1,2,1
8769,"['colegiado', 'posicionamento', 'possibilidad', 'prever']","[1, 1, 1, 1]","[]","[]",4,0,4,1
8773,"['notificar', 'regiao', 'saudar', 'sudest', 'taxar', 'taxar', 'taxar', 'taxar', 'taxar']","[1, 1, 1, 1, 5, 5, 5, 5, 5]","[]","[]",9,0,9,1
8774,"['aliviar', 'aliviar', 'ambito', 'assintomatico', 'celebrar', 'flavia', 'isolar', 'quarentenar', 'situacao']","[2, 2, 1, 1, 1, 1, 1, 1, 1]","['imagem', 'legendar']","[1, 1]",9,2,11,1
8775,"['concreto', 'decisao', 'estrategia', 'normalidad', 'quarentenar', 'relaxar', 'reuniao', 'surtir']","[1, 1, 1, 1, 1, 1, 1, 1]","[]","[]",8,0,8,1
8776,"['colegiado', 'comissao', 'comissao', 'comissao', 'comissao', 'condenacao', 'constituicao', 'constituicao', 'demrj', 'emendar', 'federar', 'justicar', 'plenario', 'plenario', 'prever', 'proposto', 'requerimento', 'tramitacao']","[1, 4, 4, 4, 4, 1, 2, 2, 1, 1, 1, 1, 2, 2, 1, 1, 1, 1]","['plam']","[1]",18,1,19,1
8777,"['advocaciager', 'atuacao', 'celso', 'celso', 'conformar', 'decisao', 'especializar', 'flavio', 'flavio', 'flavio', 'gabinet', 'investigacao', 'legislativo', 'legislativo', 'liderar', 'mello', 'ministrar', 'plenario', 'privilegiar', 'privilegiar', 'rachadinha', 'republico', 'servidor', 'supremo', 'supremo', 'sustentabilidad']","[1, 1, 2, 2, 1, 1, 1, 3, 3, 3, 1, 1, 2, 2, 1, 1, 1, 1, 2, 2, 1, 1, 1, 2, 2, 1]","[]","[]",26,0,26,1
8778,"['bruno']","[1]","[]","[]",1,0,1,1
8781,"['assintomatico', 'emprestimo', 'positivar', 'quarentenar', 'suspenso', 'temporada', 'temporada']","[1, 1, 1, 1, 1, 2, 2]","[]","[]",7,0,7,1
8782,"['alvorar', 'augusto', 'gabinet', 'heleno', 'infectar', 'mandatario', 'ministrar', 'palacio', 'planalto', 'positivar', 'saudar', 'viagem', 'wajngarten']","[1, 1, 1, 1, 1, 1, 1, 1, 1, 1, 1, 1, 1]","[]","[]",13,0,13,1
8784,"['adulto', 'adulto', 'comportamento', 'conjuntar', 'impacto', 'instituto', 'isolar', 'necessidad', 'parceria', 'relativo']","[2, 2, 1, 1, 1, 1, 1, 1, 1, 1]","['compartilhar']","[1]",10,1,11,1
8786,"['atrasar', 'balancar', 'biliao', 'habitant', 'letalidad', 'levantamento', 'levantamento', 'recordar', 'regiao', 'saudar', 'superar', 'taxar']","[1, 1, 1, 1, 1, 2, 2, 1, 1, 1, 1, 1]","[]","[]",12,0,12,1
8788,"['agravamento', 'contencao', 'decisao', 'distrito', 'levantamento', 'privar', 'regrar', 'rocha', 'surtir', 'suspensao', 'suspensao', 'suspensao', 'suspensao']","[1, 1, 1, 1, 1, 1, 1, 1, 1, 4, 4, 4, 4]","[]","[]",13,0,13,1
8789,"['antecipar', 'consorcio', 'converso', 'enxergar', 'ministrar', 'motivacao', 'necessario', 'orientacao', 'pastar', 'privar', 'saudar', 'saudar', 'tesourar']","[1, 1, 1, 1, 1, 1, 1, 1, 1, 1, 2, 2, 1]","[]","[]",13,0,13,1
8790,"['adulto', 'alunar', 'alunar', 'atendido', 'atuacao', 'fase', 'goncalv', 'publicoalvo', 'saudar', 'saudar', 'saudar', 'saudar', 'treinamento']","[1, 2, 2, 1, 1, 1, 1, 1, 4, 4, 4, 4, 1]","[]","[]",13,0,13,1
8791,"['coreia', 'coreia', 'disseminacao', 'implementacao', 'metropolitano', 'metropolitano', 'ministrar', 'periodo', 'quarentenar', 'rastreamento', 'reabertura', 'regiao', 'regiao', 'reuniao', 'rigoroso', 'saudar']","[2, 2, 1, 1, 2, 2, 1, 1, 1, 1, 1, 2, 2, 1, 1, 1]","[]","[]",16,0,16,1
8792,"['alerj', 'alerj', 'amplo', 'colegiado', 'comissao', 'comissao', 'comissao', 'comissao', 'consenso', 'decisao', 'decisao', 'irregularidad', 'irregularidad', 'legislativo', 'legislativo', 'ministrar', 'ministrar', 'ministrar', 'minoria', 'obtido', 'oficialment', 'sessao', 'supremo', 'wilson', 'wilson', 'witzel', 'witzel', 'witzel', 'witzel']","[2, 2, 1, 1, 4, 4, 4, 4, 1, 2, 2, 2, 2, 2, 2, 3, 3, 3, 1, 1, 1, 1, 1, 2, 2, 4, 4, 4, 4]","[]","[]",29,0,29,1
8794,"['comprometido', 'condicao', 'condicao', 'conjuntar', 'internar', 'internar', 'isolar', 'paralisar', 'periodo', 'prever', 'prever', 'previo', 'quarentenar', 'ribeiro', 'treinamento', 'treinamento', 'treinamento', 'treinar']","[1, 2, 2, 1, 2, 2, 1, 1, 1, 2, 2, 1, 1, 1, 3, 3, 3, 1]","['replicar']","[1]",18,1,19,1
8795,"['afetado', 'aliquota', 'ampliacao', 'coletivo', 'companhia', 'congresso', 'contribuicao', 'dificuldad', 'discussao', 'federar', 'impactar', 'proposto']","[1, 1, 1, 1, 1, 1, 1, 1, 1, 1, 1, 1]","[]","[]",12,0,12,1
8798,"['ambito', 'cometido', 'cupula', 'determinacao', 'esquema', 'fluminens', 'implementar', 'investigacao', 'irregularidad', 'justicar', 'legislativo', 'pagamento', 'pastar', 'recurso', 'saudar', 'suspeito', 'wilson', 'wilson', 'witzel', 'witzel']","[1, 1, 1, 1, 1, 1, 1, 1, 1, 1, 1, 1, 1, 1, 1, 1, 2, 2, 2, 2]","[]","[]",20,0,20,1
8799,"['alvaro', 'antonio', 'crise', 'infraestrutura', 'ministrar', 'ministrar', 'nelson', 'observar', 'palacio', 'planalto', 'saudar', 'teich']","[1, 1, 1, 1, 2, 2, 1, 1, 1, 1, 1, 1]","['caixao', 'caixao', 'caixao', 'caixao', 'imagem', 'telejorn']","[4, 4, 4, 4, 1, 1]",12,6,18,1
8801,"['aprovacao', 'celebrar', 'fornecimento', 'infectar', 'possibilidad', 'prescricao', 'pslsp', 'saudar']","[1, 1, 1, 1, 1, 1, 1, 1]","[]","[]",8,0,8,1
8802,"['balancar', 'consorcio', 'superar', 'variacao', 'variacao']","[1, 1, 1, 2, 2]","[]","[]",5,0,5,1
8809,"['afastamento', 'autorizacao', 'autorizacao', 'constituicao', 'constituicao', 'constituicao', 'decisao', 'decisao', 'exigencia', 'fundamentar', 'justicar', 'legislativo', 'regrar', 'republico', 'republico', 'supremo', 'supremo', 'vetar', 'wilson', 'witzel']","[1, 2, 2, 3, 3, 3, 2, 2, 1, 1, 1, 1, 1, 2, 2, 2, 2, 1, 1, 1]","['lixar']","[1]",20,1,21,1
8811,"['atuacao', 'celso', 'celso', 'celso', 'coordenar', 'diagnosticar', 'dificuldad', 'gabinet', 'internacao', 'isolar', 'mello', 'mello', 'mello', 'ministrar', 'ministrar', 'positivar', 'supremo']","[1, 3, 3, 3, 1, 1, 1, 1, 1, 1, 3, 3, 3, 2, 2, 1, 1]","[]","[]",17,0,17,1
8814,"['adicionar', 'autoridad', 'destacar', 'imunizacao', 'mexico', 'saudar', 'sigla', 'sputnik']","[1, 1, 1, 1, 1, 1, 1, 1]","[]","[]",8,0,8,1
8815,"['pagamento', 'recurso']","[1, 1]","['gravacao', 'legendar', 'mencao', 'tampouco']","[1, 1, 1, 1]",2,4,6,1
8816,"['complicacao', 'consequencia', 'dialogo', 'dificuldad', 'dificuldad', 'especialment', 'excecao', 'exercicio', 'infectar', 'psicologo', 'quarentenar', 'rotina', 'rotina', 'saudar', 'universitario', 'vulneravel']","[1, 1, 1, 2, 2, 1, 1, 1, 1, 1, 1, 2, 2, 1, 1, 1]","['enganar']","[1]",16,1,17,1
8817,"['autonomia', 'autorizacao', 'autorizacao', 'carat', 'cenario', 'correspondent', 'demandar', 'destinar', 'distrito', 'enfrentamento', 'especializar', 'espirito', 'necessario', 'pulmonar', 'pulmonar', 'recurso', 'reforcar', 'saudar', 'saudar', 'saudar', 'suportar', 'suportar', 'suportar', 'suspeito', 'temporario', 'ventilatorio', 'ventilatorio']","[1, 2, 2, 1, 1, 1, 1, 1, 1, 1, 1, 1, 1, 2, 2, 1, 1, 3, 3, 3, 3, 3, 3, 1, 1, 2, 2]","[]","[]",27,0,27,1
8818,"['anteriorment', 'autoridad', 'saudar', 'surtir']","[1, 1, 1, 1]","['drone', 'drone']","[2, 2]",4,2,6,1
8819,"['barroso', 'decisao', 'decisao', 'ministrar', 'ministrar', 'ministrar', 'regrar']","[1, 2, 2, 3, 3, 3, 1]","['visualizacao']","[1]",7,1,8,1
8820,"['alternativo', 'folhar', 'inquerito', 'integro', 'justicar']","[1, 1, 1, 1, 1]","[]","[]",5,0,5,1
8821,"['crise', 'decisao', 'decisao', 'decisao', 'decisao', 'funcao', 'importancia', 'importancia', 'justicar', 'magistrado', 'prazo', 'regiao', 'republico', 'saudar', 'saudar']","[1, 4, 4, 4, 4, 1, 2, 2, 1, 1, 1, 1, 1, 2, 2]","[]","[]",15,0,15,1
8822,"['autoridad', 'celso', 'mandatario', 'regiao', 'regiao', 'situacao', 'situacao']","[1, 1, 1, 2, 2, 2, 2]","[]","[]",7,0,7,1
8825,"['europeu', 'infectar', 'intensivo', 'internar', 'recordar', 'reportar', 'saudar', 'situacao', 'situacao']","[1, 1, 1, 1, 1, 1, 1, 2, 2]","[]","[]",9,0,9,1
8828,"['bancada', 'justicar', 'legislativo', 'recuperacao', 'republico', 'situacao', 'wilson', 'witzel', 'witzel', 'witzel']","[1, 1, 1, 1, 1, 1, 1, 3, 3, 3]","[]","[]",10,0,10,1
8830,"['expectativa', 'imunizacao', 'instituto', 'parceria']","[1, 1, 1, 1]","[]","[]",4,0,4,1
8831,"['argumentar', 'arthur', 'barroso', 'importancia', 'positivar', 'saudar']","[1, 1, 1, 1, 1, 1]","[]","[]",6,0,6,1
8833,"['academiar', 'destacar', 'diagnosticar', 'domingo', 'especializar', 'flavio', 'flexibilizacao', 'instituto', 'internar', 'oliveira', 'oliveira', 'reducao', 'saudar']","[1, 1, 1, 1, 1, 1, 1, 1, 1, 2, 2, 1, 1]","['abortar']","[1]",13,1,14,1
8837,"['ambientar', 'consecutivo', 'desmatamento', 'desmatamento', 'desmatamento', 'desmatamento', 'desmatamento', 'desmatamento', 'desmatamento', 'deteccao', 'instituto', 'instituto', 'monitoramento', 'monitoramento', 'recordar', 'regiao']","[1, 1, 7, 7, 7, 7, 7, 7, 7, 1, 2, 2, 2, 2, 1, 1]","[]","[]",16,0,16,1
8838,"['aglomeracao', 'aglomeracao', 'aglomeracao', 'autoridad', 'preocupacao', 'saudar', 'turistico']","[3, 3, 3, 1, 1, 1, 1]","[]","[]",7,0,7,1
8839,"['demmg', 'integro', 'jorg', 'kassio', 'ministrar', 'ministrar', 'pacheco', 'supremo']","[1, 1, 1, 1, 2, 2, 1, 1]","['ganhar']","[1]",8,1,9,1
8841,"['atrair', 'atrair', 'atrair', 'coordenar', 'desenvolvimento', 'desmatamento', 'especialment', 'parceiro', 'recurso', 'regiao', 'sustentabilidad']","[3, 3, 3, 1, 1, 1, 1, 1, 1, 1, 1]","[]","[]",11,0,11,1
8844,"['administrativo', 'carat', 'consumidor', 'consumidor', 'decisao', 'decisao', 'decisao', 'descumprimento', 'internacao', 'internacao', 'internacao', 'justicar', 'justicar', 'limitacao', 'necessario', 'planar', 'plano', 'plano', 'plano', 'prazo', 'prever', 'proferir', 'resolucao', 'saudar', 'saudar', 'saudar', 'saudar', 'saudar', 'souza', 'suspeito', 'suspeito', 'suspeito', 'varar', 'vulnerabilidad']","[1, 1, 2, 2, 3, 3, 3, 1, 3, 3, 3, 2, 2, 1, 1, 1, 3, 3, 3, 1, 1, 1, 1, 5, 5, 5, 5, 5, 1, 3, 3, 3, 1, 1]","[]","[]",34,0,34,1
8845,"['augusto', 'contrato', 'crise', 'decisao', 'determinacao', 'justicar', 'movimentacao', 'pagamento', 'pagamento', 'pagamento', 'pagamento', 'pagamento', 'pagamento', 'parcelar', 'resolucao', 'saudar', 'servidor', 'servidor', 'servidor', 'suspenso', 'suspenso']","[1, 1, 1, 1, 1, 1, 1, 6, 6, 6, 6, 6, 6, 1, 1, 1, 3, 3, 3, 2, 2]","[]","[]",21,0,21,1
8846,"['apostar', 'curvo', 'infectar', 'opcao', 'recordar', 'republico', 'ritmar']","[1, 1, 1, 1, 1, 1, 1]","['enganar']","[1]",7,1,8,1
8847,"['acordo', 'atuacao', 'destinar', 'destinar', 'federar', 'justicar', 'processo', 'recurso', 'ribeiro', 'saudar', 'saudar', 'saudar', 'situacao']","[1, 1, 2, 2, 1, 1, 1, 1, 1, 3, 3, 3, 1]","[]","[]",13,0,13,1
8848,"['acumular', 'antecipar', 'antonio', 'arthur', 'atrasa', 'biliao', 'bruto', 'comparacao', 'comparacao', 'comparacao', 'conflito', 'conflito', 'conflito', 'conflito', 'coreia', 'crise', 'crise', 'crise', 'depressao', 'desafiar', 'dificuldad', 'economia', 'economia', 'economia', 'economia', 'economia', 'equivalent', 'escalar', 'estatistico', 'europeu', 'europeu', 'europeu', 'europeu', 'expansao', 'impactar', 'impactar', 'impactar', 'impacto', 'importacao', 'infraestrutura', 'instalacao', 'insuficient', 'internar', 'merkel', 'ministrar', 'necessidad', 'paralelo', 'paralisar', 'periodo', 'piorar', 'planar', 'precedent', 'prever', 'prever', 'primeiroministro', 'projeco', 'recuperacao', 'situacao', 'sobretudo', 'sobretudo', 'trimestr', 'trimestr']","[1, 1, 1, 1, 1, 1, 1, 3, 3, 3, 4, 4, 4, 4, 1, 3, 3, 3, 1, 1, 1, 5, 5, 5, 5, 5, 1, 1, 1, 4, 4, 4, 4, 1, 3, 3, 3, 1, 1, 1, 1, 1, 1, 1, 1, 1, 1, 1, 1, 1, 1, 1, 2, 2, 1, 1, 1, 1, 2, 2, 2, 2]","['escutar', 'idioma', 'puro', 'sapato', 'sequer']","[1, 1, 1, 1, 1]",62,5,67,1
8849,"['academiar', 'agravar', 'crescimento', 'economia', 'epidemiar', 'epidemiar', 'especialment', 'feriar', 'plano', 'reabertura', 'reabertura', 'revisar', 'ritmar', 'situacao', 'transmissao']","[1, 1, 1, 1, 2, 2, 1, 1, 1, 2, 2, 1, 1, 1, 1]","[]","[]",15,0,15,1
8850,"['autorizacao', 'carat', 'correspondent', 'destinar', 'especializar', 'pulmonar', 'pulmonar', 'reforcar', 'saudar', 'saudar', 'suportar', 'suportar', 'suportar', 'suspeito', 'temporario', 'ventilatorio', 'ventilatorio']","[1, 1, 1, 1, 1, 2, 2, 1, 2, 2, 3, 3, 3, 1, 1, 2, 2]","[]","[]",17,0,17,1
8851,"['diminuicao']","[1]","['circular']","[1]",1,1,2,1
8853,"['internar', 'previsao']","[1, 1]","['desmentir']","[1]",2,1,3,1
8854,"['conformar', 'deslocamento', 'etapa', 'fase', 'fase', 'flexibilizacao', 'habitant', 'primeiroministro', 'recuperacao', 'situacao', 'turista']","[1, 1, 1, 2, 2, 1, 1, 1, 1, 1, 1]","[]","[]",11,0,11,1
8855,"['instituto', 'integro', 'presidir']","[1, 1, 1]","[]","[]",3,0,3,1
8856,"['aglomeracao', 'crescimento', 'esquema', 'fluxo', 'globonew', 'implementacao', 'implementar', 'metropolitano', 'metropolitano', 'observar', 'passageiro', 'reflexo', 'significativo']","[1, 1, 1, 1, 1, 1, 1, 2, 2, 1, 1, 1, 1]","['dorio']","[1]",13,1,14,1
8859,"['infectar', 'saudar', 'velocidad']","[1, 1, 1]","['disseminar']","[1]",3,1,4,1
8860,"['afetado', 'contabilizar', 'epidemiar', 'interrupcao', 'minimizar', 'primario', 'respostar', 'reuniao', 'universitario', 'videoconferencia']","[1, 1, 1, 1, 1, 1, 1, 1, 1, 1]","['parir']","[1]",10,1,11,1
8861,"['domingo', 'domingo', 'fronteiro', 'fronteiro', 'fronteiro', 'fronteiro', 'fronteiro', 'integrant', 'justicar', 'justicar', 'ministrar', 'reforcar']","[2, 2, 5, 5, 5, 5, 5, 1, 2, 2, 1, 1]","['faccao']","[1]",12,1,13,1
8865,"['afetado', 'aplicacao', 'desenvolvido', 'saudar']","[1, 1, 1, 1]","['equador']","[1]",4,1,5,1
8866,"['converso', 'decisao', 'depoimento']","[1, 1, 1]","['canadens']","[1]",3,1,4,1
8867,"['advocaciager', 'autonomia', 'autonomia', 'autoridad', 'republico', 'republico', 'supremo', 'suspenso']","[1, 2, 2, 1, 2, 2, 1, 1]","[]","[]",8,0,8,1
8868,"['antonio', 'augusto', 'ministrar', 'presenca', 'recebido', 'renata', 'renata', 'reuniao']","[1, 1, 1, 1, 1, 2, 2, 1]","[]","[]",8,0,8,1
8872,"['adhanom', 'consequencia', 'contencao', 'crise', 'desenvolvimento', 'destacar', 'economia', 'impacto', 'implementar', 'michael', 'posicionamento', 'quarentenar', 'resolucao', 'saudar', 'saudar', 'sobretudo', 'tedro', 'tedro', 'tedro', 'transmissao', 'vulneravel']","[1, 1, 1, 1, 1, 1, 1, 1, 1, 1, 1, 1, 1, 2, 2, 1, 3, 3, 3, 1, 1]","[]","[]",21,0,21,1
8873,"['esperancar']","[1]","['realment']","[1]",1,1,2,1
8874,"['adversario', 'colunista', 'diminuicao', 'especialment', 'mandatario', 'presenca', 'ricardo']","[1, 1, 1, 1, 1, 1, 1]","[]","[]",7,0,7,1
8875,"['anvisa', 'anvisa', 'apurar', 'autorizacao', 'consorcio', 'desenvolvido', 'entregu', 'fase', 'instituto', 'instituto', 'parceria', 'remessar', 'vigilancia']","[2, 2, 1, 1, 1, 1, 1, 1, 2, 2, 1, 1, 1]","[]","[]",13,0,13,1
8876,"['autoridad', 'epidemiologico', 'hospitalizar', 'ministrar', 'notificar', 'quarentenar', 'sabado', 'saudar']","[1, 1, 1, 1, 1, 1, 1, 1]","[]","[]",8,0,8,1
8877,"['broadcast', 'curvo', 'dificuldad', 'epidemiar', 'epidemiar', 'epidemiar', 'epidemiologico', 'instituto', 'necessidad', 'percepcao', 'recurso', 'respostar', 'ritmar']","[1, 1, 1, 3, 3, 3, 1, 1, 1, 1, 1, 1, 1]","[]","[]",13,0,13,1
8878,"['desenvolvimento', 'enfrentamento', 'especifico', 'lancamento', 'plano', 'reflexo']","[1, 1, 1, 1, 1, 1]","[]","[]",6,0,6,1
8881,"['autoridad', 'avancar', 'crise', 'especialment', 'normalidad', 'posturar', 'reuniao', 'reuniao', 'reuniao', 'saudar', 'situacao', 'tedro']","[1, 1, 1, 1, 1, 1, 3, 3, 3, 1, 1, 1]","[]","[]",12,0,12,1
8886,"['adotada', 'contabilizar', 'espirito', 'espirito', 'estrategia', 'estrategia', 'infectar', 'planar', 'regiao', 'regrar', 'republico', 'saudar', 'saudar']","[1, 1, 2, 2, 2, 2, 1, 1, 1, 1, 1, 2, 2]","['enderecar']","[1]",13,1,14,1
8887,"['associacao', 'folhar', 'folhar', 'integro', 'liderar', 'privar', 'recurso']","[1, 2, 2, 1, 1, 1, 1]","['enderecar']","[1]",7,1,8,1
8888,"['alteracao', 'autorizacao', 'boletim', 'comportamento', 'conselho', 'crescimento', 'exemplo', 'exemplo', 'exemplo', 'mantido', 'medida', 'necessario', 'none', 'observar', 'observar', 'porqu', 'reclamacao', 'reforca', 'regiao', 'regiao', 'relacao', 'relacao', 'serao', 'serao']","[1, 1, 1, 1, 1, 1, 3, 3, 3, 1, 1, 1, 1, 2, 2, 1, 1, 1, 2, 2, 2, 2, 2, 2]","[]","[]",24,0,24,1
8889,"['assistencia', 'deslocamento', 'enfrentamento', 'especifico', 'oferecido', 'primario', 'primario', 'primario', 'reforcar', 'saudar', 'saudar', 'saudar', 'saudar', 'suportar']","[1, 1, 1, 1, 1, 3, 3, 3, 1, 4, 4, 4, 4, 1]","[]","[]",14,0,14,1
8890,"['feriar', 'quarentenar', 'reabertura', 'urbano', 'volumar']","[1, 1, 1, 1, 1]","['imagem']","[1]",5,1,6,1
8891,"[]","[]","[]","[]",0,0,0,1
8893,"['alcolumbr', 'alcolumbr', 'demap', 'demrj', 'discussao', 'discussao', 'imunizacao', 'inicialment', 'planar', 'previsto', 'previsto', 'provisorio', 'recuperacao', 'recurso', 'regiao', 'reuniao', 'reuniao', 'wellington']","[2, 2, 1, 1, 2, 2, 1, 1, 1, 2, 2, 1, 1, 1, 1, 2, 2, 1]","[]","[]",18,0,18,1
8894,"['apreensao', 'associacao', 'atuacao', 'gabinet', 'gabinet', 'gabinet', 'inquerito', 'integrant', 'ministrar', 'normalidad', 'possibilidad', 'supremo']","[1, 1, 1, 3, 3, 3, 1, 1, 1, 1, 1, 1]","['espalhar']","[1]",12,1,13,1
8897,"['ambito', 'araujo', 'depoimento', 'ernesto', 'ernesto', 'ernesto', 'exministro', 'integro', 'palacio', 'paralelo', 'parceiro', 'planalto']","[1, 1, 1, 3, 3, 3, 1, 1, 1, 1, 1, 1]","['verificar', 'verificar']","[2, 2]",12,2,14,1
8898,"['adhanom', 'domingo', 'positivar', 'positivar', 'quarentenar', 'quarentenar', 'saudar', 'sigla', 'tedro']","[1, 1, 2, 2, 2, 2, 1, 1, 1]","[]","[]",9,0,9,1
8899,"['acordo', 'calamidad', 'celebrar', 'contrato', 'economia', 'extensao', 'gued', 'gued', 'jornada', 'ministrar', 'preservar', 'prever', 'prorrogacao', 'prorrogacao', 'prorrogar', 'prorrogar', 'quedo']","[1, 1, 1, 1, 1, 1, 2, 2, 1, 1, 1, 1, 2, 2, 2, 2, 1]","[]","[]",17,0,17,1
8901,"['alcolumbr', 'decisao', 'folhar', 'fux', 'fux', 'instituto', 'integro', 'integro', 'legislativo', 'legislativo', 'legislativo', 'precedent', 'supremo']","[1, 1, 1, 2, 2, 1, 2, 2, 3, 3, 3, 1, 1]","[]","[]",13,0,13,1
8903,"['distrito', 'escalar', 'saudar']","[1, 1, 1]","[]","[]",3,0,3,1
8904,"['afp', 'epidemiar', 'expressar', 'expressar', 'externo', 'fundamentar', 'normalidad']","[1, 1, 2, 2, 1, 1, 1]","['parir', 'parir', 'realment', 'verdadeiro']","[2, 2, 1, 1]",7,4,11,1
8907,"['flavia', 'flavia', 'flavia', 'internar', 'mello', 'mello', 'negativar', 'saudar', 'sorocaba', 'sorocaba', 'sorocaba']","[3, 3, 3, 1, 2, 2, 1, 1, 3, 3, 3]","['misericordia']","[1]",11,1,12,1
8908,"[]","[]","[]","[]",0,0,0,1
8909,"['araujo', 'carla', 'colunista', 'consorcio', 'correspondent', 'imunizacao', 'necessario', 'prioritario', 'prioritario', 'prtb', 'republico', 'saudar', 'souza']","[1, 1, 1, 1, 1, 1, 1, 2, 2, 1, 1, 1, 1]","[]","[]",13,0,13,1
8910,"['apurar', 'arthur', 'ccj', 'ccj', 'comissao', 'comissao', 'comissao', 'constituicao', 'constituicao', 'constituicao', 'emendar', 'inquerito', 'investigacao', 'justicar', 'lira', 'presidir', 'proposto', 'proposto', 'supremo']","[1, 1, 2, 2, 3, 3, 3, 3, 3, 3, 1, 1, 1, 1, 1, 1, 2, 2, 1]","[]","[]",19,0,19,1
8912,"['abordagem', 'administrativo', 'conformar', 'constatar', 'descumprir', 'lesao', 'previsto', 'regrar', 'resistencia']","[1, 1, 1, 1, 1, 1, 1, 1, 1]","[]","[]",9,0,9,1
8914,"['atrasar', 'calamidad', 'condicao', 'contrato', 'contrato', 'fase', 'fase', 'juro', 'pagamento', 'pagamento', 'pagamento', 'parcelar', 'parcelar', 'parcelar', 'parcelar', 'resolucao', 'resolucao', 'suspensao', 'suspenso', 'suspenso', 'suspenso']","[1, 1, 1, 2, 2, 2, 2, 1, 3, 3, 3, 4, 4, 4, 4, 2, 2, 1, 3, 3, 3]","[]","[]",21,0,21,1
8915,"['antonio', 'anvisa', 'anvisa', 'anvisa', 'aprovacao', 'decisao', 'diretoria', 'instituto', 'instituto', 'milho', 'milho', 'parceria', 'pedido', 'reuniao', 'sendo', 'unanimidad', 'vigilancia']","[1, 3, 3, 3, 1, 1, 1, 2, 2, 2, 2, 1, 1, 1, 1, 1, 1]","[]","[]",17,0,17,1
8917,"['autoridad', 'avancar', 'cepa', 'circulacao', 'circulacao', 'circulacao', 'hubei', 'hubei', 'infectar', 'observacao', 'provincia', 'provincia', 'provincia', 'respiratorio', 'subir', 'turistico', 'urbano']","[1, 1, 1, 3, 3, 3, 2, 2, 1, 1, 3, 3, 3, 1, 1, 1, 1]","[]","[]",17,0,17,1
8922,"['ausencia', 'cenario', 'crise', 'crise', 'desafio', 'destacar', 'michael', 'possibilidad', 'prever', 'projecao', 'transmissao']","[1, 1, 2, 2, 1, 1, 1, 1, 1, 1, 1]","[]","[]",11,0,11,1
8924,"['ambientar', 'ambientar', 'ambientar', 'comprometido', 'concessionario', 'conservacao', 'desembarcar', 'determinacao', 'determinacao', 'domingo', 'domingo', 'funcionamento', 'funcionamento', 'instituto', 'ministrar', 'plano', 'preventivo', 'reducao', 'ricardo', 'ricardo', 'sall', 'subir', 'suspensao', 'turista', 'turista', 'turista', 'turista', 'turista', 'turistico', 'turistico', 'wilson', 'witzel']","[3, 3, 3, 1, 1, 1, 1, 2, 2, 2, 2, 2, 2, 1, 1, 1, 1, 1, 2, 2, 1, 1, 1, 5, 5, 5, 5, 5, 2, 2, 1, 1]","[]","[]",32,0,32,1
8925,"['concedido', 'emendar', 'publicitario', 'republico']","[1, 1, 1, 1]","['insinuar', 'tampouco']","[1, 1]",4,2,6,1
8926,"['aplicacao', 'destinar', 'dosar', 'dosar', 'dosar', 'expectativa', 'normalment', 'regiao', 'saudar', 'saudar']","[1, 1, 3, 3, 3, 1, 1, 1, 2, 2]","[]","[]",10,0,10,1
8927,"['apurar', 'aspecto', 'desempenhar', 'funcao', 'gabinet', 'republico']","[1, 1, 1, 1, 1, 1]","['imagem']","[1]",6,1,7,1
8928,"['desembarcar', 'palacio', 'planalto', 'recebido']","[1, 1, 1, 1]","[]","[]",4,0,4,1
8929,"['compromisso', 'concedido', 'disseminacao', 'reabrir']","[1, 1, 1, 1]","['cbn']","[1]",4,1,5,1
8930,"['afp', 'anuncio', 'companhia', 'crise', 'pagamento', 'paralisar', 'portavoz', 'prever', 'sindicato', 'sindicato', 'sindicato', 'sindicato', 'temporario']","[1, 1, 1, 1, 1, 1, 1, 1, 4, 4, 4, 4, 1]","[]","[]",13,0,13,1
8933,"['expectativa', 'prioritario', 'profissionai', 'profissionai', 'proposta', 'proposta', 'risco']","[1, 1, 2, 2, 2, 2, 1]","[]","[]",7,0,7,1
8934,"['constatar', 'epidemiologico', 'prazo', 'prioritario', 'saudar', 'saudar', 'saudar']","[1, 1, 1, 1, 3, 3, 3]","['cadastramento']","[1]",7,1,8,1
8935,"['absoluto', 'acumular', 'balancar', 'contabilizar', 'crescimento', 'excecao', 'indicador', 'infectar', 'infectar', 'intensivo', 'intensivo', 'internar', 'particularment', 'primeiroministro', 'quarentenar', 'quedo', 'reabertura', 'reabrir', 'recordar', 'regiao', 'testagem', 'totalizar']","[1, 1, 1, 1, 1, 1, 1, 2, 2, 2, 2, 1, 1, 1, 1, 1, 1, 1, 1, 1, 1, 1]","['ganhar']","[1]",22,1,23,1
8937,"['aglomeracao', 'avancar', 'coletivo', 'jornada']","[1, 1, 1, 1]","['fingir']","[1]",4,1,5,1
8938,"['bbc', 'instituto', 'necessidad', 'percepcao', 'piorar', 'piorar', 'piorar', 'saudar', 'saudar']","[1, 1, 1, 1, 3, 3, 3, 2, 2]","[]","[]",9,0,9,1
8939,"['arthur', 'bancada', 'bancada', 'bancada', 'federar', 'federar', 'lira', 'oficialment', 'ppal', 'rossi', 'sigla']","[1, 3, 3, 3, 2, 2, 1, 1, 1, 1, 1]","[]","[]",11,0,11,1
8941,"['bastidor', 'congresso', 'congresso', 'congresso', 'cupula', 'destacar', 'integrant', 'minimizar', 'ministrar', 'orientacao', 'pastar', 'saudar', 'situacao']","[1, 3, 3, 3, 1, 1, 1, 1, 1, 1, 1, 1, 1]","[]","[]",13,0,13,1
8942,"['agravar', 'circulacao', 'comparacao', 'gorinchteyn', 'gorinchteyn', 'gorinchteyn', 'intensivo', 'internar', 'saudar', 'saudar']","[1, 1, 1, 3, 3, 3, 1, 1, 2, 2]","[]","[]",10,0,10,1
8944,"['decisao', 'decisao', 'imunizacao', 'imunizacao', 'manutencao', 'plano', 'prioridad', 'prioritario', 'quedo', 'recurso', 'regiao', 'saudar', 'saudar', 'vulneravel']","[2, 2, 2, 2, 1, 1, 1, 1, 1, 1, 1, 2, 2, 1]","[]","[]",14,0,14,1
8945,"['cepa', 'cepa', 'contagioso', 'instituto', 'instituto', 'mutacao', 'parceria', 'sequenciamento', 'vigilancia']","[2, 2, 1, 2, 2, 1, 1, 1, 1]","[]","[]",9,0,9,1
8949,"['pslsp']","[1]","[]","[]",1,0,1,1
8950,"['adversario', 'arthur', 'bancada', 'bancada', 'bancada', 'colegio', 'lira', 'marilia', 'marilia', 'marilia', 'ppal']","[1, 1, 3, 3, 3, 1, 1, 3, 3, 3, 1]","['legendar']","[1]",11,1,12,1
8951,"['adesao', 'biliao', 'biliao', 'biliao', 'biliao', 'enfrentamento', 'iniciativo', 'integrant', 'montant', 'pastar', 'processo', 'recurso', 'recurso', 'recurso', 'saudar']","[1, 4, 4, 4, 4, 1, 1, 1, 1, 1, 1, 3, 3, 3, 1]","[]","[]",15,0,15,1
8954,"['argumentar', 'biliao', 'conformar', 'desenvolvimento', 'governista', 'integro', 'minimizar', 'obtido', 'orcamentaria', 'recurso', 'recurso']","[1, 1, 1, 1, 1, 1, 1, 1, 1, 2, 2]","['secreto']","[1]",11,1,12,1
8956,"['autoridad', 'cerimonia', 'domingo', 'extraordinario', 'lorenzoni', 'lorenzoni', 'ministrar', 'onyx', 'preparacao', 'preparacao', 'presenca', 'treinamento', 'treinamento', 'treinar', 'treinar']","[1, 1, 1, 1, 2, 2, 1, 1, 2, 2, 1, 2, 2, 2, 2]","[]","[]",15,0,15,1
8957,"['congresso', 'congresso', 'demrj', 'dialogo', 'dialogo', 'economia', 'exministro', 'fundeb', 'fundeb', 'gued', 'ministrar', 'ministrar', 'reuniao', 'ribeiro']","[2, 2, 1, 2, 2, 1, 1, 2, 2, 1, 2, 2, 1, 1]","[]","[]",14,0,14,1
8958,"['conjuntar', 'converso', 'especialment', 'impacto', 'lancamento', 'liderar', 'perspectivo', 'projeco', 'realizacao', 'sabado', 'sabado']","[1, 1, 1, 1, 1, 1, 1, 1, 1, 2, 2]","[]","[]",11,0,11,1
8963,"['anticorpo', 'comportamento', 'domicilio', 'estatistico', 'geografia', 'ibg', 'infectar', 'instituto', 'presenca', 'previsao', 'realizacao', 'reforcar', 'saudar', 'saudar', 'saudar', 'saudar']","[1, 1, 1, 1, 1, 1, 1, 1, 1, 1, 1, 1, 4, 4, 4, 4]","['enderecar']","[1]",16,1,17,1
8966,"['apoio', 'aumento', 'exemplo', 'globonew', 'moderno', 'necessidad', 'necessidad', 'oferecido', 'plena', 'regiao', 'regiao', 'tambem']","[1, 1, 1, 1, 1, 2, 2, 1, 1, 2, 2, 1]","[]","[]",12,0,12,1
8967,"['comparacao', 'consolidar', 'consorcio', 'crescimento', 'crescimento', 'levantamento', 'saudar', 'situacao', 'tendencia', 'tendencia', 'variacao', 'variacao']","[1, 1, 1, 2, 2, 1, 1, 1, 2, 2, 2, 2]","[]","[]",12,0,12,1
8968,"['associacao', 'folhar', 'integro', 'levantamento', 'privar', 'privar', 'regiao', 'situacao']","[1, 1, 1, 1, 2, 2, 1, 1]","[]","[]",8,0,8,1
8969,"['balancar', 'distrito', 'infectar', 'infectar', 'roraima', 'saudar', 'saudar', 'saudar']","[1, 1, 2, 2, 1, 3, 3, 3]","[]","[]",8,0,8,1
8971,"['ampliacao', 'crescimento', 'curvo', 'decisao', 'disseminacao', 'entendimento', 'epidemiar', 'flexibilizar', 'necessario', 'necessario', 'orientacao', 'reducao', 'situacao', 'taxar']","[1, 1, 1, 1, 1, 1, 1, 1, 2, 2, 1, 1, 1, 1]","[]","[]",14,0,14,1
8973,"['associacao', 'associacao', 'associacao', 'consumidor', 'demandar', 'equilibrio', 'normalment']","[3, 3, 3, 1, 1, 1, 1]","[]","[]",7,0,7,1
8974,"['acordo', 'aglomeracao', 'client', 'destac', 'domingo', 'domingo', 'fase', 'fase', 'fase', 'flexibilizacao', 'medida', 'primeiroministro', 'reabrir', 'reuniao', 'risco', 'serao', 'serao', 'surto', 'tambem']","[1, 1, 1, 1, 2, 2, 3, 3, 3, 1, 1, 1, 1, 1, 1, 2, 2, 1, 1]","[]","[]",19,0,19,1
8976,"['absoluto', 'araujo', 'carla', 'cepa', 'colunista', 'gabbardo', 'gabbardo', 'implementar', 'importancia', 'possibilidad', 'reducao', 'transmissao']","[1, 1, 1, 1, 1, 2, 2, 1, 1, 1, 1, 1]","[]","[]",12,0,12,1
8978,"['internar', 'recuperacao', 'saudar']","[1, 1, 1]","[]","[]",3,0,3,1
8981,"['administrativo', 'ambientar', 'andrea', 'atuacao', 'californio', 'complicacao', 'concedido', 'dedicar', 'desenvolvimento', 'emprestimo', 'exgovernador', 'extraordinario', 'improbidad', 'instituto', 'internar', 'pagamento', 'periodo', 'planar', 'plano', 'prever', 'prever', 'realizacao', 'urbano', 'urbano', 'urbano']","[1, 1, 1, 1, 1, 1, 1, 1, 1, 1, 1, 1, 1, 1, 1, 1, 1, 1, 1, 2, 2, 1, 3, 3, 3]","['compartilhar', 'espalhar', 'replicar']","[1, 1, 1]",25,3,28,1
8982,"['anvisa', 'anvisa', 'aplicacao', 'aprovacao', 'condicao', 'etapa', 'fase', 'fase', 'fase', 'instituto', 'parceria', 'perspectivo', 'superar', 'testagem']","[2, 2, 1, 1, 1, 1, 3, 3, 3, 1, 1, 1, 1, 1]","[]","[]",14,0,14,1
8983,"['amplo', 'arthur', 'decorrent', 'demmg', 'facilitar', 'imunizacao', 'imunizacao', 'lira', 'pacheco', 'plenario', 'ppal', 'privar', 'reuniao', 'reuter', 'saudar', 'saudar']","[1, 1, 1, 1, 1, 2, 2, 1, 1, 1, 1, 1, 1, 1, 2, 2]","[]","[]",16,0,16,1
8984,"['assintomatico', 'decisao', 'instituto', 'lesao', 'possibilidad', 'possibilidad', 'reuniao', 'saudar', 'saudar', 'saudar', 'suspeito']","[1, 1, 1, 1, 2, 2, 1, 3, 3, 3, 1]","[]","[]",11,0,11,1
8987,"['anticorpo', 'anticorpo', 'anticorpo', 'anticorpo', 'avancar', 'especializar', 'expectativa', 'fase', 'imunizacao', 'instituto', 'preliminar', 'respostar']","[4, 4, 4, 4, 1, 1, 1, 1, 1, 1, 1, 1]","[]","[]",12,0,12,1
8990,"['arthur', 'calheiro', 'calheiro', 'comissao', 'flavio', 'gabinet', 'inquerito', 'lira', 'rachadinha', 'vespera']","[1, 2, 2, 1, 1, 1, 1, 1, 1, 1]","['assaltar', 'imagem', 'vagabundar', 'vagabundar']","[1, 1, 2, 2]",10,4,14,1
8993,"['absoluto', 'consorcio', 'deteccao', 'epidemiar', 'folhar', 'folhar', 'infectar', 'integro', 'risco', 'superar']","[1, 1, 1, 1, 2, 2, 1, 1, 1, 1]","[]","[]",10,0,10,1
8995,"['autoridad', 'kong', 'monitoram', 'portavoz', 'saudar', 'suspeito', 'transmissao']","[1, 1, 1, 1, 1, 1, 1]","['espalhar']","[1]",7,1,8,1
8996,"['assistencia', 'compromisso', 'demmg', 'favorito', 'necessario', 'pacheco', 'pacheco', 'pacheco', 'plenario', 'reafirmar', 'situacao', 'vulnerabilidad']","[1, 1, 1, 1, 1, 3, 3, 3, 1, 1, 1, 1]","[]","[]",12,0,12,1
8997,"['autoridad', 'claudio', 'decisao', 'entregu', 'lewandowski', 'lewandowski', 'pedido', 'plantao', 'ricardo', 'supremo']","[1, 1, 1, 1, 2, 2, 1, 1, 1, 1]","[]","[]",10,0,10,1
8999,"['exigencia', 'externo', 'plano', 'prever', 'previsao', 'saudar', 'suprimento']","[1, 1, 1, 1, 1, 1, 1]","[]","[]",7,0,7,1
9000,"['balancar', 'consolidar', 'consorcio', 'dosar', 'dosar', 'dosar', 'dosar', 'intervalar']","[1, 1, 1, 4, 4, 4, 4, 1]","[]","[]",8,0,8,1
9001,"['complicacao', 'decorrencia', 'diagnosticar', 'funcao', 'funcao', 'internar', 'internar', 'respiratorio', 'saudar', 'transferir']","[1, 1, 1, 2, 2, 2, 2, 1, 1, 1]","[]","[]",10,0,10,1
9004,"['afetado', 'aprovacao', 'arthur', 'condicao', 'discussao', 'facilitar', 'fase', 'juro', 'lira', 'parcelar', 'plenario', 'ppal', 'preservar', 'prever', 'prever', 'proposto', 'proposto', 'renata', 'sessao']","[1, 1, 1, 1, 1, 1, 1, 1, 1, 1, 1, 1, 1, 2, 2, 2, 2, 1, 1]","[]","[]",19,0,19,1
9007,"['alcolumbr', 'bruno', 'henriqu', 'porqu', 'quatro']","[1, 1, 1, 1, 1]","[]","[]",5,0,5,1
9008,"['contabilizar', 'desmatamento', 'desmatamento', 'desmatamento', 'instituto', 'mudanca', 'taxar', 'taxar']","[1, 3, 3, 3, 1, 1, 2, 2]","['carbono', 'carbono']","[2, 2]",8,2,10,1
9009,"['especifico', 'machadar', 'metropolitano', 'regiao', 'ribeiro']","[1, 1, 1, 1, 1]","['mesario', 'mesario']","[2, 2]",5,2,7,1
9012,"['bolsonarista', 'carat', 'conduta', 'conformar', 'dificuldad', 'domingo', 'internar', 'legislativo', 'ministrar', 'sabado']","[1, 1, 1, 1, 1, 1, 1, 1, 1, 1]","[]","[]",10,0,10,1
9013,"['ambientar', 'andrea', 'cenario', 'chefiar', 'converso', 'converso', 'decisao', 'jorg', 'jorg', 'pastar', 'saudar']","[1, 1, 1, 1, 2, 2, 1, 2, 2, 1, 1]","[]","[]",11,0,11,1
9014,"['levantamento', 'preliminar']","[1, 1]","[]","[]",2,0,2,1
9015,"['infectar', 'intensivo', 'internar', 'internar', 'surtir', 'viagem']","[1, 1, 2, 2, 1, 1]","['arquivar', 'garganta', 'imagem']","[1, 1, 1]",6,3,9,1
9016,"['confirmado', 'confirmado', 'hipertensao', 'sabado', 'sabado', 'sabado', 'tambem']","[2, 2, 1, 3, 3, 3, 1]","[]","[]",7,0,7,1
9017,"['adhanom', 'alteracao', 'anticorpo', 'comportamento', 'consequencia', 'importancia', 'mutacao', 'mutacao', 'mutacao', 'reforcar', 'saudar', 'tedro', 'transmissao', 'variacao']","[1, 1, 1, 1, 1, 1, 3, 3, 3, 1, 1, 1, 1, 1]","[]","[]",14,0,14,1
9020,"['compromisso', 'demrj', 'economia', 'necessario', 'reafirmar']","[1, 1, 1, 1, 1]","[]","[]",5,0,5,1
9022,"['anvisa', 'cenario', 'conformar', 'epidemiologico', 'impactar', 'republico', 'republico', 'saudar', 'vigilancia']","[1, 1, 1, 1, 1, 2, 2, 1, 1]","[]","[]",9,0,9,1
9023,"['avancar', 'chefiar', 'circulacao', 'enquadrar']","[1, 1, 1, 1]","[]","[]",4,0,4,1
9024,"['avancar', 'crescimento', 'habitant', 'positivar', 'taxar', 'taxar']","[1, 1, 1, 1, 2, 2]","[]","[]",6,0,6,1
9025,"['acordo', 'articulacao', 'conjuntar', 'conjunto', 'constituicao', 'constituicao', 'convencao', 'desenvolvimento', 'destacar', 'destacar', 'destinar', 'escalar', 'estrategia', 'exercicio', 'externo', 'fundamentar', 'fundamentar', 'importancia', 'inclusao', 'independentement', 'individuar', 'inglaterra', 'iniciativo', 'instalacao', 'necessario', 'precedent', 'respostar', 'respostar', 'sobretudo', 'viagem']","[1, 1, 1, 1, 2, 2, 1, 1, 2, 2, 1, 1, 1, 1, 1, 2, 2, 1, 1, 1, 1, 1, 1, 1, 1, 1, 2, 2, 1, 1]","['humanar', 'humanar', 'manipulacao']","[2, 2, 1]",30,3,33,1
9026,"['afp', 'epidemiar', 'epidemiar', 'liderar', 'turistico']","[1, 2, 2, 1, 1]","[]","[]",5,0,5,1
9027,"['conflito', 'decisao', 'edson', 'fachin', 'fachin', 'plenario', 'processo', 'proximo', 'supremo', 'supremo', 'wilson', 'witzel']","[1, 1, 1, 2, 2, 1, 1, 1, 2, 2, 1, 1]","[]","[]",12,0,12,1
9028,"['balancar', 'investigacao', 'saudar', 'saudar']","[1, 1, 2, 2]","[]","[]",4,0,4,1
9029,"['anvisa', 'anvisa', 'enfrentamento', 'estatistico', 'geografia', 'ibg', 'infraestrutura', 'instituto', 'intensivo', 'monitoramento', 'parceria', 'regiao', 'regiao', 'ricardo', 'saudar', 'saudar', 'saudar', 'saudar', 'saudar', 'vigilancia']","[2, 2, 1, 1, 1, 1, 1, 1, 1, 1, 1, 2, 2, 1, 5, 5, 5, 5, 5, 1]","[]","[]",20,0,20,1
9030,"['balancar', 'balancar', 'balancar', 'circulacao', 'compilar', 'estimativo', 'gabbardo', 'internar', 'letalidad', 'pastar', 'perspectivo', 'projecao', 'reducao', 'saudar', 'saudar', 'secretarioexecutivo', 'sudest', 'taxar']","[3, 3, 3, 1, 1, 1, 1, 1, 1, 1, 1, 1, 1, 2, 2, 1, 1, 1]","[]","[]",18,0,18,1
9031,"['edson', 'fachin', 'fachin', 'fachin', 'julgamento', 'ministrar', 'ministrar', 'preconceito', 'prtb', 'reafirmar', 'supremo']","[1, 3, 3, 3, 1, 2, 2, 1, 1, 1, 1]","[]","[]",11,0,11,1
9034,"['absoluto', 'absoluto', 'conformar', 'conformar', 'consorcio', 'habitant', 'habitant', 'habitant', 'liderar', 'mexico', 'ritmar', 'semestr', 'taxar']","[2, 2, 2, 2, 1, 3, 3, 3, 1, 1, 1, 1, 1]","[]","[]",13,0,13,1
9038,"['araujo', 'avancar', 'converso', 'converso', 'ernesto', 'estrategico', 'interlocutor', 'reforcar']","[1, 1, 2, 2, 1, 1, 1, 1]","[]","[]",8,0,8,1
9040,"['celebrar', 'decorrencia', 'espanha', 'espanha', 'levantamento']","[1, 1, 2, 2, 1]","['camisa', 'cuspir', 'cuspir', 'imagem']","[1, 2, 2, 1]",5,4,9,1
9041,"['apurar', 'distrito', 'dosar', 'elaborar', 'enfrentamento', 'estrategia', 'instaurar', 'irregularidad', 'justicar', 'levantamento', 'operacionalizacao', 'permanencia', 'planar', 'planar', 'planar', 'plano', 'previsto', 'prioridad', 'prioritario', 'prioritario', 'regiao', 'republico', 'saudar', 'saudar']","[1, 1, 1, 1, 1, 1, 1, 1, 1, 1, 1, 1, 3, 3, 3, 1, 1, 1, 2, 2, 1, 1, 2, 2]","[]","[]",24,0,24,1
9043,"['acumular', 'acumular', 'comparacao', 'condicao', 'conformar', 'dificuldad', 'observar', 'recuar', 'recuperacao', 'recuperacao', 'recuperacao', 'recuperacao', 'respectivament', 'subir', 'taxar', 'tendencia']","[2, 2, 1, 1, 1, 1, 1, 1, 4, 4, 4, 4, 1, 1, 1, 1]","[]","[]",16,0,16,1
9044,"['biliao', 'client', 'emprestimo', 'reforcar']","[1, 1, 1, 1]","[]","[]",4,0,4,1
9046,"['alergia', 'alergia', 'alergia', 'associacao', 'autoridad', 'imunizacao', 'marinhar', 'observar', 'precaucao', 'preocupacao', 'reportar', 'saudar', 'significativo']","[3, 3, 3, 1, 1, 1, 1, 1, 1, 1, 1, 1, 1]","[]","[]",13,0,13,1
9049,"['academico', 'alteracao', 'californio', 'decisao', 'economia', 'impactar', 'modelo', 'pratico', 'prazo', 'presenciar', 'reabertura', 'regrar', 'ribeiro', 'ribeiro', 'ribeiro']","[1, 1, 1, 1, 1, 1, 1, 1, 1, 1, 1, 1, 3, 3, 3]","['arquivar', 'imagem']","[1, 1]",15,2,17,1
9051,"['biliao', 'congresso', 'economia', 'economia', 'emendar', 'gued', 'ministrar', 'ministrar', 'periodo', 'proposto']","[1, 1, 2, 2, 1, 1, 2, 2, 1, 1]","[]","[]",10,0,10,1
9053,"['acordo', 'desenvolvimento', 'desenvolvimento', 'estagio', 'fase', 'fase', 'fase', 'fornecimento', 'instituto', 'moderno', 'parceria', 'saudar', 'sputnik']","[1, 2, 2, 1, 3, 3, 3, 1, 1, 1, 1, 1, 1]","[]","[]",13,0,13,1
9059,"['anuncio', 'crescimento', 'decisao', 'emergenciai', 'estimativo', 'infectar', 'infectar', 'infectar', 'positivar', 'propagacao', 'prorrogacao', 'prorrogar', 'reuniao', 'taxar', 'transmissao', 'wellington']","[1, 1, 1, 1, 1, 3, 3, 3, 1, 1, 1, 1, 1, 1, 1, 1]","[]","[]",16,0,16,1
9060,"['congresso', 'consumidor', 'decisao', 'economia', 'economia', 'gued', 'gued', 'gued', 'interlocutor', 'legislativo', 'ministrar', 'ministrar', 'mudanca', 'mudanca', 'periodo', 'prever', 'previsao', 'provisorio', 'reuniao', 'taxar']","[1, 1, 1, 2, 2, 3, 3, 3, 1, 1, 2, 2, 2, 2, 1, 1, 1, 1, 1, 1]","[]","[]",20,0,20,1
9062,"['levantamento', 'primeiroministro', 'propagacao', 'regiao', 'regiao', 'saudar', 'velocidad']","[1, 1, 1, 2, 2, 1, 1]","['parir', 'parir']","[2, 2]",7,2,9,1
9063,"['enfrentamento', 'fase', 'moderno', 'pastar', 'pastar', 'prever', 'prever', 'reuter', 'saudar', 'secretarioexecutivo', 'sessao']","[1, 1, 1, 2, 2, 2, 2, 1, 1, 1, 1]","[]","[]",11,0,11,1
9067,"['ambito', 'cenario', 'cenario', 'condicao', 'condicao', 'efetividad', 'enfrentamento', 'enfrentamento', 'entregu', 'reforcar', 'saudar', 'saudar', 'situacao']","[1, 2, 2, 2, 2, 1, 2, 2, 1, 1, 2, 2, 1]","['realment']","[1]",13,1,14,1
9069,"['equipamento', 'equipamento', 'equipamento', 'equipamento', 'positivar', 'presenca', 'regiao', 'respiratorio']","[4, 4, 4, 4, 1, 1, 1, 1]","['verificar', 'visualizar']","[1, 1]",8,2,10,1
9070,"['advocaciager', 'ambito', 'confederacao', 'equipamento', 'escassez', 'escassez', 'iniciativo', 'opcao', 'pastar', 'previo', 'privar', 'privar', 'privar', 'privar', 'saudar', 'saudar', 'situacao', 'supremo', 'suprimento']","[1, 1, 1, 1, 2, 2, 1, 1, 1, 1, 4, 4, 4, 4, 2, 2, 1, 1, 1]","[]","[]",19,0,19,1
9071,"['colegiado', 'conformar', 'externo', 'humberto', 'integro', 'julgamento', 'justicar', 'justicar', 'martim', 'martim', 'oferecido', 'paralisar', 'processo', 'recuperacao', 'reuter', 'servidor']","[1, 1, 1, 1, 1, 1, 2, 2, 2, 2, 1, 1, 1, 1, 1, 1]","['usuario']","[1]",16,1,17,1
9072,"['decisao', 'desembarcar', 'domingo', 'epidemiar', 'necessario', 'pastar', 'periodo', 'quarentenar', 'situacao']","[1, 1, 1, 1, 1, 1, 1, 1, 1]","[]","[]",9,0,9,1
9073,"['assistencia', 'autonomia', 'autonomia', 'cerimonia', 'congresso', 'economia', 'gued', 'lorenzoni', 'ministrar', 'ministrar', 'ministrar', 'onyx', 'onyx', 'onyx', 'palacio', 'pastar', 'planalto', 'planar', 'presenca', 'republico', 'republico', 'sancao']","[1, 2, 2, 1, 1, 1, 1, 1, 3, 3, 3, 3, 3, 3, 1, 1, 1, 1, 1, 2, 2, 1]","[]","[]",22,0,22,1
9074,"['decisao', 'deslocamento', 'heleno', 'justicar', 'mudanca', 'orientacao', 'palacio', 'palacio', 'palacio', 'palacio', 'periodo', 'permanencia', 'wilson', 'witzel', 'witzel', 'witzel', 'witzel', 'witzel']","[1, 1, 1, 1, 1, 1, 4, 4, 4, 4, 1, 1, 1, 5, 5, 5, 5, 5]","['despejar', 'despejar']","[2, 2]",18,2,20,1
9076,"['particularment', 'temporada']","[1, 1]","['estranhar']","[1]",2,1,3,1
9077,"['aurelio', 'consequencia', 'exministro', 'julgamento', 'justicar', 'precisao', 'suspeicao']","[1, 1, 1, 1, 1, 1, 1]","['atirar', 'imagem']","[1, 1]",7,2,9,1
9078,"['amplo', 'bandeirant', 'circulacao', 'concedido', 'crise', 'desafiar', 'desenvolvimento', 'epidemiar', 'instituto', 'normalment', 'palacio', 'particularment', 'saudar', 'semestr']","[1, 1, 1, 1, 1, 1, 1, 1, 1, 1, 1, 1, 1, 1]","['circular']","[1]",14,1,15,1
9081,"['consorcio', 'infectar', 'levantamento', 'notificar', 'periodo', 'recordar', 'saudar', 'totalizar']","[1, 1, 1, 1, 1, 1, 1, 1]","[]","[]",8,0,8,1
9082,"['compilar', 'fronteiro', 'integro', 'levantamento']","[1, 1, 1, 1]","[]","[]",4,0,4,1
9083,"['conformar', 'parceiro', 'pastar', 'respostar']","[1, 1, 1, 1]","['vc']","[1]",4,1,5,1
9084,"['atuam', 'possibilidad', 'projeco', 'recurso', 'servidor', 'suspensao', 'temporario']","[1, 1, 1, 1, 1, 1, 1]","[]","[]",7,0,7,1
9085,"['aglomeracao', 'circulacao', 'circulacao', 'claudio', 'claudio', 'constatar', 'individuar', 'necessario', 'periodo']","[1, 2, 2, 2, 2, 1, 1, 1, 1]","[]","[]",9,0,9,1
9086,"['alcolumbr', 'aliquota', 'comissao', 'comissao', 'congresso', 'congresso', 'contribuicao', 'discussao', 'economia', 'estimular', 'estrategia', 'folhar', 'gued', 'gued', 'gued', 'gued', 'gued', 'ministrar', 'ministrar', 'ministrar', 'pagamento', 'painel', 'prazo', 'proposto', 'proposto', 'proposto', 'reducao', 'sugestao', 'tributario']","[1, 1, 2, 2, 2, 2, 1, 1, 1, 1, 1, 1, 5, 5, 5, 5, 5, 3, 3, 3, 1, 1, 1, 3, 3, 3, 1, 1, 1]","[]","[]",29,0,29,1
9088,"['administrativo', 'comissao', 'comissao', 'comissao', 'congresso', 'discussao', 'improbidad', 'improbidad', 'jurista', 'mudanca', 'previsto', 'proposta', 'proposta', 'punicao', 'ricardo', 'supremo']","[1, 3, 3, 3, 1, 1, 2, 2, 1, 1, 1, 2, 2, 1, 1, 1]","['versao']","[1]",16,1,17,1
9090,"['acompanhamento', 'autonomia', 'californio', 'comorbidad', 'decisao', 'depressao', 'desempenhar', 'diagnosticar', 'dificuldad', 'dinamarca', 'independentement', 'letalidad', 'levantamento', 'necessidad', 'quadro', 'saudar', 'saudar', 'situacao', 'suportar']","[1, 1, 1, 1, 1, 1, 1, 1, 1, 1, 1, 1, 1, 1, 1, 2, 2, 1, 1]","['humanar']","[1]",19,1,20,1
9093,"['ansiedad']","[1]","['quinzena']","[1]",1,1,2,1
9099,"['destacar', 'globonew', 'impactar']","[1, 1, 1]","[]","[]",3,0,3,1
9100,"['ambientar', 'antecipar', 'autorizacao', 'client', 'client', 'flexibilizacao', 'funcao', 'funcionamento', 'intervalar', 'planar', 'prever', 'previo', 'reabrir', 'relativo', 'republicanosrj', 'salao', 'salao', 'salao', 'salao', 'ventilacao']","[1, 1, 1, 2, 2, 1, 1, 1, 1, 1, 1, 1, 1, 1, 1, 4, 4, 4, 4, 1]","[]","[]",20,0,20,1
9102,"['circulacao', 'consequencia', 'crise', 'expansao', 'periodo', 'reducao', 'reducao', 'respectivament', 'ricardo', 'volumar']","[1, 1, 1, 1, 1, 2, 2, 1, 1, 1]","['cbn']","[1]",10,1,11,1
9104,"['atuam', 'decisao', 'edson', 'fachin', 'fachin', 'integro', 'investigacao', 'julgamento', 'ministrar', 'plenario', 'recurso', 'republico', 'supremo']","[1, 1, 1, 2, 2, 1, 1, 1, 1, 1, 1, 1, 1]","[]","[]",13,0,13,1
9106,"['destacar', 'fase', 'metropolitano', 'metropolitano', 'mudanca', 'regiao', 'regiao', 'regiao', 'regiao', 'regiao', 'regiao', 'regiao', 'restritivo', 'saudar', 'sudest']","[1, 1, 2, 2, 1, 7, 7, 7, 7, 7, 7, 7, 1, 1, 1]","[]","[]",15,0,15,1
9107,"['cenario', 'cenario', 'dificultar', 'facilitar', 'integrant', 'preliminar', 'republico', 'sabado', 'sessao', 'supremo', 'temor', 'turma']","[2, 2, 1, 1, 1, 1, 1, 1, 1, 1, 1, 1]","[]","[]",12,0,12,1
9109,"['contabilizar', 'estatistico', 'habitant', 'infectar', 'ministrar', 'ministrar', 'pastar', 'sabado', 'sabado', 'saudar', 'saudar', 'saudar', 'saudar']","[1, 1, 1, 1, 2, 2, 1, 2, 2, 4, 4, 4, 4]","[]","[]",13,0,13,1
9110,"['bandeirant', 'compromisso', 'consecutivo', 'consequencia', 'decisao', 'decisao', 'flexibilizacao', 'flexibilizacao', 'flexibilizar', 'metropolitano', 'metropolitano', 'observar', 'palacio', 'preocupacao', 'preocupacao', 'projeco', 'quarentenar', 'regiao', 'regiao', 'revisar', 'saudar', 'taxar', 'tendencia']","[1, 1, 1, 1, 2, 2, 2, 2, 1, 2, 2, 1, 1, 2, 2, 1, 1, 2, 2, 1, 1, 1, 1]","[]","[]",23,0,23,1
9113,"['acordo', 'contrato', 'cooperacao', 'decisao', 'decisao', 'delacao', 'forcatarefa', 'forcatarefa', 'integro', 'lewandowski', 'ministrar', 'ricardo', 'supremo', 'varar']","[1, 1, 1, 2, 2, 1, 2, 2, 1, 1, 1, 1, 1, 1]","[]","[]",14,0,14,1
9114,"['converso', 'dificuldad', 'flavio', 'mandatario', 'possibilidad', 'previo', 'treino', 'treino', 'wilson', 'witzel']","[1, 1, 1, 1, 1, 1, 2, 2, 1, 1]","[]","[]",10,0,10,1
9116,"['aliquota', 'congresso', 'economia', 'emendar', 'gued', 'gued', 'gued', 'ministrar', 'planalto', 'privar', 'proposto', 'proposto', 'rejeitar', 'tributario']","[1, 1, 1, 1, 3, 3, 3, 1, 1, 1, 2, 2, 1, 1]","[]","[]",14,0,14,1
9117,"['carla', 'supremo', 'suspeito']","[1, 1, 1]","['imagem']","[1]",3,1,4,1
9118,"['autoridad', 'conjuntar', 'distrito', 'instituto', 'palacio', 'palacio', 'planalto']","[1, 1, 1, 1, 2, 2, 1]","[]","[]",7,0,7,1
9120,"['batalhar', 'dificuldad', 'epidemiar', 'periferia']","[1, 1, 1, 1]","[]","[]",4,0,4,1
9122,"['andrew', 'gabi', 'respostar']","[1, 1, 1]","['privacidad', 'usuario', 'versao']","[1, 1, 1]",3,3,6,1
9126,"['ambito', 'apurar', 'avancar', 'broadcast', 'condicao', 'condicao', 'converso', 'crise', 'discussao', 'emprestimo', 'especifico', 'flexibilizar', 'flexibilizar', 'folhar', 'impactar', 'implementacao', 'jornada', 'mantido', 'manutencao', 'mudanca', 'pagamento', 'parcelar', 'parcelar', 'parcelar', 'periodo', 'proporcao', 'provisorio', 'suspenso', 'suspenso', 'temporario']","[1, 1, 1, 1, 2, 2, 1, 1, 1, 1, 1, 2, 2, 1, 1, 1, 1, 1, 1, 1, 1, 3, 3, 3, 1, 1, 1, 2, 2, 1]","[]","[]",30,0,30,1
9128,"['complicacao', 'decorrencia', 'domingo', 'esperancar', 'internar', 'intervalar', 'pereira', 'pereira', 'piorar', 'prazo', 'presenca', 'recuperacao']","[1, 1, 1, 1, 1, 1, 2, 2, 1, 1, 1, 1]","['verdadeiro']","[1]",12,1,13,1
9129,"['ambientar', 'parceria']","[1, 1]","['arvor', 'lixar']","[1, 1]",2,2,4,1
9131,"['conformar', 'conjuntar', 'especifico', 'instituto', 'planar', 'preliminar', 'preventivo', 'respiratorio', 'saudar', 'saudar', 'saudar', 'transmissao']","[1, 1, 1, 1, 1, 1, 1, 1, 3, 3, 3, 1]","[]","[]",12,0,12,1
9133,"['circulacao', 'companhia', 'equipamento', 'notificar', 'positivar', 'sindicato', 'sindicato', 'sindicato']","[1, 1, 1, 1, 1, 3, 3, 3]","[]","[]",8,0,8,1
9134,"['autoridad', 'diplomata', 'diplomata', 'portavoz', 'queixar']","[1, 2, 2, 1, 1]","['enganir']","[1]",5,1,6,1
9135,"['bruno', 'parceria', 'ricardo', 'spaulo', 'transmissao']","[1, 1, 1, 1, 1]","[]","[]",5,0,5,1
9138,"['aplicacao', 'atrasar', 'demrj', 'dosar', 'dosar', 'fluminens']","[1, 1, 1, 2, 2, 1]","[]","[]",6,0,6,1
9140,"['alvorar', 'cilindro', 'cilindro', 'cilindro', 'cilindro', 'cilindro', 'destinar', 'destinar', 'fundacao', 'fundacao', 'pastar', 'saudar', 'saudar']","[1, 5, 5, 5, 5, 5, 2, 2, 2, 2, 1, 2, 2]","['invadir', 'soldar']","[1, 1]",13,2,15,1
9143,"['conjuntar', 'crise', 'infancia', 'monetario', 'previsao', 'projeco', 'sobretudo']","[1, 1, 1, 1, 1, 1, 1]","[]","[]",7,0,7,1
9144,"['alvorar', 'palacio']","[1, 1]","['supostament']","[1]",2,1,3,1
9146,"['exonerar', 'investigacao', 'orientacao', 'oswaldo', 'palacio', 'pastar', 'pastar', 'planalto', 'supremo']","[1, 1, 1, 1, 1, 2, 2, 1, 1]","[]","[]",9,0,9,1
9148,"['acompanhamento', 'acumular', 'diagnosticar', 'saudar']","[1, 1, 1, 1]","[]","[]",4,0,4,1
9152,"['anteontem', 'competicao', 'competicao', 'decisao', 'decisao', 'positivar', 'prioridad', 'tornear', 'tornear', 'tornear', 'treinar']","[1, 2, 2, 2, 2, 1, 1, 3, 3, 3, 1]","[]","[]",11,0,11,1
9153,"['dosar', 'dosar', 'dosar', 'infectar', 'inglaterra', 'ministrar', 'observar', 'saudar', 'saudar', 'transmissao']","[3, 3, 3, 1, 1, 1, 1, 2, 2, 1]","[]","[]",10,0,10,1
9154,"['crescimento', 'discussao', 'flexibilizar', 'habitant', 'infeccioso', 'instituto']","[1, 1, 1, 1, 1, 1]","[]","[]",6,0,6,1
9156,"['bastidor', 'bastidor', 'colunista', 'decisao', 'palacio', 'supremo', 'supremo', 'supremo', 'supremo', 'supremo']","[2, 2, 1, 1, 1, 5, 5, 5, 5, 5]","['misturar']","[1]",10,1,11,1
9157,"['converso', 'crise', 'itamarati', 'itamarati']","[1, 1, 2, 2]","['terrorismo']","[1]",4,1,5,1
9158,"['anvisa', 'anvisa', 'anvisa', 'anvisa', 'circulacao', 'determinacao', 'diretoria', 'fronteiro', 'mudanca', 'mudanca', 'necessario', 'regrar', 'vigilancia']","[4, 4, 4, 4, 1, 1, 1, 1, 2, 2, 1, 1, 1]","[]","[]",13,0,13,1
9161,"['comunitario', 'decisao', 'decisao', 'decisao', 'opcao', 'opcao', 'proposto', 'recurso', 'situacao']","[1, 3, 3, 3, 2, 2, 1, 1, 1]","['implantar']","[1]",9,1,10,1
9162,"['araujo', 'arrecadar', 'bolsonarista', 'elaborar', 'ernesto', 'estrategia', 'fronteiro', 'mexico', 'mexico', 'ministrar', 'negativar', 'recurso', 'recurso']","[1, 1, 1, 1, 1, 1, 1, 2, 2, 1, 1, 2, 2]","['manipulacao']","[1]",13,1,14,1
9163,"['boletim', 'condicao', 'especifico', 'intensivo', 'jorg', 'jorg', 'previsao', 'previsao', 'quadro', 'quadro']","[1, 1, 1, 1, 2, 2, 2, 2, 2, 2]","[]","[]",10,0,10,1
9166,"['autorizacao', 'coletivo', 'fase', 'funcionamento', 'individuar', 'pratico', 'pratico', 'pratico', 'privar', 'reabertura', 'rocha']","[1, 1, 1, 1, 1, 3, 3, 3, 1, 1, 1]","[]","[]",11,0,11,1
9169,"['ambientar', 'ambientar', 'ambientar', 'arrecadar', 'azevedo', 'azevedo', 'desenvolvimento', 'mudanca', 'recurso']","[3, 3, 3, 1, 2, 2, 1, 1, 1]","['pego']","[1]",9,1,10,1
9170,"['anteontem', 'bandeirant', 'imunizacao', 'opcao', 'opcao', 'palacio', 'possibilidad']","[1, 1, 1, 2, 2, 1, 1]","['cristao']","[1]",7,1,8,1
9174,"['afp', 'autoridad', 'dosar', 'europeu', 'europeu', 'merkel', 'sputnik']","[1, 1, 1, 2, 2, 1, 1]","[]","[]",7,0,7,1
9175,"['ambientar', 'desenvolvido', 'deteccao', 'enfermagem', 'etapa', 'fase', 'plantao', 'possibilidad', 'precisao', 'reconhecimento', 'triagem']","[1, 1, 1, 1, 1, 1, 1, 1, 1, 1, 1]","[]","[]",11,0,11,1
9177,"['interferencia', 'mudanca', 'mudanca', 'respostar', 'saudar', 'saudar']","[1, 2, 2, 1, 2, 2]","['obama', 'parir']","[1, 1]",6,2,8,1
9179,"['client', 'regiao']","[1, 1]","[]","[]",2,0,2,1
9181,"['anteontem', 'campino', 'campino', 'campino', 'campino', 'dedicar', 'equipamento', 'fase', 'fase', 'flexibilizacao', 'globonew', 'metropolitano', 'metropolitano', 'metropolitano', 'necessario', 'planar', 'regiao', 'regiao', 'regiao', 'rocha', 'saudar']","[1, 4, 4, 4, 4, 1, 1, 2, 2, 1, 1, 3, 3, 3, 1, 1, 3, 3, 3, 1, 1]","[]","[]",21,0,21,1
9183,"['diagnosticar', 'distrito', 'distrito', 'domingo', 'domingo', 'estrategico', 'instituto', 'internar', 'palacio', 'piorar', 'planalto', 'saudar', 'transferir']","[1, 2, 2, 2, 2, 1, 1, 1, 1, 1, 1, 1, 1]","[]","[]",13,0,13,1
9184,"['administrativo', 'afastamento', 'apurar', 'improbidad', 'privar', 'recebido', 'republico']","[1, 1, 1, 1, 1, 1, 1]","[]","[]",7,0,7,1
9186,"['boletim', 'epidemiologico', 'hipertensao', 'instituto', 'intensivo', 'internar', 'pastar', 'positivar', 'pulmonar', 'saudar', 'transferir']","[1, 1, 1, 1, 1, 1, 1, 1, 1, 1, 1]","['menino']","[1]",11,1,12,1
9190,"['atuam', 'constituicao', 'constituicao', 'estabilidad', 'reuter']","[1, 2, 2, 1, 1]","[]","[]",5,0,5,1
9194,"['decisao', 'dedicar', 'destacar', 'espirito', 'estrategia', 'igualitario', 'impactar', 'infectar', 'iniciativo', 'intensivo', 'internacao', 'jurista', 'necessario', 'plano', 'preservar', 'prever', 'prioridad', 'privar', 'privar', 'privar', 'recurso', 'saudar', 'saudar', 'saudar', 'saudar', 'saudar', 'taxar']","[1, 1, 1, 1, 1, 1, 1, 1, 1, 1, 1, 1, 1, 1, 1, 1, 1, 3, 3, 3, 1, 5, 5, 5, 5, 5, 1]","[]","[]",27,0,27,1
9195,"['associacao', 'prioridad', 'rotina', 'rotina', 'souza']","[1, 1, 2, 2, 1]","[]","[]",5,0,5,1
9196,"[]","[]","[]","[]",0,0,0,1
9198,"['comportamento', 'flexibilizar', 'mudanca', 'periodo', 'propagacao', 'regrar']","[1, 1, 1, 1, 1, 1]","['menino', 'menino']","[2, 2]",6,2,8,1
9199,"['boletim', 'federar', 'internar', 'internar', 'regiao']","[1, 1, 2, 2, 1]","['estomago']","[1]",5,1,6,1
9201,"['alerj', 'alerj', 'antonio', 'flavio', 'flavio', 'gabinet', 'gabinet', 'gabinet', 'investigacao', 'legislativo', 'planalto', 'processo', 'rachadinha', 'respectivament']","[2, 2, 1, 2, 2, 3, 3, 3, 1, 1, 1, 1, 1, 1]","['sacar']","[1]",14,1,15,1
9203,"['domingo', 'habitant', 'oliveira', 'proporcao']","[1, 1, 1, 1]","[]","[]",4,0,4,1
9205,"['biliao', 'biliao', 'desenvolvido', 'institut', 'instituto', 'levantamento', 'opcao', 'parceria', 'realizacao']","[2, 2, 1, 1, 1, 1, 1, 1, 1]","[]","[]",9,0,9,1
9207,"['adulto', 'autoridad', 'disseminacao', 'expressar', 'humanitario', 'reforcar', 'respostar', 'situacao', 'situacao', 'situacao', 'viagem']","[1, 1, 1, 1, 1, 1, 1, 3, 3, 3, 1]","[]","[]",11,0,11,1
9208,"['anticorpo', 'aprovacao', 'compromisso', 'desenvolvido', 'etapa', 'fase', 'moderno', 'negativar', 'transferencia']","[1, 1, 1, 1, 1, 1, 1, 1, 1]","['checar']","[1]",9,1,10,1
9210,"['atuam', 'cirurgico', 'desembarcar', 'domingo', 'infectar', 'inicialment', 'integrant', 'previsao', 'quarentenar', 'risco', 'rotina', 'sabado', 'sabado']","[1, 1, 1, 1, 1, 1, 1, 1, 1, 1, 1, 2, 2]","[]","[]",13,0,13,1
9211,"['definitivo', 'epidemiologico', 'intensivo', 'intensivo', 'internacao', 'internar', 'internar', 'observacao', 'recebido', 'transferir', 'vigilancia']","[1, 1, 2, 2, 1, 2, 2, 1, 1, 1, 1]","[]","[]",11,0,11,1
9212,"['arrecadar', 'necessidad', 'plano', 'recurso', 'serao']","[1, 1, 1, 1, 1]","[]","[]",5,0,5,1
9213,"['autoridad', 'boletim', 'boletim', 'fluminens', 'internar', 'investigacao', 'metropolitano', 'regiao', 'saudar', 'saudar']","[1, 2, 2, 1, 1, 1, 1, 1, 2, 2]","[]","[]",10,0,10,1
9214,"['colegio', 'colegio', 'decisao', 'descumprimento', 'justicar', 'magistrado', 'presenciar', 'recebido', 'sindicato', 'varar']","[2, 2, 1, 1, 1, 1, 1, 1, 1, 1]","[]","[]",10,0,10,1
9215,"['positivar']","[1]","['checar']","[1]",1,1,2,1
9220,"['ambito', 'comissao', 'competicao', 'conduta', 'decisao', 'etapa', 'justicar', 'justicar', 'punicao', 'regulamentar', 'regulamentar']","[1, 1, 1, 1, 1, 1, 2, 2, 1, 2, 2]","['arquivar']","[1]",11,1,12,1
9221,"['carla', 'consorcio', 'consorcio', 'imunizacao', 'iniciativo', 'reuniao', 'saudar']","[1, 2, 2, 1, 1, 1, 1]","[]","[]",7,0,7,1
9222,"['biliao', 'emprestimo', 'emprestimo', 'prazo']","[1, 2, 2, 1]","[]","[]",4,0,4,1
9224,"['acompanhamento', 'acumular', 'diagnosticar', 'saudar']","[1, 1, 1, 1]","[]","[]",4,0,4,1
9225,"['calamidad', 'concedido', 'destinar', 'impacto', 'minimizar', 'necessidad', 'pagamento', 'parcelar', 'prazo', 'prazo', 'prazo', 'reconhecimento', 'requerimento', 'suspensao']","[1, 1, 1, 1, 1, 1, 1, 1, 3, 3, 3, 1, 1, 1]","[]","[]",14,0,14,1
9226,"['cerimonia', 'claudio', 'equipamento', 'exercicio']","[1, 1, 1, 1]","['facada']","[1]",4,1,5,1
9228,"['cnmp', 'cnmp', 'conselho', 'conselho', 'decisao', 'deltan', 'deltan', 'deltan', 'etapa', 'guaruja', 'processo', 'processo', 'recurso', 'supremo', 'tramitacao', 'triplex']","[2, 2, 2, 2, 1, 3, 3, 3, 1, 1, 2, 2, 1, 1, 1, 1]","['arquivar']","[1]",16,1,17,1
9231,"['destinar', 'equipamento', 'equipamento', 'equipamento', 'iniciativo', 'inovacao', 'justificativo', 'privar', 'respirador', 'saudar', 'saudar', 'saudar', 'situacao', 'universitario']","[1, 3, 3, 3, 1, 1, 1, 1, 1, 3, 3, 3, 1, 1]","['parir']","[1]",14,1,15,1
9232,"['iniciativo', 'journal', 'portavoz', 'privar', 'rejeitar']","[1, 1, 1, 1, 1]","[]","[]",5,0,5,1
9235,"['acordo', 'condicao', 'exercicio', 'exercicio', 'lorenzoni', 'ministrar', 'ministrar', 'onyx']","[1, 1, 2, 2, 1, 2, 2, 1]","[]","[]",8,0,8,1
9236,"['aurelio', 'aurelio', 'justicar', 'justicar', 'mello', 'mendonca', 'mendonca', 'mendonca', 'ministrar', 'ministrar', 'ministrar', 'pastar', 'supremo', 'supremo', 'supremo', 'supremo']","[2, 2, 2, 2, 1, 3, 3, 3, 3, 3, 3, 1, 4, 4, 4, 4]","[]","[]",16,0,16,1
9237,"['anuncio', 'anuncio', 'ideologico', 'ideologico', 'pratico', 'supremo']","[2, 2, 2, 2, 1, 1]","[]","[]",6,0,6,1
9241,"['apurar', 'associacao', 'desenvolvimento', 'diretoria', 'exjuiz', 'forcatarefa', 'investigacao', 'irregularidad', 'julgamento', 'lavagem', 'mantido', 'mello', 'obtido', 'processo', 'recurso', 'regiao', 'ribeiro', 'sentenca', 'sentenca', 'suspeito', 'temporariament', 'turma', 'unanimidad']","[1, 1, 1, 1, 1, 1, 1, 1, 1, 1, 1, 1, 1, 1, 1, 1, 1, 2, 2, 1, 1, 1, 1]","['fraudar', 'inocentar']","[1, 1]",23,2,25,1
9244,"['depoimento', 'depoimento', 'depoimento', 'inquerito', 'ramagem', 'ramagem', 'ramagem', 'ramagem', 'tambem']","[3, 3, 3, 1, 4, 4, 4, 4, 1]","[]","[]",9,0,9,1
9247,"['coreia', 'estrategia', 'infectar', 'molecular', 'pastar', 'precisao', 'realizacao', 'respostar', 'saudar', 'saudar']","[1, 1, 1, 1, 1, 1, 1, 1, 2, 2]","[]","[]",10,0,10,1
9249,"['aliquota', 'anuncio', 'arrecadacao', 'congresso', 'contribuicao', 'economia', 'importacao', 'proposta', 'proposta', 'serao']","[1, 1, 1, 1, 1, 1, 1, 2, 2, 1]","[]","[]",10,0,10,1
9251,"['crescimento', 'estrategia', 'mudanca', 'mudanca', 'prtb', 'sigla', 'variacao']","[1, 1, 2, 2, 1, 1, 1]","['legendar']","[1]",7,1,8,1
9253,"['privar', 'situacao', 'suspenso']","[1, 1, 1]","[]","[]",3,0,3,1
9254,"['economia', 'folhar', 'gued', 'impactar', 'iniciativo', 'integro', 'ministrar', 'ministrar', 'recurso', 'transferencia', 'transferencia']","[1, 1, 1, 1, 1, 1, 2, 2, 1, 2, 2]","['ganhar']","[1]",11,1,12,1
9256,"['aprovacao', 'competicao', 'desafiar', 'escalar', 'individuar', 'organizador', 'presenca', 'tornear', 'vespera']","[1, 1, 1, 1, 1, 1, 1, 1, 1]","[]","[]",9,0,9,1
9258,"['autoridad', 'defendido', 'integro', 'saudar', 'saudar', 'suspeito']","[1, 1, 1, 2, 2, 1]","[]","[]",6,0,6,1
9259,"['anticorpo', 'anticorpo', 'antonio', 'anvisa', 'anvisa', 'anvisa', 'anvisa', 'compromisso', 'descumprimento', 'instituto', 'prazo', 'prazo', 'prazo', 'prorrogacao', 'prorrogacao', 'relativo', 'respostar', 'vigilancia']","[2, 2, 1, 4, 4, 4, 4, 1, 1, 1, 3, 3, 3, 2, 2, 1, 1, 1]","[]","[]",18,0,18,1
9260,"['capitar', 'dosar', 'imunizacao', 'levantamento', 'normalment', 'paralisar', 'planar', 'recebido', 'saudar', 'saudar', 'suspenso']","[1, 1, 1, 1, 1, 1, 1, 1, 2, 2, 1]","[]","[]",11,0,11,1
9263,"['academiar', 'aglomeracao', 'ampliacao', 'campino', 'campino', 'cronica', 'fase', 'fase', 'flexibilizacao', 'funcionamento', 'funcionamento', 'habitant', 'metropolitano', 'planar', 'planar', 'planar', 'regiao', 'regiao', 'salao']","[1, 1, 1, 2, 2, 1, 2, 2, 1, 2, 2, 1, 1, 3, 3, 3, 2, 2, 1]","['menino']","[1]",19,1,20,1
9265,"['biliao', 'economia', 'impactar', 'volumar']","[1, 1, 1, 1]","[]","[]",4,0,4,1
9266,"['assistencia', 'atendido', 'crescimento', 'destinar', 'expressivo', 'intensivo', 'internacao', 'isolar', 'saudar', 'saudar', 'situacao', 'situacao']","[1, 1, 1, 1, 1, 1, 1, 1, 2, 2, 2, 2]","['misturar']","[1]",12,1,13,1
9269,"['cepa', 'deteccao', 'fundacao', 'mutacao', 'oswaldo', 'positivar', 'roraima', 'saudar']","[1, 1, 1, 1, 1, 1, 1, 1]","[]","[]",8,0,8,1
9270,"['ambientar', 'ampliacao', 'condicao', 'disseminacao', 'distrito', 'isolar', 'justicar', 'ministrar', 'palacio', 'planalto', 'relativo', 'servidor', 'suspensao', 'suspensao', 'suspenso', 'temor']","[1, 1, 1, 1, 1, 1, 1, 1, 1, 1, 1, 1, 2, 2, 1, 1]","[]","[]",16,0,16,1
9271,"['assintomatico', 'autoridad', 'californio', 'consequencia', 'examinar', 'infectar', 'infectar', 'propagacao', 'saudar']","[1, 1, 1, 1, 1, 2, 2, 1, 1]","['espalhar']","[1]",9,1,10,1
9272,"['carla', 'desenvolvido', 'instituto', 'ministrar', 'ministrar', 'parceria', 'permanencia', 'positivar', 'respostar', 'saudar', 'situacao']","[1, 1, 1, 2, 2, 1, 1, 1, 1, 1, 1]","[]","[]",11,0,11,1
9276,"['balancar', 'balancar', 'conformar', 'fluminens', 'funcao', 'hospitalizar', 'infectar', 'intensivo', 'letalidad', 'ministrar', 'nelson', 'painel', 'saudar', 'saudar', 'saudar', 'subir', 'teich']","[2, 2, 1, 1, 1, 1, 1, 1, 1, 1, 1, 1, 3, 3, 3, 1, 1]","[]","[]",17,0,17,1
9278,"['desgast', 'desmatamento', 'espirito', 'exgovernador', 'proposta', 'proprio']","[1, 1, 1, 1, 1, 1]","['arvor', 'imagem']","[1, 1]",6,2,8,1
9279,"['autoridad', 'decisao', 'inquerito', 'instituto', 'ministrar', 'ministrar', 'pslrj', 'sabado', 'sabado', 'silveiro', 'situacao', 'supremo']","[1, 1, 1, 1, 2, 2, 1, 2, 2, 1, 1, 1]","['compartilhar', 'filmar', 'imagem']","[1, 1, 1]",12,3,15,1
9280,"['cupula', 'decisao', 'decisao', 'exministro', 'exministro', 'exministro', 'presenca', 'saudar', 'sobretudo']","[1, 2, 2, 3, 3, 3, 1, 1, 1]","[]","[]",9,0,9,1
9282,"['coletivo', 'decisao', 'decisao', 'decisao', 'especializar', 'ministrar', 'ministrar', 'recurso', 'supremo', 'supremo']","[1, 3, 3, 3, 1, 2, 2, 1, 2, 2]","['greve', 'greve']","[2, 2]",10,2,12,1
9284,"['consequencia', 'crescimento', 'estimativo', 'monetario', 'necessario', 'precedent', 'prever', 'recuperacao', 'reuniao', 'sabado']","[1, 1, 1, 1, 1, 1, 1, 1, 1, 1]","[]","[]",10,0,10,1
9287,"['alteracao', 'ambito', 'constatar', 'crise', 'especifico', 'exigencia', 'fase', 'fundacao', 'importancia', 'instituto', 'instituto', 'levantamento', 'necessidad', 'periodo', 'proporcao', 'subir', 'taxar', 'varga']","[1, 1, 1, 1, 1, 1, 1, 1, 1, 2, 2, 1, 1, 1, 1, 1, 1, 1]","['enderecar', 'ganhar']","[1, 1]",18,2,20,1
9288,"['aglomeracao', 'aglomeracao', 'autonomia', 'carat', 'conformar', 'congresso', 'disseminacao', 'elaborar', 'parceria', 'planar', 'planar', 'possibilidad', 'pratico', 'realizacao', 'regrar', 'supremo']","[2, 2, 1, 1, 1, 1, 1, 1, 1, 2, 2, 1, 1, 1, 1, 1]","[]","[]",16,0,16,1
9290,"['aplicacao', 'comissao', 'condicao', 'cronica', 'externo', 'necessario', 'recuar', 'reducao', 'respiratorio', 'reuniao', 'saudar', 'transmissao', 'videoconferencia', 'vigilancia']","[1, 1, 1, 1, 1, 1, 1, 1, 1, 1, 1, 1, 1, 1]","[]","[]",14,0,14,1
9291,"['atuacao', 'companhia', 'converso', 'cupula', 'cupula', 'destinar', 'domingo', 'domingo', 'especifico', 'exministro', 'exministro', 'exministro', 'minimizar', 'ministrar', 'possibilidad', 'possibilidad', 'prever', 'punicao', 'punicao', 'regrar', 'regulamentar', 'regulamentar', 'saudar', 'saudar', 'saudar', 'saudar', 'transferencia']","[1, 1, 1, 2, 2, 1, 2, 2, 1, 3, 3, 3, 1, 1, 2, 2, 1, 2, 2, 1, 2, 2, 4, 4, 4, 4, 1]","[]","[]",27,0,27,1
9294,"['afp', 'autoridad', 'balancar', 'domingo', 'epidemiar', 'mexico', 'notificar', 'sabado', 'saudar']","[1, 1, 1, 1, 1, 1, 1, 1, 1]","[]","[]",9,0,9,1
9296,"['afetado', 'alternativo', 'destinar', 'europeu', 'pratico', 'quarentenar', 'regiao', 'relaxamento', 'rigoroso', 'subir', 'surtir']","[1, 1, 1, 1, 1, 1, 1, 1, 1, 1, 1]","['imagem']","[1]",11,1,12,1
9297,"['aliviar', 'aliviar', 'cenario', 'cenario', 'consumidor', 'crise', 'emprestimo', 'estimativo', 'impacto', 'perspectivo', 'pratico', 'privar', 'projecao', 'proposto', 'reducao', 'significativo', 'volumar']","[2, 2, 2, 2, 1, 1, 1, 1, 1, 1, 1, 1, 1, 1, 1, 1, 1]","['bandeiro', 'bandeiro']","[2, 2]",17,2,19,1
9300,"['destacar', 'destacar', 'distrito', 'distrito', 'escalar', 'inglaterra', 'jn', 'preocupacao', 'sabado']","[2, 2, 2, 2, 1, 1, 1, 1, 1]","['imagem', 'mencao', 'protestar', 'protestar', 'telejorn', 'telejorn', 'telejorn']","[1, 1, 2, 2, 3, 3, 3]",9,7,16,1
9305,"['intenso', 'quilometro', 'rocha']","[1, 1, 1]","[]","[]",3,0,3,1
9306,"['alerj', 'depoimento', 'depoimento', 'esquema', 'fabricio', 'flavio', 'flavio', 'flavio', 'flavio', 'inquerito', 'investigacao', 'legislativo', 'mprj', 'mprj', 'queiroz', 'queiroz', 'rachadinha', 'republicanosrj']","[1, 2, 2, 1, 1, 4, 4, 4, 4, 1, 1, 1, 2, 2, 2, 2, 1, 1]","[]","[]",18,0,18,1
9307,"['ambito', 'autorizacao', 'domingo', 'enfrentamento', 'kong', 'medida']","[1, 1, 1, 1, 1, 1]","[]","[]",6,0,6,1
9308,"['californio', 'duqu', 'preocupacao', 'regiao', 'segredar', 'transicao']","[1, 1, 1, 1, 1, 1]","['mansao', 'mansao']","[2, 2]",6,2,8,1
9309,"['atrair', 'economia', 'economia', 'inedito', 'iniciativo', 'liderar', 'organizador', 'privar', 'proposto', 'regiao']","[1, 2, 2, 1, 1, 1, 1, 1, 1, 1]","['ganhar']","[1]",10,1,11,1
9313,"['acumular', 'anuncio', 'atuam', 'crise', 'fase', 'oliveira', 'oliveira', 'periodo', 'planar', 'quedo']","[1, 1, 1, 1, 1, 2, 2, 1, 1, 1]","['bispar', 'bispar']","[2, 2]",10,2,12,1
9314,"['comorbidad', 'comorbidad', 'complicacao', 'constatar', 'dosar', 'estimativo', 'imunizacao', 'necessario', 'necessario', 'planar', 'prescricao', 'saudar', 'saudar']","[2, 2, 1, 1, 1, 1, 1, 2, 2, 1, 1, 2, 2]","[]","[]",13,0,13,1
9316,"['apoio', 'celebrar', 'colaboracao', 'crescimento', 'desenvolvimento', 'economia', 'economia', 'instituto', 'levantamento', 'periodo', 'periodo', 'periodo', 'proximo', 'reabertura', 'relacao', 'secom']","[1, 1, 1, 1, 1, 2, 2, 1, 1, 3, 3, 3, 1, 1, 1, 1]","[]","[]",16,0,16,1
9317,"['acordo', 'comparacao', 'crescimento', 'crescimento', 'domingo', 'epidemia', 'exemplo', 'levantamento', 'medida', 'periodo', 'periodo', 'periodo', 'quatro', 'reabertura', 'regiao', 'regiao', 'resultado', 'sudest', 'tendencia']","[1, 1, 2, 2, 1, 1, 1, 1, 1, 3, 3, 3, 1, 1, 2, 2, 1, 1, 1]","[]","[]",19,0,19,1
9319,"['arthur', 'arthur', 'colegiado', 'legislativo', 'lira', 'lira', 'plenario', 'plenario', 'ppal', 'temporariament']","[2, 2, 1, 1, 2, 2, 2, 2, 1, 1]","['verdadeiro']","[1]",10,1,11,1
9321,"['administrativo', 'apurar', 'decisao', 'fase', 'goncalv', 'improbidad', 'investigacao', 'investigacao', 'julgamento', 'justicar', 'ministrar', 'pulmonar', 'respirador']","[1, 1, 1, 1, 1, 1, 2, 2, 1, 1, 1, 1, 1]","[]","[]",13,0,13,1
9323,"['confirmado', 'confirmado', 'consorcio', 'levantamento', 'relacao', 'relacao', 'situacao', 'ultimo', 'ultimo', 'variacao', 'variacao']","[2, 2, 1, 1, 2, 2, 1, 2, 2, 2, 2]","[]","[]",11,0,11,1
9326,"['consecutivo', 'consorcio', 'diagnosticar', 'feriar', 'inclusao', 'inedito', 'intervalar', 'obtido', 'periodo', 'plantao', 'quedo', 'saudar', 'saudar', 'subir']","[1, 1, 1, 1, 1, 1, 1, 1, 1, 1, 1, 2, 2, 1]","[]","[]",14,0,14,1
9327,"['adotada', 'complicacao', 'decorrent', 'decorrent', 'diariament', 'disseminacao', 'esperancar', 'parceria', 'periodo', 'ricardo']","[1, 1, 2, 2, 1, 1, 1, 1, 1, 1]","[]","[]",10,0,10,1
9328,"['etapa', 'fase', 'infectar', 'presenca', 'respiratorio', 'saudar', 'situacao']","[1, 1, 1, 1, 1, 1, 1]","[]","[]",7,0,7,1
9331,"['destacar', 'fabricio', 'inglaterra', 'investigacao', 'investigacao', 'queiroz', 'queiroz', 'queiroz', 'respostar']","[1, 1, 1, 2, 2, 3, 3, 3, 1]","['catedr']","[1]",9,1,10,1
9332,"['adiamento', 'decorrencia', 'feriar', 'inicialment', 'lancamento', 'precaucao']","[1, 1, 1, 1, 1, 1]","['filmar']","[1]",6,1,7,1
9333,"['anvisa', 'anvisa', 'anvisa', 'autorizacao', 'autorizacao', 'avancar', 'conjuntar', 'desenvolvido', 'desenvolvimento', 'domingo', 'domingo', 'enfatizar', 'estagio', 'expectativa', 'exportacao', 'exportacao', 'exportacao', 'exportacao', 'exportacao', 'fundacao', 'fundacao', 'importacao', 'importacao', 'instituto', 'instituto', 'instituto', 'instituto', 'itamarati', 'necessario', 'oswaldo', 'oswaldo', 'recuar', 'relativo', 'reuter', 'saudar', 'submetido', 'vetar', 'vigilancia', 'vigilancia', 'vulneravel']","[3, 3, 3, 2, 2, 1, 1, 1, 1, 2, 2, 1, 1, 1, 5, 5, 5, 5, 5, 2, 2, 2, 2, 4, 4, 4, 4, 1, 1, 2, 2, 1, 1, 1, 1, 1, 1, 2, 2, 1]","[]","[]",40,0,40,1
9334,"['comorbidad', 'complicacao', 'gestant', 'gestant', 'hipertensao', 'obesidad', 'orientacao', 'orientacao', 'periodo', 'previo', 'saudar', 'saudar']","[1, 1, 2, 2, 1, 1, 2, 2, 1, 1, 2, 2]","[]","[]",12,0,12,1
9335,"['quarentenar', 'recordar', 'regrar', 'viagem']","[1, 1, 1, 1]","[]","[]",4,0,4,1
9336,"['autoridad', 'goncalo']","[1, 1]","['menino']","[1]",2,1,3,1
9338,"['autoridad', 'congresso', 'esforco', 'infeccioso', 'painel', 'saudar']","[1, 1, 1, 1, 1, 1]","[]","[]",6,0,6,1
9339,"['aglomeracao', 'argumentar', 'assintomatico', 'condicao', 'converso', 'converso', 'fundacao', 'habito', 'habito', 'independentement', 'infectar', 'infectar', 'infectar', 'justificativo', 'justificativo', 'parcelar', 'percepcao', 'sobretudo', 'vulnerabilidad']","[1, 1, 1, 1, 2, 2, 1, 2, 2, 1, 3, 3, 3, 2, 2, 1, 1, 1, 1]","['atribuir', 'camisa', 'enganar', 'enganir', 'enganir', 'humanar', 'humanar', 'humanar', 'humanar', 'humanar', 'sortir']","[1, 1, 1, 2, 2, 5, 5, 5, 5, 5, 1]",19,11,30,1
9340,"['caxia', 'duqu', 'instalacao', 'risco']","[1, 1, 1, 1]","[]","[]",4,0,4,1
9341,"['autorizacao', 'carat', 'correspondent', 'destinar', 'especializar', 'pulmonar', 'pulmonar', 'reforcar', 'saudar', 'saudar', 'suportar', 'suportar', 'suportar', 'suspeito', 'temporario', 'ventilatorio', 'ventilatorio']","[1, 1, 1, 1, 1, 2, 2, 1, 2, 2, 3, 3, 3, 1, 1, 2, 2]","[]","[]",17,0,17,1
9343,"['acompanhamento', 'comorbidad', 'embora', 'sabado', 'vigilancia']","[1, 1, 1, 1, 1]","['caixao']","[1]",5,1,6,1
9344,"['adulto', 'apoio', 'carat', 'correspondent', 'distrito', 'medida', 'milho', 'reforca', 'temporario']","[1, 1, 1, 1, 1, 1, 1, 1, 1]","[]","[]",9,0,9,1
9345,"['avancar', 'biliao', 'biliao', 'biliao', 'biliao', 'biliao', 'crise', 'destinar', 'epicentro', 'equipamento', 'equivalent', 'instituto', 'recurso', 'saudar', 'saudar', 'saudar']","[1, 5, 5, 5, 5, 5, 1, 1, 1, 1, 1, 1, 1, 3, 3, 3]","[]","[]",16,0,16,1
9346,"['hospitalizacao', 'ritmar', 'sabado']","[1, 1, 1]","[]","[]",3,0,3,1
9347,"['algun', 'cupula', 'fase', 'fux', 'fux', 'julgamento', 'prioridad', 'recuperacao', 'supremo', 'supremo', 'supremo', 'supremo']","[1, 1, 1, 2, 2, 1, 1, 1, 4, 4, 4, 4]","['imagem', 'toga']","[1, 1]",12,2,14,1
9348,"['anuncio', 'comissao', 'concedido', 'confederacao', 'correspondent', 'crise', 'periodo', 'recebido', 'recebido', 'surtir', 'taxar', 'taxar', 'taxar']","[1, 1, 1, 1, 1, 1, 1, 2, 2, 1, 3, 3, 3]","[]","[]",13,0,13,1
9350,"['adotada', 'ambientar', 'disseminacao', 'gorinchteyn', 'gorinchteyn', 'infectar', 'instituto', 'instituto', 'presenca', 'respiratorio', 'vulneravel']","[1, 1, 1, 2, 2, 1, 2, 2, 1, 1, 1]","[]","[]",11,0,11,1
9352,"['absoluto', 'adicionar', 'campino', 'crescimento', 'crescimento', 'crescimento', 'desenvolvimento', 'gabbardo', 'necessidad', 'prever', 'regiao', 'regiao', 'regiao', 'regiao', 'regiao', 'sorocaba']","[1, 1, 1, 3, 3, 3, 1, 1, 1, 1, 5, 5, 5, 5, 5, 1]","[]","[]",16,0,16,1
9354,"['ambientar', 'enfrentamento', 'habitant', 'negativar', 'pastar', 'saudar', 'taxar']","[1, 1, 1, 1, 1, 1, 1]","['desmentir', 'sobrar']","[1, 1]",7,2,9,1
9355,"['bolsonarista', 'carat', 'carat', 'demrj']","[1, 2, 2, 1]","[]","[]",4,0,4,1
9356,"['alvorar', 'atrasar', 'converso', 'converso', 'integrant', 'palacio', 'prazo', 'semestr']","[1, 1, 2, 2, 1, 1, 1, 1]","['legendar']","[1]",8,1,9,1
9358,"['dengu', 'desafiar', 'destinar', 'enfrentamento', 'estrategia', 'estrategico', 'estrategico', 'etapa', 'fase', 'imunizacao', 'instituto', 'ministrar', 'previsto', 'regiao', 'regiao', 'regiao', 'republico', 'saudar', 'situacao', 'situacao']","[1, 1, 1, 1, 1, 2, 2, 1, 1, 1, 1, 1, 1, 3, 3, 3, 1, 1, 2, 2]","[]","[]",20,0,20,1
9359,"['competicao', 'converso', 'elaborar', 'planar', 'reuniao', 'temporada', 'temporada']","[1, 1, 1, 1, 1, 2, 2]","[]","[]",7,0,7,1
9362,"[]","[]","[]","[]",0,0,0,1
9363,"['aplicacao', 'infectar', 'possibilidad']","[1, 1, 1]","[]","[]",3,0,3,1
9364,"['arthur', 'autoridad', 'competicao', 'iniciativo', 'iniciativo', 'lira', 'ppal', 'prioritario', 'privar', 'privar', 'saudar']","[1, 1, 1, 2, 2, 1, 1, 1, 2, 2, 1]","[]","[]",11,0,11,1
9369,"['exministro', 'exministro', 'globonew', 'henriqu', 'necessidad', 'saudar', 'tendencia']","[2, 2, 1, 1, 1, 1, 1]","['espalhar']","[1]",7,1,8,1
9374,"['acompanhamento', 'anuncio', 'assistencia', 'cerimonia', 'destacar', 'destinar', 'gestant', 'gestant', 'iniciativo', 'ministrar', 'ministrar', 'presenca', 'recurso', 'saudar', 'saudar', 'saudar', 'saudar']","[1, 1, 1, 1, 1, 1, 2, 2, 1, 2, 2, 1, 1, 4, 4, 4, 4]","[]","[]",17,0,17,1
9375,"['agravamento', 'augusto', 'crise', 'desenvolvimento', 'diretoria', 'enfrentamento', 'exonerar', 'fundacao', 'goncalv', 'goncalv', 'heleno', 'justicar', 'propagacao', 'relativo', 'situacao']","[1, 1, 1, 1, 1, 1, 1, 1, 2, 2, 1, 1, 1, 1, 1]","['circular']","[1]",15,1,16,1
9377,"['alerj', 'apurar', 'depoimento', 'esquema', 'fabricio', 'flavio', 'flavio', 'flavio', 'gabinet', 'investigacao', 'irregularidad', 'justicar', 'justicar', 'legislativo', 'mprj', 'queiroz', 'rachadinha', 'reafirmar', 'republicanosrj', 'segredar']","[1, 1, 1, 1, 1, 3, 3, 3, 1, 1, 1, 2, 2, 1, 1, 1, 1, 1, 1, 1]","[]","[]",20,0,20,1
9379,"['anvisa', 'economia', 'gued', 'iniciativo', 'ministrar', 'privar', 'revogar', 'saudar', 'saudar', 'saudar', 'saudar', 'saudar', 'saudar']","[1, 1, 1, 1, 1, 1, 1, 6, 6, 6, 6, 6, 6]","[]","[]",13,0,13,1
9381,"['calheiro', 'comissao', 'inquerito', 'mdbal', 'possibilidad', 'republico']","[1, 1, 1, 1, 1, 1]","[]","[]",6,0,6,1
9384,"['client', 'crescimento', 'crescimento', 'emprestimo', 'estimativo', 'impactar', 'juro', 'pagamento', 'prazo', 'quedo', 'reforcar', 'respostar', 'taxar']","[1, 2, 2, 1, 1, 1, 1, 1, 1, 1, 1, 1, 1]","['checar']","[1]",13,1,14,1
9385,"['aprovacao', 'aprovacao', 'consorcio', 'iniciativo', 'integrant', 'liderar', 'panamericana', 'prazo', 'saudar', 'saudar']","[2, 2, 1, 1, 1, 1, 1, 1, 2, 2]","[]","[]",10,0,10,1
9389,"['prioridad']","[1]","[]","[]",1,0,1,1
9391,"['atuacao', 'flavio', 'folhar', 'gabinet', 'integro', 'ramagem', 'relativo', 'republicanosrj', 'servidor', 'servidor', 'subordinar', 'suspeito']","[1, 1, 1, 1, 1, 1, 1, 1, 2, 2, 1, 1]","['vazar']","[1]",12,1,13,1
9393,"['adiamento', 'adiamento', 'ampliacao', 'aplicacao', 'argumentar', 'calendario', 'colegio', 'decisao', 'desigualdad', 'federar', 'instituto', 'mantido', 'periodo', 'presenciar', 'prever', 'prorrogacao', 'ribeiro', 'saudar', 'situacao', 'suspensao']","[2, 2, 1, 1, 1, 1, 1, 1, 1, 1, 1, 1, 1, 1, 1, 1, 1, 1, 1, 1]","[]","[]",20,0,20,1
9394,"['absoluto', 'crise', 'domingo', 'liderar', 'liderar', 'periodo', 'saudar', 'saudar']","[1, 1, 1, 2, 2, 1, 2, 2]","[]","[]",8,0,8,1
9395,"['correspondent', 'negativar', 'positivar', 'presenca', 'wajngarten']","[1, 1, 1, 1, 1]","['minutar']","[1]",5,1,6,1
9398,"['conformar', 'estimular', 'fornecimento', 'recordar', 'recordar', 'regiao', 'saudar', 'transferir', 'transferir']","[1, 1, 1, 2, 2, 1, 1, 2, 2]","[]","[]",9,0,9,1
9399,"['acumular', 'afetado', 'curvo', 'epidemiar', 'epidemiar', 'estatistico', 'inicialment', 'patamar', 'positivar', 'quedo', 'regiao']","[1, 1, 1, 2, 2, 1, 1, 1, 1, 1, 1]","[]","[]",11,0,11,1
9401,"['processo', 'salao', 'sociai', 'tendencia']","[1, 1, 1, 1]","['copiar', 'realment']","[1, 1]",4,2,6,1
9402,"['agravar', 'amplo', 'consumidor', 'consumidor', 'demandar', 'desafiar', 'economia', 'economia', 'economia', 'estimular', 'expectativa', 'necessario', 'preocupacao', 'preocupacao', 'privar', 'recuperacao', 'recuperacao', 'recuperacao', 'recuperacao', 'semestr', 'surtir', 'temor']","[1, 1, 2, 2, 1, 1, 3, 3, 3, 1, 1, 1, 2, 2, 1, 4, 4, 4, 4, 1, 1, 1]","[]","[]",22,0,22,1
9403,"['consorcio', 'consorcio', 'entregu', 'integro', 'liderar', 'sputnik']","[2, 2, 1, 1, 1, 1]","[]","[]",6,0,6,1
9404,"['aspecto', 'estrategia', 'instituto', 'logistico']","[1, 1, 1, 1]","[]","[]",4,0,4,1
9407,"['desenvolvimento', 'economia', 'instituto', 'milho', 'milho', 'previsao', 'recurso', 'recurso', 'recurso', 'ricardo', 'sall', 'sall']","[1, 1, 1, 2, 2, 1, 3, 3, 3, 1, 2, 2]","[]","[]",12,0,12,1
9409,"['almeida', 'almeida', 'argumentar', 'decisao', 'justicar', 'magistrado', 'recurso', 'saudar', 'saudar']","[2, 2, 1, 1, 1, 1, 1, 2, 2]","['estuprar']","[1]",9,1,10,1
9410,"['entregu', 'guarulho', 'instituto', 'instituto', 'instituto', 'previsao', 'remessar', 'saudar', 'saudar']","[1, 1, 3, 3, 3, 1, 1, 2, 2]","[]","[]",9,0,9,1
9413,"['associacao', 'comparacao', 'periodo', 'periodo', 'respiratorio', 'subir', 'subir']","[1, 1, 2, 2, 1, 2, 2]","[]","[]",7,0,7,1
9415,"['calendario', 'imunizacao']","[1, 1]","['compartilhar']","[1]",2,1,3,1
9417,"['cirurgico', 'client', 'client', 'distrito', 'especialment', 'kong', 'regiao', 'suprimento', 'temor']","[1, 2, 2, 1, 1, 1, 1, 1, 1]","['espalhar']","[1]",9,1,10,1
9420,"['apurar', 'atuacao', 'conduta', 'conduta', 'determinacao', 'impactar', 'investigacao', 'mprj', 'precandidato', 'saudar', 'servidor']","[1, 1, 2, 2, 1, 1, 1, 1, 1, 1, 1]","['abusar', 'abusar']","[2, 2]",11,2,13,1
9421,"['bruto', 'capitar', 'capitar', 'capitar', 'crescimento', 'crescimento', 'crise', 'crise', 'depressao', 'desempenhar', 'desempenhar', 'economia', 'economia', 'economia', 'economia', 'economia', 'estimativo', 'impacto', 'internar', 'levantamento', 'pib', 'pib', 'projeco', 'proporcao', 'quedo', 'recordar', 'trimestr', 'trimestr', 'trimestr', 'trimestr', 'trimestr']","[1, 3, 3, 3, 2, 2, 2, 2, 1, 2, 2, 5, 5, 5, 5, 5, 1, 1, 1, 1, 2, 2, 1, 1, 1, 1, 5, 5, 5, 5, 5]","[]","[]",31,0,31,1
9422,"['barroso', 'correspondent', 'expectativa', 'prazo', 'prazo']","[1, 1, 1, 2, 2]","[]","[]",5,0,5,1
9424,"['calendario', 'compromisso', 'medeiro', 'oferecido', 'publicoalvo', 'reafirmar', 'realizacao', 'rotina', 'saudar', 'saudar', 'situacao', 'vigilancia']","[1, 1, 1, 1, 1, 1, 1, 1, 2, 2, 1, 1]","[]","[]",12,0,12,1
9425,"['balancar', 'desembarcar', 'deteccao', 'saudar', 'subir']","[1, 1, 1, 1, 1]","[]","[]",5,0,5,1
9428,"['atuacao', 'decisao', 'decisao', 'folhar', 'fux', 'fux', 'individuar', 'integro', 'ministrar', 'supremo']","[1, 2, 2, 1, 2, 2, 1, 1, 1, 1]","[]","[]",10,0,10,1
9430,"['agravar', 'condicao', 'dengu', 'dengu', 'dengu', 'suspeito']","[1, 1, 3, 3, 3, 1]","['sequer']","[1]",6,1,7,1
9431,"['competicao', 'equivalent']","[1, 1]","['deitar']","[1]",2,1,3,1
9432,"['atrair', 'biliao', 'consultoria', 'consumidor', 'crescimento', 'mergulhar']","[1, 1, 1, 1, 1, 1]","[]","[]",6,0,6,1
9435,"['absoluto', 'bbc', 'folhar', 'integro', 'republicanosrj']","[1, 1, 1, 1, 1]","[]","[]",5,0,5,1
9436,"['afp', 'afp', 'belgica', 'belgica', 'facilitar', 'mantido', 'pfizerbiontech']","[2, 2, 2, 2, 1, 1, 1]","['versao']","[1]",7,1,8,1
9437,"['bbc', 'fase', 'infectar', 'periodo', 'periodo', 'presenciar', 'presenciar', 'situacao', 'situacao', 'turma']","[1, 1, 1, 2, 2, 2, 2, 2, 2, 1]","[]","[]",10,0,10,1
9438,"['alteracao', 'anticorpo', 'anticorpo', 'desenvolvido', 'mutacao', 'oferecido', 'regiao', 'treinar']","[1, 2, 2, 1, 1, 1, 1, 1]","['parir']","[1]",8,1,9,1
9439,"['alteracao', 'coletivo', 'mudanca', 'planar', 'planar', 'planar', 'plano', 'possibilidad', 'possibilidad', 'prever', 'regiao', 'viagem']","[1, 1, 1, 3, 3, 3, 1, 2, 2, 1, 1, 1]","[]","[]",12,0,12,1
9440,"['adversario', 'elaborar', 'elaborar', 'elaborar', 'indicador', 'palacio', 'planalto', 'republico', 'republico', 'rocha', 'sabado', 'saudar']","[1, 3, 3, 3, 1, 1, 1, 2, 2, 1, 1, 1]","[]","[]",12,0,12,1
9442,"['acordo', 'acordo', 'acumular', 'airlin', 'anuncio', 'client', 'client', 'companhia', 'companhia', 'contribuicao', 'crise', 'decisao', 'economia', 'esforco', 'impulsionar', 'inicialment', 'passageiro', 'proximo', 'regiao', 'tambem', 'viagem']","[2, 2, 1, 1, 1, 2, 2, 2, 2, 1, 1, 1, 1, 1, 1, 1, 1, 1, 1, 1, 1]","['ampla']","[1]",21,1,22,1
9443,"['augusto', 'depoimento', 'depoimento', 'fase', 'informaco', 'inquerito', 'inquerito', 'inquerito', 'interferencia', 'investigacao', 'investigacao', 'necessario', 'prazo', 'proximo', 'reuniao', 'supremo', 'tambem', 'ultimo']","[1, 2, 2, 1, 1, 3, 3, 3, 1, 2, 2, 1, 1, 1, 1, 1, 1, 1]","[]","[]",18,0,18,1
9445,"['aglomeracao', 'client', 'client', 'client', 'decorrencia', 'reabertura', 'regiao', 'regiao', 'regiao', 'salao']","[1, 3, 3, 3, 1, 1, 3, 3, 3, 1]","[]","[]",10,0,10,1
9446,"['adicionar', 'client', 'companhia', 'companhia', 'complicacao', 'consumidor', 'decorrencia', 'equipamento', 'limitacao', 'regiao', 'reuter', 'reuter']","[1, 1, 2, 2, 1, 1, 1, 1, 1, 1, 2, 2]","[]","[]",12,0,12,1
9447,"['aglomeracao', 'avancar', 'avancar', 'boletim', 'consorcio', 'disseminacao', 'economia', 'flexibilizacao', 'habitant', 'habitant', 'ibg', 'infectar', 'inglaterra', 'intenso', 'possibilidad', 'provincia', 'regiao', 'saudar', 'totalizar']","[1, 2, 2, 1, 1, 1, 1, 1, 2, 2, 1, 1, 1, 1, 1, 1, 1, 1, 1]","[]","[]",19,0,19,1
9450,"['normalidad', 'saudar']","[1, 1]","[]","[]",2,0,2,1
9451,"['adesao', 'autoridad', 'feriar', 'flexibilizar', 'henriqu', 'quarentenar', 'quarentenar', 'reforcar', 'saudar', 'saudar', 'situacao', 'taxar']","[1, 1, 1, 1, 1, 2, 2, 1, 2, 2, 1, 1]","['sortir', 'sortir']","[2, 2]",12,2,14,1
9453,"['administrativo', 'adotada', 'decisao', 'demandar', 'diretoria', 'impacto', 'incerteza', 'necessario', 'necessario', 'preparacao', 'propagacao', 'realizacao', 'realizacao', 'realizacao', 'reducao', 'reuniao', 'reuter', 'transmissao', 'transmissao']","[1, 1, 1, 1, 1, 1, 1, 2, 2, 1, 1, 3, 3, 3, 1, 1, 1, 2, 2]","['verificar']","[1]",19,1,20,1
9457,"['delacao', 'despesa', 'forcatarefa', 'metropolitano', 'ministrar', 'situacao', 'temporariament', 'varar']","[1, 1, 1, 1, 1, 1, 1, 1]","[]","[]",8,0,8,1
9461,"['colaborar', 'dificuldad', 'iniciativo', 'isolar', 'necessario', 'necessidad']","[1, 1, 1, 1, 1, 1]","['compartilhar', 'preencher']","[1, 1]",6,2,8,1
9462,"['acumular', 'apostar', 'crise', 'crise', 'desempenhar', 'economia', 'incerteza', 'respectivament', 'tendencia', 'trimestr', 'variacao']","[1, 1, 2, 2, 1, 1, 1, 1, 1, 1, 1]","[]","[]",11,0,11,1
9463,"['arrecadar', 'arrecadar', 'reconhecimento', 'saudar', 'saudar']","[2, 2, 1, 2, 2]","[]","[]",5,0,5,1
9465,"['aglomeracao', 'alternativo', 'ambientar', 'bolsonarista', 'bolsonarista', 'colaborar', 'distant', 'equilibrio', 'estatistico', 'exministro', 'exministro', 'henriqu', 'necessidad', 'organizador', 'proposto', 'realizacao', 'regrar', 'saudar', 'saudar', 'sindicato']","[1, 1, 1, 2, 2, 1, 1, 1, 1, 2, 2, 1, 1, 1, 1, 1, 1, 2, 2, 1]","['compartilhar', 'ganhar', 'protestar']","[1, 1, 1]",20,3,23,1
9466,"['congresso', 'congresso', 'provisorio', 'pslsp', 'sabado', 'wajngarten']","[2, 2, 1, 1, 1, 1]","[]","[]",6,0,6,1
9469,"['autoridad', 'diagnosticar', 'epicentro', 'epidemiar', 'infectar', 'internar', 'kong', 'kong', 'kong', 'kong']","[1, 1, 1, 1, 1, 1, 4, 4, 4, 4]","[]","[]",10,0,10,1
9472,"['antecipar', 'anuncio', 'anvisa', 'claudio', 'domingo', 'dosar', 'exercicio', 'imunizacao', 'inicialment', 'ministrar', 'prever', 'saudar']","[1, 1, 1, 1, 1, 1, 1, 1, 1, 1, 1, 1]","[]","[]",12,0,12,1
9474,"['bolsonarista', 'distrito']","[1, 1]","[]","[]",2,0,2,1
9475,"['benjamin', 'primeiroministro', 'sabado']","[1, 1, 1]","['biblia']","[1]",3,1,4,1
9478,"['decisao', 'supremo', 'supremo', 'suspensao', 'suspensao']","[1, 2, 2, 2, 2]","['motorista', 'motorista', 'motorista']","[3, 3, 3]",5,3,8,1
9479,"['ausencia', 'compromisso', 'flavio', 'flavio', 'flavio', 'flavio', 'marinhar', 'possibilidad', 'republicanosrj']","[1, 1, 4, 4, 4, 4, 1, 1, 1]","['imagem']","[1]",9,1,10,1
9480,"['europeu', 'folhar', 'fronteiro', 'integro', 'regiao', 'voo']","[1, 1, 1, 1, 1, 1]","['torrar']","[1]",6,1,7,1
9482,"['ausencia', 'celso', 'celso', 'decisao', 'decisao', 'depoimento', 'depoimento', 'depoimento', 'depoimento', 'determinacao', 'exercicio', 'inquerito', 'jurista', 'machadar', 'mello', 'mello', 'mello', 'ministrar', 'pratico', 'presenca', 'supremo', 'supremo', 'varar']","[1, 2, 2, 2, 2, 4, 4, 4, 4, 1, 1, 1, 1, 1, 3, 3, 3, 1, 1, 1, 2, 2, 1]","['versao']","[1]",23,1,24,1
9484,"['demandar', 'globonew', 'infectar', 'intensivo', 'internacao', 'intubacao', 'intubacao', 'intubacao', 'necessidad', 'nogueira', 'nogueira', 'nogueira', 'quedo', 'situacao', 'situacao']","[1, 1, 1, 1, 1, 3, 3, 3, 1, 3, 3, 3, 1, 2, 2]","[]","[]",15,0,15,1
9485,"['algun', 'autoridad', 'fez', 'medida', 'quadro', 'quatro']","[1, 1, 1, 1, 1, 1]","[]","[]",6,0,6,1
9488,"['acompanhamento', 'alternativo', 'balancar', 'cronica', 'discussao', 'distrito', 'facilitar', 'hipertensao', 'iniciativo', 'prescricao', 'prescricao', 'prescricao', 'primario', 'primario', 'regiao', 'renata', 'saudar', 'saudar', 'saudar', 'saudar', 'saudar', 'situacao']","[1, 1, 1, 1, 1, 1, 1, 1, 1, 3, 3, 3, 2, 2, 1, 1, 5, 5, 5, 5, 5, 1]","['implantar', 'usuario']","[1, 1]",22,2,24,1
9489,"['conselho', 'desigualdad', 'economia', 'exministro', 'exministro', 'henriqu', 'minimizar', 'opcao', 'porqu', 'sido', 'tambem', 'ultimo']","[1, 1, 1, 2, 2, 1, 1, 1, 1, 1, 1, 1]","[]","[]",12,0,12,1
9491,"['abordagem', 'adiamento', 'adicionar', 'adulto', 'adulto', 'anuncio', 'avancar', 'conjuntar', 'consolidar', 'desafio', 'desafio', 'desenvolvimento', 'destacar', 'economia', 'escalar', 'esforco', 'especifico', 'esperancar', 'estagio', 'europeu', 'insuficient', 'insuficient', 'lancamento', 'logistico', 'moderno', 'moderno', 'opcao', 'opcao', 'pfizerbiontech', 'recordar', 'reforcar', 'velocidad']","[1, 1, 1, 2, 2, 1, 1, 1, 1, 2, 2, 1, 1, 1, 1, 1, 1, 1, 1, 1, 2, 2, 1, 1, 2, 2, 2, 2, 1, 1, 1, 1]","['humanar']","[1]",32,1,33,1
9493,"['acompanhamento', 'avancar', 'cardiologista', 'complicacao', 'destacar', 'diagnosticar', 'importancia', 'importancia', 'instituto', 'presenca', 'quadro', 'recuperacao', 'saudar']","[1, 1, 1, 1, 1, 1, 2, 2, 1, 1, 1, 1, 1]","['autopsia']","[1]",13,1,14,1
9494,"['azevedo', 'bolsonarista', 'colunista']","[1, 1, 1]","[]","[]",3,0,3,1
9495,"['armazenamento', 'associacao', 'destacar', 'liderar', 'precisao']","[1, 1, 1, 1, 1]","['disseminar', 'escutar']","[1, 1]",5,2,7,1
9496,"['apreensao', 'distrito', 'equipamento', 'esquema', 'funcionamento', 'interrupcao', 'oliveira', 'oliveira', 'pulmonar', 'quedo', 'respirador', 'respirador', 'respirador', 'respirador', 'temporario', 'temporario', 'varar', 'ventilador']","[1, 1, 1, 1, 1, 1, 2, 2, 1, 1, 4, 4, 4, 4, 2, 2, 1, 1]","[]","[]",18,0,18,1
9497,"['complicacao', 'respiratorio', 'saudar']","[1, 1, 1]","[]","[]",3,0,3,1
9498,"['propagacao', 'rigoroso']","[1, 1]","[]","[]",2,0,2,1
9501,"['comissao', 'constituicao', 'correspondent', 'decisao', 'decisao', 'inquerito', 'instalacao', 'legislativo', 'minoria', 'plenario', 'randolf', 'republico', 'situacao', 'supremo', 'supremo', 'supremo']","[1, 1, 1, 2, 2, 1, 1, 1, 1, 1, 1, 1, 1, 3, 3, 3]","['compartilhar']","[1]",16,1,17,1
9504,"['alcolumbr', 'alcolumbr', 'alcolumbr', 'constatar', 'definitivo', 'demap', 'flexibilizar', 'provisorio', 'provisorio', 'regrar']","[3, 3, 3, 1, 1, 1, 1, 2, 2, 1]","[]","[]",10,0,10,1
9505,"['alcolumbr', 'avancar', 'constituicao', 'decisao', 'demap', 'demrj', 'economia', 'emendar', 'equilibrio', 'globonew', 'gued', 'ministrar', 'necessario', 'possibilidad', 'proposto', 'supremo', 'tramitacao', 'tributario']","[1, 1, 1, 1, 1, 1, 1, 1, 1, 1, 1, 1, 1, 1, 1, 1, 1, 1]","[]","[]",18,0,18,1
9506,"['aglomeracao', 'circulacao', 'constatar', 'curso', 'curso', 'desafiar', 'destacar', 'enfermagem', 'equipamento', 'estagio', 'estagio', 'estagio', 'levantamento', 'observar', 'pastar', 'previsao', 'quedo', 'reducao', 'saudar', 'saudar', 'saudar', 'semestr', 'semestr', 'semestr']","[1, 1, 1, 2, 2, 1, 1, 1, 1, 3, 3, 3, 1, 1, 1, 1, 1, 1, 3, 3, 3, 3, 3, 3]","['quinzena']","[1]",24,1,25,1
9508,"['escalar', 'etapa', 'fabricacao', 'ministrar', 'mudanca', 'parceiro', 'saudar']","[1, 1, 1, 1, 1, 1, 1]","[]","[]",7,0,7,1
9511,"['aprovacao', 'aprovacao', 'comissao', 'comissao', 'comissao', 'congresso', 'congresso', 'congresso', 'legislativo', 'legislativo', 'ministrar', 'mudanca', 'necessidad', 'periodo', 'plenario', 'plenario', 'plenario', 'prazo', 'presenca', 'proposto', 'proposto', 'provisorio', 'republico', 'supremo', 'tramitacao', 'tramitacao']","[2, 2, 3, 3, 3, 3, 3, 3, 2, 2, 1, 1, 1, 1, 3, 3, 3, 1, 1, 2, 2, 1, 1, 1, 2, 2]","[]","[]",26,0,26,1
9513,"['associacao', 'augusto', 'autoridad', 'destacar', 'elaborar', 'especializar', 'etapa', 'henriqu', 'infectar', 'instituto', 'levantamento', 'minimizar', 'minimizar', 'ministrar', 'negativar', 'orientacao', 'saudar', 'suspeito']","[1, 1, 1, 1, 1, 1, 1, 1, 1, 1, 1, 2, 2, 1, 1, 1, 1, 1]","['sacar', 'visualizacao']","[1, 1]",18,2,20,1
9515,"['adicionar', 'boletim', 'consorcio', 'consorcio', 'consorcio', 'contabilizar', 'excecao', 'infectar', 'levantamento', 'roraima', 'sabado', 'saudar', 'saudar', 'saudar']","[1, 1, 3, 3, 3, 1, 1, 1, 1, 1, 1, 3, 3, 3]","[]","[]",14,0,14,1
9516,"['academiar', 'adulto', 'agravar', 'alergia', 'alergia', 'alergia', 'alergia', 'alergia', 'alergia', 'associacao', 'claudio', 'condicao', 'crise', 'habito', 'importancia', 'normalment', 'orientacao', 'piorar', 'planar', 'pulmonar', 'regrar', 'respiratorio']","[1, 1, 1, 6, 6, 6, 6, 6, 6, 1, 1, 1, 1, 1, 1, 1, 1, 1, 1, 1, 1, 1]","['realment']","[1]",22,1,23,1
9517,"['circulacao', 'domingo', 'necessidad', 'situacao']","[1, 1, 1, 1]","[]","[]",4,0,4,1
9518,"['alvaro', 'alvaro', 'alvaro', 'antonio', 'antonio', 'antonio', 'associacao', 'discussao', 'ideologico', 'justicar', 'justicar', 'ministrar', 'recurso', 'situacao']","[3, 3, 3, 3, 3, 3, 1, 1, 1, 2, 2, 1, 1, 1]","[]","[]",14,0,14,1
9519,"['adotada', 'alvaro', 'antonio', 'araujo', 'destacar', 'ernesto', 'impactar', 'iniciativo', 'instituto', 'machadar', 'machadar', 'palacio', 'planalto', 'planalto', 'planar', 'preservacao', 'privar', 'recuperacao', 'turistico', 'viagem']","[1, 1, 1, 1, 1, 1, 1, 1, 1, 2, 2, 1, 2, 2, 1, 1, 1, 1, 1, 1]","[]","[]",20,0,20,1
9521,"['acordo', 'contrato', 'proposto', 'suspensao']","[1, 1, 1, 1]","[]","[]",4,0,4,1
9523,"['autoridad', 'decisao', 'domingo', 'economia', 'enfatizar', 'mandatario', 'prorrogar', 'quarentenar', 'saudar', 'saudar']","[1, 1, 1, 1, 1, 1, 1, 1, 2, 2]","['falsar']","[1]",10,1,11,1
9524,"['acordo', 'acordo', 'agravar', 'cepa', 'desenvolvimento', 'esforco', 'imunizacao', 'imunizacao', 'milho', 'milho', 'milho', 'milho', 'milho', 'milho', 'milho', 'milho', 'none', 'none', 'none', 'plano', 'plano', 'plano', 'plano', 'porqu', 'porqu', 'profissionai', 'risco', 'risco', 'risco', 'serao', 'situacao']","[2, 2, 1, 1, 1, 1, 2, 2, 8, 8, 8, 8, 8, 8, 8, 8, 3, 3, 3, 4, 4, 4, 4, 2, 2, 1, 3, 3, 3, 1, 1]","[]","[]",31,0,31,1
9525,"['associacao', 'associacao', 'colaborar', 'decisao', 'decisao', 'destacar', 'determinacao', 'impacto', 'jurista', 'kassio', 'saudar', 'supremo', 'supremo', 'supremo', 'temporario']","[2, 2, 1, 2, 2, 1, 1, 1, 1, 1, 1, 3, 3, 3, 1]","[]","[]",15,0,15,1
9527,"['afastamento', 'aglomeracao', 'ambientar', 'ambientar', 'claudio', 'determinacao', 'exercicio', 'externo', 'permanencia', 'restritivo', 'suspenso', 'transmissao', 'vetar']","[1, 1, 2, 2, 1, 1, 1, 1, 1, 1, 1, 1, 1]","[]","[]",13,0,13,1
9530,"['converso', 'fabricio', 'flavio', 'flavio', 'justicar', 'kassio', 'kassio', 'kassio', 'kassio', 'ministrar', 'queiroz', 'republicanosrj', 'supremo']","[1, 1, 2, 2, 1, 4, 4, 4, 4, 1, 1, 1, 1]","['desgracar']","[1]",13,1,14,1
9531,"['concedido', 'especializar', 'interino', 'julgamento', 'posicionamento', 'reajustar']","[1, 1, 1, 1, 1, 1]","[]","[]",6,0,6,1
9533,"['administrativo', 'apurar', 'dosar', 'dosar', 'instituto', 'parceria', 'reclamacao', 'saudar', 'transmissao']","[1, 1, 2, 2, 1, 1, 1, 1, 1]","[]","[]",9,0,9,1
9535,"['conjunto', 'decisao', 'lavagem', 'processo', 'processo', 'processo', 'processo', 'processo', 'processo', 'processo', 'reuniao', 'sido', 'tramitacao', 'turma']","[1, 1, 1, 7, 7, 7, 7, 7, 7, 7, 1, 1, 1, 1]","[]","[]",14,0,14,1
9539,"['araujo', 'conflito', 'ernesto', 'ministrar', 'previsao']","[1, 1, 1, 1, 1]","['desmentir', 'sortir']","[1, 1]",5,2,7,1
9540,"['infeccioso', 'inglaterra', 'saudar', 'transmissao']","[1, 1, 1, 1]","[]","[]",4,0,4,1
9542,"['assistencia', 'conjuntar', 'conjunto', 'esforco', 'infraestrutura', 'necessario', 'reforcar', 'respostar', 'respostar', 'sigla', 'sigla', 'significativo']","[1, 1, 1, 1, 1, 1, 1, 2, 2, 2, 2, 1]","[]","[]",12,0,12,1
9543,"['economia', 'extensao', 'privar', 'recuperacao', 'reuniao', 'sabado', 'vulneravel']","[1, 1, 1, 1, 1, 1, 1]","[]","[]",7,0,7,1
9546,"['administrativo', 'afastamento', 'ambientar', 'ambientar', 'ambientar', 'ambientar', 'ambito', 'carat', 'celso', 'decisao', 'distrito', 'funcao', 'improbidad', 'interferencia', 'investigacao', 'justicar', 'justicar', 'mello', 'ministrar', 'ministrar', 'ministrar', 'orcamentaria', 'pagamento', 'pastar', 'pastar', 'punicao', 'republico', 'reuniao', 'ricardo', 'sall', 'sall', 'sall', 'sall', 'sall', 'supremo', 'suspensao', 'tramitar']","[1, 1, 4, 4, 4, 4, 1, 1, 1, 1, 1, 1, 1, 1, 1, 2, 2, 1, 3, 3, 3, 1, 1, 2, 2, 1, 1, 1, 1, 5, 5, 5, 5, 5, 1, 1, 1]","[]","[]",37,0,37,1
9548,"['avancar', 'congresso', 'congresso', 'demandar', 'despesa', 'flexibilizacao', 'folhar', 'iniciativo', 'integro', 'periodo', 'recurso', 'regrar']","[1, 2, 2, 1, 1, 1, 1, 1, 1, 1, 1, 1]","[]","[]",12,0,12,1
9553,"['atrair', 'crescimento', 'crise', 'demandar', 'domingo', 'europeu', 'mexico', 'publicitario', 'saudar', 'saudar']","[1, 1, 1, 1, 1, 1, 1, 1, 2, 2]","[]","[]",10,0,10,1
9554,"['anteontem', 'anteontem', 'californio', 'crescimento', 'crescimento', 'decorrencia', 'florido', 'ritmar', 'ritmar', 'sigla']","[2, 2, 1, 2, 2, 1, 1, 2, 2, 1]","[]","[]",10,0,10,1
9555,"['paralelo', 'rejeicao']","[1, 1]","['verificar']","[1]",2,1,3,1
9556,"['adotada', 'benjamin', 'crise', 'fornecimento', 'infectar', 'investigacao', 'ministrar', 'ministrar', 'plenario', 'prever', 'recordar', 'saudar', 'saudar', 'saudar', 'tcu', 'tcu']","[1, 1, 1, 1, 1, 1, 2, 2, 1, 1, 1, 3, 3, 3, 2, 2]","[]","[]",16,0,16,1
9557,"['dengu', 'dengu', 'dengu', 'epidemiar', 'impactar', 'internacao', 'oliveira', 'quadro', 'recurso', 'recurso', 'rotina', 'saudar', 'saudar', 'saudar', 'saudar', 'saudar', 'subir', 'tendencia', 'vigilancia']","[3, 3, 3, 1, 1, 1, 1, 1, 2, 2, 1, 5, 5, 5, 5, 5, 1, 1, 1]","[]","[]",19,0,19,1
9558,"['converso', 'converso', 'desenvolvimento', 'discussao', 'economia', 'economia', 'economia', 'economia', 'economia', 'elaborar', 'estrategia', 'flexibilizar', 'gued', 'gued', 'gued', 'gued', 'gued', 'infraestrutura', 'ministrar', 'ministrar', 'ministrar', 'ministrar', 'ministrar', 'planar', 'planar', 'possibilidad', 'privar', 'privar', 'privatizacao', 'proposto']","[2, 2, 1, 1, 5, 5, 5, 5, 5, 1, 1, 1, 5, 5, 5, 5, 5, 1, 5, 5, 5, 5, 5, 2, 2, 1, 2, 2, 1, 1]","[]","[]",30,0,30,1
9559,"['acordo', 'anticorpo', 'assintomatico', 'assintomatico', 'assintomatico', 'autoridad', 'habitant', 'informaco', 'milho', 'resultado', 'situacao', 'tambem']","[1, 1, 3, 3, 3, 1, 1, 1, 1, 1, 1, 1]","[]","[]",12,0,12,1
9560,"['cenario', 'flexibilizacao', 'instituto', 'metropolitano', 'quarentenar', 'quedo', 'regiao', 'regrar', 'substituto', 'taxar', 'taxar', 'temporario']","[1, 1, 1, 1, 1, 1, 1, 1, 1, 2, 2, 1]","[]","[]",12,0,12,1
9564,"['academico', 'decisao', 'federar', 'integro', 'ministrar', 'presenciar', 'resistencia', 'revogar', 'ribeiro']","[1, 1, 1, 1, 1, 1, 1, 1, 1]","[]","[]",9,0,9,1
9572,"['destinar', 'destinar', 'equivalent', 'proporcao', 'proporcao']","[2, 2, 1, 2, 2]","[]","[]",5,0,5,1
9573,"['compilar', 'europeu', 'infeccioso', 'letalidad', 'saudar', 'sigla']","[1, 1, 1, 1, 1, 1]","[]","[]",6,0,6,1
9574,"['ambientar', 'comprometido', 'cupula', 'economia', 'folhar', 'ideologico', 'ministrar', 'ministrar', 'opcao', 'presenca', 'queiroga', 'sabado', 'superar', 'surtir']","[1, 1, 1, 1, 1, 1, 2, 2, 1, 1, 1, 1, 1, 1]","[]","[]",14,0,14,1
9575,"['acompanhamento', 'augusto', 'constituicao', 'diretoria', 'divergencia', 'epidemiar', 'gabinet', 'henriqu', 'ministrar', 'oficio', 'oficio', 'pastar', 'reabertura', 'republico', 'saudar', 'videoconferencia']","[1, 1, 1, 1, 1, 1, 1, 1, 1, 2, 2, 1, 1, 1, 1, 1]","[]","[]",16,0,16,1
9577,"['autorizacao', 'diagnosticar', 'domingo', 'dosar', 'infectar', 'instituto', 'ministrar', 'possibilidad', 'revogar', 'risco', 'sabado', 'saudar', 'sigla', 'superar']","[1, 1, 1, 1, 1, 1, 1, 1, 1, 1, 1, 1, 1, 1]","[]","[]",14,0,14,1
9578,"['articulacao', 'assistenci', 'capitar', 'coordenar', 'distrito', 'distrito', 'internar', 'necessario', 'privar', 'saudar', 'saudar', 'transferencia', 'transferir']","[1, 1, 1, 1, 2, 2, 1, 1, 1, 2, 2, 1, 1]","[]","[]",13,0,13,1
9582,"['ministrar', 'supremo']","[1, 1]","[]","[]",2,0,2,1
9585,"['ampliacao', 'compromisso', 'cupula', 'desmatamento', 'itamarati', 'organizador']","[1, 1, 1, 1, 1, 1]","[]","[]",6,0,6,1
9589,"['acumular', 'desenvolvimento', 'destacar', 'especializar', 'estagio', 'estagio', 'estrategia', 'eventualment', 'examinar', 'impactar', 'inglaterra', 'liderar', 'modelo', 'molecular', 'necessario', 'reducao', 'respostar', 'significativo']","[1, 1, 1, 1, 2, 2, 1, 1, 1, 1, 1, 1, 1, 1, 1, 1, 1, 1]","['circular']","[1]",18,1,19,1
9594,"['apurar', 'atuacao', 'atuacao', 'atuacao', 'atuacao', 'autorizacao', 'calamidad', 'capitar', 'congresso', 'constituicao', 'emendar', 'preocupacao', 'privar', 'proposto', 'proposto', 'situacao']","[1, 4, 4, 4, 4, 1, 1, 1, 1, 1, 1, 1, 1, 2, 2, 1]","['minutar']","[1]",16,1,17,1
9595,"['articulacao', 'articulacao', 'atendido', 'diagnosticar', 'instituto', 'molecular', 'observar', 'periodo', 'periodo', 'positivar', 'presenca', 'presenca', 'queixar']","[2, 2, 1, 1, 1, 1, 1, 2, 2, 1, 2, 2, 1]","[]","[]",13,0,13,1
9597,"['funcionamento', 'isolar', 'possibilidad', 'respostar', 'transmissao']","[1, 1, 1, 1, 1]","['gravacao', 'invadir', 'invadir', 'invadir']","[1, 3, 3, 3]",5,4,9,1
9598,"['abordagem', 'anticorpo', 'atrair', 'atrair', 'desenvolvimento', 'desenvolvimento', 'estimular', 'estrategia', 'estrategia', 'instituto', 'instituto', 'respostar', 'respostar']","[1, 1, 2, 2, 2, 2, 1, 2, 2, 2, 2, 2, 2]","[]","[]",13,0,13,1
9601,"['domingo', 'mandatario', 'prioridad', 'sputnik']","[1, 1, 1, 1]","['venezuelano', 'venezuelano']","[2, 2]",4,2,6,1
9603,"['alteracao', 'alvorar', 'exercicio', 'fux', 'justicar', 'palacio', 'proposto', 'supremo']","[1, 1, 1, 1, 1, 1, 1, 1]","['perdao']","[1]",8,1,9,1
9607,"['cenario', 'condicao', 'consumidor', 'consumidor', 'desafiar', 'desafio', 'impactar', 'impactar', 'importancia', 'inedito', 'modelo', 'periodo', 'publicitario']","[1, 1, 2, 2, 1, 1, 2, 2, 1, 1, 1, 1, 1]","['carrefour', 'estampar', 'filmar', 'filmar', 'ganhar']","[1, 1, 2, 2, 1]",13,5,18,1
9609,"['acordo', 'destacar', 'profissionai', 'profissionai', 'profissionai', 'reconhecimento', 'reuter', 'tambem']","[1, 1, 3, 3, 3, 1, 1, 1]","['facad']","[1]",8,1,9,1
9615,"['adversario', 'embora', 'porqu']","[1, 1, 1]","['ganhar']","[1]",3,1,4,1
9617,"['comparacao', 'consolidar', 'consorcio', 'crescimento', 'crescimento', 'levantamento', 'sabado', 'saudar', 'situacao', 'tendencia', 'tendencia', 'variacao', 'variacao']","[1, 1, 1, 2, 2, 1, 1, 1, 1, 2, 2, 2, 2]","[]","[]",13,0,13,1
9618,"['turma']","[1]","['espalhar']","[1]",1,1,2,1
9623,"['conformar', 'enfrentamento', 'entregu', 'entregu', 'equipamento', 'equipamento', 'equipamento', 'espirito', 'pulmonar', 'pulmonar', 'pulmonar', 'pulmonar', 'pulmonar', 'pulmonar', 'pulmonar', 'reforcar', 'reforcar', 'sabado', 'saudar', 'saudar', 'saudar', 'saudar', 'ventilador', 'ventilador', 'ventilador', 'ventilador']","[1, 1, 2, 2, 3, 3, 3, 1, 7, 7, 7, 7, 7, 7, 7, 2, 2, 1, 4, 4, 4, 4, 4, 4, 4, 4]","['ganhar']","[1]",26,1,27,1
9625,"['anticorpo', 'coordenar', 'desenvolvimento', 'distrito', 'fase', 'fase', 'imunizacao', 'imunizacao', 'intervalar']","[1, 1, 1, 1, 2, 2, 2, 2, 1]","[]","[]",9,0,9,1
9630,"['intensivo']","[1]","[]","[]",1,0,1,1
9631,"['autoridad', 'colaboracao', 'decisao', 'desenvolvimento', 'medida', 'precedent', 'suspensa']","[1, 1, 1, 1, 1, 1, 1]","[]","[]",7,0,7,1
9632,"['aglomeracao', 'calheiro', 'colaborar', 'comissao', 'comissao', 'converso', 'decisao', 'destacar', 'enfrentamento', 'enfrentamento', 'estimular', 'favorito', 'integrant', 'integrant', 'integro', 'investigacao', 'investigacao', 'mdbal', 'minimizar', 'preventivo']","[1, 1, 1, 2, 2, 1, 1, 1, 2, 2, 1, 1, 2, 2, 1, 2, 2, 1, 1, 1]","[]","[]",20,0,20,1
9633,"['anvisa', 'domingo', 'imunizacao', 'levantamento', 'milho', 'milho', 'milho', 'milho', 'milho', 'milho', 'unanimidad']","[1, 1, 1, 1, 6, 6, 6, 6, 6, 6, 1]","[]","[]",11,0,11,1
9634,"['anuncio', 'condicao', 'infectar', 'saudar', 'subir']","[1, 1, 1, 1, 1]","[]","[]",5,0,5,1
9638,"['imunizacao', 'propagacao', 'risco', 'servidor']","[1, 1, 1, 1]","['motorista', 'usuario']","[1, 1]",4,2,6,1
9640,"['parceiro', 'piorar', 'positivar']","[1, 1, 1]","['garganta', 'torrar']","[1, 1]",3,2,5,1
9642,"['bruto', 'comparacao', 'crescimento', 'economia', 'economia', 'indicador', 'informaco', 'pib', 'resultado', 'trimestr', 'trimestr']","[1, 1, 1, 2, 2, 1, 1, 1, 1, 2, 2]","[]","[]",11,0,11,1
9646,"['aglomeracao', 'esforco', 'fluxo', 'mudanca', 'prazo', 'prazo', 'prorrogar', 'prorrogar', 'prorrogar', 'servidor', 'suspensao', 'temporario']","[1, 1, 1, 1, 2, 2, 3, 3, 3, 1, 1, 1]","[]","[]",12,0,12,1
9647,"['aliviar', 'associacao', 'atendido', 'autoridad', 'autoridad', 'inicialment', 'propagacao', 'prorrogar', 'saudar']","[1, 1, 1, 2, 2, 1, 1, 1, 1]","[]","[]",9,0,9,1
9648,"['adulto', 'apoio', 'autonomia', 'autorizacao', 'cenario', 'decorrencia', 'demanda', 'distrito', 'enfrentamento', 'medida', 'milho', 'necessario', 'recurso', 'reforca', 'sendo']","[1, 1, 1, 1, 1, 1, 1, 1, 1, 1, 1, 1, 1, 1, 1]","[]","[]",15,0,15,1
9649,"['adulto', 'afetado', 'andrew', 'fase', 'inicialment', 'planar', 'resistencia', 'respostar', 'sabado']","[1, 1, 1, 1, 1, 1, 1, 1, 1]","[]","[]",9,0,9,1
9652,"['autoridad', 'autoridad', 'autoridad', 'determinacao', 'possibilidad', 'saudar', 'transmissao']","[3, 3, 3, 1, 1, 1, 1]","[]","[]",7,0,7,1
9653,"['atuam', 'elaborar', 'imunizacao', 'intensivo', 'montant', 'periodo', 'permanencia', 'planar', 'planar', 'saudar', 'saudar', 'saudar', 'saudar']","[1, 1, 1, 1, 1, 1, 1, 2, 2, 4, 4, 4, 4]","[]","[]",13,0,13,1
9654,"['cirurgico', 'curvo', 'dificultar', 'journal', 'reconhecimento', 'recurso', 'saudar']","[1, 1, 1, 1, 1, 1, 1]","['usuario']","[1]",7,1,8,1
9655,"['autonomia', 'funcao', 'internar', 'internar', 'permanencia', 'semestr']","[1, 1, 2, 2, 1, 1]","['postagen']","[1]",6,1,7,1
9656,"['consumidor', 'inicialment', 'medida', 'risco', 'sendo']","[1, 1, 1, 1, 1]","['engano']","[1]",5,1,6,1
9657,"['batalhar', 'compromisso', 'compromisso', 'conformar', 'dedicar', 'esperancar', 'ministrar', 'ministrar', 'nelson', 'saudar', 'saudar', 'teich', 'teich']","[1, 2, 2, 1, 1, 1, 2, 2, 1, 2, 2, 2, 2]","['chorar', 'chorar']","[2, 2]",13,2,15,1
9659,"['antecipar', 'anuncio', 'congresso', 'discussao', 'economia', 'economia', 'estrategia', 'federativo', 'gued', 'gued', 'ministrar', 'ministrar', 'mudanca', 'pastar', 'proposto', 'recurso']","[1, 1, 1, 1, 2, 2, 1, 1, 2, 2, 2, 2, 1, 1, 1, 1]","['abortar', 'vazar']","[1, 1]",16,2,18,1
9662,"['anvisa', 'aplicacao', 'definitivo', 'portavoz', 'preocupacao', 'risco', 'saudar', 'sputnik', 'superar', 'vigilancia']","[1, 1, 1, 1, 1, 1, 1, 1, 1, 1]","['assinalar']","[1]",10,1,11,1
9663,"['fase', 'fase', 'fase', 'fase', 'fase', 'observacao', 'observacao', 'observar']","[5, 5, 5, 5, 5, 2, 2, 1]","['imagem', 'versao']","[1, 1]",8,2,10,1
9668,"['campino', 'eventualment', 'presenciar', 'rossi', 'rossi', 'transmissao']","[1, 1, 1, 2, 2, 1]","['bandeiro']","[1]",6,1,7,1
9669,"['adiamento', 'adiamento', 'atrasar', 'compilar', 'congresso', 'entregu', 'mudanca', 'periodo', 'precisao', 'previsto']","[2, 2, 1, 1, 1, 1, 1, 1, 1, 1]","[]","[]",10,0,10,1
9670,"['bbc', 'calendario', 'coletivo', 'especializar', 'individuar', 'intenso', 'lesao', 'lesao', 'lesao', 'lesao', 'oficialment', 'periodo', 'periodo', 'previsao', 'provisorio', 'taxar', 'treinamento', 'treinar']","[1, 1, 1, 1, 1, 1, 4, 4, 4, 4, 1, 2, 2, 1, 1, 1, 1, 1]","[]","[]",18,0,18,1
9673,"['arrecadar', 'contribuicao', 'contribuicao', 'espanha', 'instituto']","[1, 2, 2, 1, 1]","['gasol']","[1]",5,1,6,1
9674,"['anuncio', 'bbc', 'conservacao', 'conservacao', 'desmatam', 'destinar', 'investigacao']","[1, 1, 2, 2, 1, 1, 1]","['invadir']","[1]",7,1,8,1
9678,"['client', 'client', 'cnj', 'cnj', 'decisao', 'gestant', 'justicar', 'justicar', 'justicar', 'periodo', 'possibilidad', 'resolucao', 'sobretudo', 'transferir']","[2, 2, 2, 2, 1, 1, 3, 3, 3, 1, 1, 1, 1, 1]","[]","[]",14,0,14,1
9681,"['decorrencia', 'especialment', 'supremo', 'vulneravel']","[1, 1, 1, 1]","[]","[]",4,0,4,1
9682,"['adotada', 'argumentar', 'competicao', 'condicao', 'decisao', 'decisao', 'emendar', 'emendar', 'impacto', 'intervalar', 'mudanca', 'mudanca', 'organizador', 'periodo', 'periodo', 'regrar', 'regrar', 'substituicao', 'substituicao', 'substituicao', 'temporada', 'temporario', 'temporario', 'temporario', 'temporario']","[1, 1, 1, 1, 2, 2, 2, 2, 1, 1, 2, 2, 1, 2, 2, 2, 2, 3, 3, 3, 1, 4, 4, 4, 4]","[]","[]",25,0,25,1
9684,"['anvisa', 'carat', 'domingo', 'instituto', 'vigilancia']","[1, 1, 1, 1, 1]","[]","[]",5,0,5,1
9685,"['folhar', 'movimentacao', 'nogueira', 'pagamento', 'transferencia']","[1, 1, 1, 1, 1]","[]","[]",5,0,5,1
9688,"['ambientar', 'comissao', 'especifico', 'impulsionar', 'legislativo', 'necessario', 'necessario', 'revisar']","[1, 1, 1, 1, 1, 2, 2, 1]","[]","[]",8,0,8,1
9691,"['consecutivo', 'provisorio', 'quedo', 'quedo', 'reportar', 'sigla', 'taxar']","[1, 1, 2, 2, 1, 1, 1]","[]","[]",7,0,7,1
9698,"['apurar', 'conduta', 'decisao', 'humberto', 'inquerito', 'instituto', 'investigacao', 'medeiro', 'medeiro', 'ministrar', 'pslrj', 'republico', 'silveiro', 'silveiro', 'supremo']","[1, 1, 1, 1, 1, 1, 1, 2, 2, 1, 1, 1, 2, 2, 1]","['circular']","[1]",15,1,16,1
9700,"['alternativo', 'alvorar', 'ambientar', 'avancar', 'congresso', 'crescimento', 'crise', 'demrj', 'discussao', 'economia', 'economia', 'gued', 'gued', 'gued', 'gued', 'interlocutor', 'ministrar', 'palacio', 'reforcar', 'reuniao']","[1, 1, 1, 1, 1, 1, 1, 1, 1, 2, 2, 4, 4, 4, 4, 1, 1, 1, 1, 1]","[]","[]",20,0,20,1
9701,"['alteracao', 'barroso', 'barroso', 'congresso', 'constituicao', 'dificuldad', 'domingo', 'globonew', 'justicar', 'justicar', 'justicar', 'ministrar', 'prazo', 'previsto', 'previsto', 'supremo', 'treinar', 'treinar']","[1, 2, 2, 1, 1, 1, 1, 1, 3, 3, 3, 1, 1, 2, 2, 1, 2, 2]","['fraudar', 'mesario']","[1, 1]",18,2,20,1
9702,"['administrativo', 'aprovacao', 'arthur', 'comissao', 'conformar', 'converso', 'instalacao', 'legislativo', 'lira', 'possibilidad', 'ppal', 'prioridad', 'prioridad', 'saudar', 'tributario']","[1, 1, 1, 1, 1, 1, 1, 1, 1, 1, 1, 2, 2, 1, 1]","['cbn', 'plam']","[1, 1]",15,2,17,1
9703,"['isolar', 'quarentenar', 'situacao']","[1, 1, 1]","['misturar']","[1]",3,1,4,1
9704,"['dedicar', 'diagnosticar', 'diagnosticar', 'diagnosticar', 'instituto', 'isolar', 'jorg', 'jorg', 'liderar', 'oficialment']","[1, 3, 3, 3, 1, 1, 2, 2, 1, 1]","[]","[]",10,0,10,1
9706,"['client', 'client', 'client', 'client', 'corpu', 'feriar', 'isolar', 'movimentacao', 'orientacao', 'reabertura', 'reabrir']","[4, 4, 4, 4, 1, 1, 1, 1, 1, 1, 1]","[]","[]",11,0,11,1
9709,"['afp', 'balancar', 'biliao', 'desigu', 'integro', 'recurso']","[1, 1, 1, 1, 1, 1]","[]","[]",6,0,6,1
9710,"['anuncio', 'diariament', 'dificuldad', 'iniciativo', 'periodo', 'saudar', 'vulneravel']","[1, 1, 1, 1, 1, 1, 1]","[]","[]",7,0,7,1
9711,"['interpretar', 'necessario']","[1, 1]","[]","[]",2,0,2,1
9713,"['anvisa', 'anvisa', 'anvisa', 'autorizacao', 'autorizacao', 'concedido', 'concedido', 'diretoria', 'domingo', 'domingo', 'importacao', 'imunizacao', 'inclusao', 'instituto', 'instituto', 'instituto', 'instituto', 'materiaprima', 'mudanca', 'parceria', 'planar', 'vigilancia']","[3, 3, 3, 2, 2, 2, 2, 1, 2, 2, 1, 1, 1, 4, 4, 4, 4, 1, 1, 1, 1, 1]","[]","[]",22,0,22,1
9714,"['comissao', 'comprometido', 'europeu', 'europeu', 'exportacao', 'exportacao', 'necessario', 'portavoz', 'prioridad', 'saudar']","[1, 1, 2, 2, 2, 2, 1, 1, 1, 1]","[]","[]",10,0,10,1
9718,"['adhanom', 'arrecadar', 'autoridad', 'biliao', 'biliao', 'biliao', 'biliao', 'biliao', 'biliao', 'biliao', 'biliao', 'colaboracao', 'colaboracao', 'comissao', 'desenvolvimento', 'europeu', 'igualitario', 'implementar', 'iniciativo', 'montant', 'saudar', 'saudar', 'tedro']","[1, 1, 1, 8, 8, 8, 8, 8, 8, 8, 8, 2, 2, 1, 1, 1, 1, 1, 1, 1, 2, 2, 1]","[]","[]",23,0,23,1
9719,"['argumentar', 'aurelio', 'autonomia', 'condicao', 'crise', 'decisao', 'decisao', 'determinacao', 'domingo', 'kassio', 'kassio', 'mello', 'ministrar', 'ministrar', 'ministrar', 'presenca', 'realizacao', 'sabado', 'supremo']","[1, 1, 1, 1, 1, 2, 2, 1, 1, 2, 2, 1, 3, 3, 3, 1, 1, 1, 1]","[]","[]",19,0,19,1
9720,"['aglomeracao', 'aglomeracao', 'distrito', 'etapa', 'fase', 'instituto', 'ministrar', 'ministrar', 'presenca', 'prioritario', 'saudar', 'saudar', 'saudar']","[2, 2, 1, 1, 1, 1, 2, 2, 1, 1, 3, 3, 3]","[]","[]",13,0,13,1
9721,"['celso', 'crescimento', 'decisao', 'estrategia', 'mello', 'possibilidad', 'preservacao', 'reuniao', 'ricardo', 'sall', 'sall', 'sall', 'sociai']","[1, 1, 1, 1, 1, 1, 1, 1, 1, 3, 3, 3, 1]","[]","[]",13,0,13,1
9724,"['airlin', 'companhia', 'companhia', 'compromis', 'passageiro', 'passageiro', 'voo']","[1, 2, 2, 1, 2, 2, 1]","['dubai', 'dubai', 'dubai']","[3, 3, 3]",7,3,10,1
9725,"['afetado', 'crise', 'destinar', 'orcamentaria', 'palacio', 'planalto', 'recurso', 'regiao', 'republico', 'revogar', 'secom', 'transferencia', 'transferir', 'transferir']","[1, 1, 1, 1, 1, 1, 1, 1, 1, 1, 1, 1, 2, 2]","[]","[]",14,0,14,1
9727,"['oficialment']","[1]","[]","[]",1,0,1,1
9729,"['argumentar', 'colegiado', 'decisao', 'economia', 'funcionamento', 'fux', 'fux', 'fux', 'gued', 'gued', 'ministrar', 'planar', 'prioridad', 'recurso', 'rejeitar', 'republico', 'republico', 'supremo', 'supremo', 'supremo', 'supremo']","[1, 1, 1, 1, 1, 3, 3, 3, 2, 2, 1, 1, 1, 1, 1, 2, 2, 4, 4, 4, 4]","[]","[]",21,0,21,1
9731,"['punicao', 'republico', 'significativo', 'silveiro', 'silveiro', 'sobretudo', 'supremo']","[1, 1, 1, 2, 2, 1, 1]","[]","[]",7,0,7,1
9732,"['folhar', 'instituto', 'integro', 'lira', 'oliveira', 'saudar', 'sessao']","[1, 1, 1, 1, 1, 1, 1]","[]","[]",7,0,7,1
9733,"['biliao', 'desenvolvimento', 'desenvolvimento', 'opcao', 'opcao', 'plano', 'precedent', 'precedent', 'propagacao', 'recuperacao', 'temporario', 'temporario']","[1, 2, 2, 2, 2, 1, 2, 2, 1, 1, 2, 2]","[]","[]",12,0,12,1
9736,"['ministrar', 'ministrar', 'prescricao', 'regrar', 'respectivament', 'risco', 'sabado', 'saudar', 'saudar']","[2, 2, 1, 1, 1, 1, 1, 2, 2]","[]","[]",9,0,9,1
9740,"['etapa', 'etapa', 'processo', 'resultado', 'treinamento', 'treinamento', 'turma', 'vigilancia']","[2, 2, 1, 1, 2, 2, 1, 1]","[]","[]",8,0,8,1
9742,"['alteracao', 'ambientar', 'ambientar', 'ambientar', 'ambientar', 'desmatamento', 'economia', 'economia', 'economia', 'especifico', 'gued', 'justicar', 'pastar', 'pastar', 'planar', 'ppa', 'preservacao', 'prever', 'proposto', 'proposto', 'recuar', 'recuar', 'ricardo', 'sall']","[1, 4, 4, 4, 4, 1, 3, 3, 3, 1, 1, 1, 2, 2, 1, 1, 1, 1, 2, 2, 2, 2, 1, 1]","['incendio']","[1]",24,1,25,1
9745,"['avancar', 'condicao', 'europeu', 'fronteiro', 'fronteiro', 'humanitario', 'ministrar', 'reabrir', 'reabrir', 'reuniao', 'turista']","[1, 1, 1, 2, 2, 1, 1, 2, 2, 1, 1]","[]","[]",11,0,11,1
9747,"['diagnosticar', 'kong', 'kong', 'possibilidad']","[1, 2, 2, 1]","[]","[]",4,0,4,1
9748,"['anvisa', 'decisao', 'desembarcar', 'justicar', 'passageiro', 'preocupacao', 'quarentenar', 'saudar', 'sugestao', 'viajant', 'vigilancia']","[1, 1, 1, 1, 1, 1, 1, 1, 1, 1, 1]","[]","[]",11,0,11,1
9751,"['alteracao', 'aplicacao', 'cenario', 'circulacao', 'circulacao', 'circulacao', 'comorbidad', 'consequencia', 'constatar', 'decisao', 'decisao', 'decorrent', 'dificultar', 'dosar', 'estimular', 'estimular', 'exercicio', 'exercicio', 'exercicio', 'facilitar', 'gestant', 'gestant', 'gestant', 'imunizacao', 'interrupcao', 'jornada', 'normalment', 'periodo', 'periodo', 'periodo', 'pulmonar', 'respiratorio', 'risco', 'risco', 'saudar', 'saudar', 'suspensao', 'viagem']","[1, 1, 1, 3, 3, 3, 1, 1, 1, 2, 2, 1, 1, 1, 2, 2, 3, 3, 3, 1, 3, 3, 3, 1, 1, 1, 1, 3, 3, 3, 1, 1, 2, 2, 2, 2, 1, 1]","['acidentar']","[1]",38,1,39,1
9752,"['araujo', 'araujo', 'carla', 'carla', 'carla', 'colunista', 'decisao', 'mudanca', 'mudanca', 'planar', 'posturar', 'realizacao', 'realizacao', 'tornear', 'vetar']","[2, 2, 3, 3, 3, 1, 1, 2, 2, 1, 1, 2, 2, 1, 1]","[]","[]",15,0,15,1
9753,"['araujo', 'araujo', 'articulacao', 'azevedo', 'azevedo', 'azevedo', 'congresso', 'congresso', 'congresso', 'dedicar', 'destacar', 'ernesto', 'esforco', 'expectativa', 'integrant', 'ministrar', 'ministrar', 'ministrar', 'ministrar', 'ministrar', 'ministrar', 'necessidad', 'oficialment', 'palacio', 'palacio', 'pastar', 'periodo', 'planalto', 'planalto', 'planalto', 'preservar', 'preservar', 'reconhecimento', 'republico', 'reuniao', 'subordinar']","[2, 2, 1, 3, 3, 3, 3, 3, 3, 1, 1, 1, 1, 1, 1, 6, 6, 6, 6, 6, 6, 1, 1, 2, 2, 1, 1, 3, 3, 3, 2, 2, 1, 1, 1, 1]","[]","[]",36,0,36,1
9754,"['cenario', 'enquadrar', 'intenso', 'isolar', 'periferia']","[1, 1, 1, 1, 1]","['humanar', 'renunciar', 'verdadeiro']","[1, 1, 1]",5,3,8,1
9755,"['calendario', 'domingo', 'especifico', 'extensao', 'externo', 'fase', 'fluxo', 'iniciativo', 'intenso', 'intenso', 'mello', 'mello', 'mello', 'mello', 'observacao', 'observacao', 'observacao', 'observacao', 'observacao', 'observacao', 'observacao', 'observacao', 'observacao', 'observar', 'observar', 'observar', 'observar', 'observar', 'observar', 'observar', 'observar', 'observar', 'oposto', 'periodo', 'quedo', 'regiao', 'regiao', 'regiao', 'regiao', 'regiao', 'regiao', 'regiao', 'regiao', 'regiao', 'regiao', 'regiao', 'sudest', 'ufrj', 'ufrj']","[1, 1, 1, 1, 1, 1, 1, 1, 2, 2, 4, 4, 4, 4, 9, 9, 9, 9, 9, 9, 9, 9, 9, 9, 9, 9, 9, 9, 9, 9, 9, 9, 1, 1, 1, 11, 11, 11, 11, 11, 11, 11, 11, 11, 11, 11, 1, 2, 2]","['fotografia', 'imagem']","[1, 1]",49,2,51,1
9758,"['autoridad', 'azevedo', 'compromisso', 'conformar', 'coordenar', 'gabinet', 'infraestrutura', 'infraestrutura', 'planalto', 'ramagem', 'regiao', 'republico', 'sabado', 'viagem']","[1, 1, 1, 1, 1, 1, 2, 2, 1, 1, 1, 1, 1, 1]","[]","[]",14,0,14,1
9760,"['calculo', 'calculo', 'consorcio', 'contabilizar', 'diariament', 'distrito', 'enxergar', 'escassez', 'estabilidad', 'estatistico', 'folhar', 'inconsistencia', 'infectar', 'iniciativo', 'plantao', 'preliminar', 'quedo', 'recurso', 'saudar', 'saudar', 'spaulo', 'tendencia', 'tendencia', 'totalizar']","[2, 2, 1, 1, 1, 1, 1, 1, 1, 1, 1, 1, 1, 1, 1, 1, 1, 1, 2, 2, 1, 2, 2, 1]","[]","[]",24,0,24,1
9761,"['biliao', 'biliao', 'biliao', 'desigualdad', 'instituto']","[3, 3, 3, 1, 1]","[]","[]",5,0,5,1
9763,"['advocaciager', 'cometido', 'decisao', 'entendimento', 'exercicio', 'flavio', 'funcao', 'plenario', 'rachadinha', 'rejeicao', 'republicanosrj', 'supremo', 'supremo', 'sustentabilidad']","[1, 1, 1, 1, 1, 1, 1, 1, 1, 1, 1, 2, 2, 1]","[]","[]",14,0,14,1
9764,"['adulto', 'aliviar', 'internacao', 'primeiroministro', 'prioritario', 'quedo', 'sabado', 'saudar', 'vulneravel']","[1, 1, 1, 1, 1, 1, 1, 1, 1]","[]","[]",9,0,9,1
9769,"['anuncio']","[1]","[]","[]",1,0,1,1
9772,"['adulto', 'atrasar', 'calendario', 'calendario', 'colunista', 'fornecimento', 'imunizacao', 'imunizacao', 'imunizacao', 'rossi', 'saudar', 'souza']","[1, 1, 2, 2, 1, 1, 3, 3, 3, 1, 1, 1]","[]","[]",12,0,12,1
9773,"['alvaro', 'antonio', 'companhia', 'compromisso', 'domingo', 'ministrar', 'pastar', 'previsto', 'turista']","[1, 1, 1, 1, 1, 1, 1, 1, 1]","['gravacao']","[1]",9,1,10,1
9774,"['economia', 'esforco', 'limitacao', 'periodo', 'previsto', 'primeiroministro', 'regiao', 'submetido', 'vespera']","[1, 1, 1, 1, 1, 1, 1, 1, 1]","[]","[]",9,0,9,1
9775,"['algun', 'atuam', 'desafio', 'esquema', 'estimular', 'exercicio', 'profissionai', 'pulmo', 'recurso', 'respiratorio', 'resultado', 'situacao']","[1, 1, 1, 1, 1, 1, 1, 1, 1, 1, 1, 1]","[]","[]",12,0,12,1
9776,"['acordo', 'comunitario', 'coreia', 'decisao', 'destacar', 'economia', 'economia', 'incerteza', 'incerteza', 'situacao', 'situacao']","[1, 1, 1, 1, 1, 2, 2, 2, 2, 2, 2]","[]","[]",11,0,11,1
9777,"['anuncio', 'companhia', 'ministrar', 'republico']","[1, 1, 1, 1]","[]","[]",4,0,4,1
9783,"['constituicao', 'discussao', 'emendar', 'folhar', 'fundeb', 'integro', 'proposto']","[1, 1, 1, 1, 1, 1, 1]","[]","[]",7,0,7,1
9784,"['imunizacao', 'painel', 'painel', 'painel', 'saudar', 'saudar']","[1, 3, 3, 3, 2, 2]","[]","[]",6,0,6,1
9786,"['alckmin', 'ambientar', 'ambientar', 'ambito', 'decisao', 'geraldo', 'inquerito', 'justicar', 'ministrar', 'ministrar', 'periodo', 'periodo', 'ricardo', 'sall', 'sall', 'sall', 'varar']","[1, 2, 2, 1, 1, 1, 1, 1, 2, 2, 2, 2, 1, 3, 3, 3, 1]","[]","[]",17,0,17,1
9787,"['adotada', 'afp', 'espanha', 'europeu', 'passageiro', 'passageiro', 'portavoz', 'portavoz', 'voo']","[1, 1, 1, 1, 2, 2, 2, 2, 1]","[]","[]",9,0,9,1
9788,"['administrativo', 'associacao', 'barroso', 'congresso', 'constituicao', 'economia', 'enfrentamento', 'ministrar', 'ministrar', 'privar', 'republico', 'republico', 'respostar', 'saudar', 'saudar', 'supremo', 'supremo', 'sustentabilidad']","[1, 1, 1, 1, 1, 1, 1, 2, 2, 1, 2, 2, 1, 2, 2, 2, 2, 1]","[]","[]",18,0,18,1
9789,"['antecipar', 'celso', 'dialogo', 'etapa', 'tatto', 'tatto', 'tatto', 'transferencia']","[1, 1, 1, 1, 3, 3, 3, 1]","[]","[]",8,0,8,1
9792,"['alteracao', 'aprovacao', 'autoridad', 'descumprir', 'equipamento', 'especifico', 'inicialment', 'prever', 'privar', 'proposto', 'regulamentar', 'saudar']","[1, 1, 1, 1, 1, 1, 1, 1, 1, 1, 1, 1]","[]","[]",12,0,12,1
9793,"['assistencia', 'associacao', 'atuacao', 'atuacao', 'coordenar', 'crescimento', 'curso', 'enfrentamento', 'iniciativo', 'intensivo', 'intensivo', 'ministrar', 'necessidad', 'queiroga', 'reforcar', 'saudar', 'saudar', 'saudar', 'saudar']","[1, 1, 2, 2, 1, 1, 1, 1, 1, 2, 2, 1, 1, 1, 1, 4, 4, 4, 4]","[]","[]",19,0,19,1
9794,"['confirmado', 'economia']","[1, 1]","[]","[]",2,0,2,1
9796,"['arthur', 'lira', 'lira', 'lira', 'ppal']","[1, 3, 3, 3, 1]","[]","[]",5,0,5,1
9798,"['agravamento', 'crise', 'inquerito', 'integro', 'movimentacao', 'necessidad', 'pastar', 'planar', 'saudar', 'saudar', 'transferir', 'transferir']","[1, 1, 1, 1, 1, 1, 1, 1, 2, 2, 2, 2]","[]","[]",12,0,12,1
9800,"['contribuicao', 'jornada', 'provisorio', 'reducao', 'sancao', 'sancao', 'supremo']","[1, 1, 1, 1, 2, 2, 1]","[]","[]",7,0,7,1
9802,"['exministro', 'exministro', 'henriqu', 'infeccioso', 'saudar', 'saudar', 'situacao']","[2, 2, 1, 1, 2, 2, 1]","['enfim']","[1]",7,1,8,1
9803,"['flavio', 'flavio', 'folhar', 'integro', 'justicar', 'justicar', 'pagamento', 'segredar', 'varar']","[2, 2, 1, 1, 2, 2, 1, 1, 1]","['menino', 'menino']","[2, 2]",9,2,11,1
9806,"['apreensao', 'circulacao', 'espirito', 'isolar', 'justicar', 'passageiro', 'passageiro', 'prever', 'quilometro', 'saudar', 'suspensao', 'turistico', 'urbano', 'wilson', 'witzel']","[1, 1, 1, 1, 1, 2, 2, 1, 1, 1, 1, 1, 1, 1, 1]","['circular', 'motorista']","[1, 1]",15,2,17,1
9807,"['adulto', 'calendario', 'fase', 'inquerito', 'internacao', 'observar', 'oficio', 'planar', 'presenciar', 'prioridad', 'proporcao', 'saudar', 'taxar', 'taxar']","[1, 1, 1, 1, 1, 1, 1, 1, 1, 1, 1, 1, 2, 2]","[]","[]",14,0,14,1
9808,"['bbc', 'bbc']","[2, 2]","['soldar']","[1]",2,1,3,1
9810,"['avancar', 'folhar', 'integro', 'parcelar', 'piorar', 'piorar', 'recordar', 'situacao', 'situacao', 'situacao']","[1, 1, 1, 1, 2, 2, 1, 3, 3, 3]","[]","[]",10,0,10,1
9812,"['araujo', 'converso', 'cooperacao', 'cooperacao', 'economia', 'ernesto', 'especialment', 'especialment', 'estrategico', 'estrategico', 'ministrar', 'ministrar', 'parceria', 'parceria', 'parceria', 'perspectivo', 'perspectivo', 'suprimento', 'suprimento', 'suprimento']","[1, 1, 2, 2, 1, 1, 2, 2, 2, 2, 2, 2, 3, 3, 3, 2, 2, 3, 3, 3]","[]","[]",20,0,20,1
9813,"['assistencia', 'associacao', 'comparacao', 'contabilizar', 'intervalar', 'painel', 'parceria', 'periodo', 'periodo', 'periodo', 'queiroga', 'regiao', 'saudar', 'saudar']","[1, 1, 1, 1, 1, 1, 1, 3, 3, 3, 1, 1, 2, 2]","[]","[]",14,0,14,1
9814,"['apurar', 'apurar', 'bandeirant', 'bandeirant', 'definitivo', 'oficialment', 'planar', 'precandidato']","[2, 2, 2, 2, 1, 1, 1, 1]","[]","[]",8,0,8,1
9815,"['adulto', 'biliao', 'demandar', 'necessario', 'orientacao', 'parcelar', 'pastar', 'periodo', 'planar', 'prorrogacao', 'prorrogacao', 'prorrogar', 'prorrogar', 'prorrogar', 'reforcar', 'saudar', 'saudar', 'saudar', 'saudar', 'taxar']","[1, 1, 1, 1, 1, 1, 1, 1, 1, 2, 2, 3, 3, 3, 1, 4, 4, 4, 4, 1]","[]","[]",20,0,20,1
9816,"['flavio', 'infraestrutura', 'ministrar', 'republicanosrj']","[1, 1, 1, 1]","['adorar', 'ganhar']","[1, 1]",4,2,6,1
9830,"['exercicio', 'instituto', 'letalidad', 'liderar', 'marilia', 'taxar']","[1, 1, 1, 1, 1, 1]","['realment', 'replicar']","[1, 1]",6,2,8,1
9835,"['atuacao', 'comunitario', 'comunitario', 'dificuldad', 'especialment', 'instituto', 'pereira', 'periferia', 'resistencia', 'souza', 'ufrj', 'urbano']","[1, 2, 2, 1, 1, 1, 1, 1, 1, 1, 1, 1]","[]","[]",12,0,12,1
9836,"['saudar', 'vigilancia', 'visitant', 'voo']","[1, 1, 1, 1]","[]","[]",4,0,4,1
9837,"['aplicacao', 'azevedo', 'converso', 'distrito', 'dosar', 'integro', 'ministrar']","[1, 1, 1, 1, 1, 1, 1]","[]","[]",7,0,7,1
9838,"['decorrencia']","[1]","[]","[]",1,0,1,1
9841,"['intensivo', 'internar', 'mantido', 'sabado', 'saudar', 'saudar', 'transferir', 'ventilacao']","[1, 1, 1, 1, 2, 2, 1, 1]","['imagem']","[1]",8,1,9,1
9843,"['condicao', 'decorrencia', 'diagnosticar', 'infectar', 'internar', 'positivar', 'toquio']","[1, 1, 1, 1, 1, 1, 1]","[]","[]",7,0,7,1
9844,"['arthur', 'azevedo', 'folhar', 'funcionamento', 'gabinet', 'integro', 'margem', 'paralelo', 'saudar']","[1, 1, 1, 1, 1, 1, 1, 1, 1]","[]","[]",9,0,9,1
9849,"['diagnosticar', 'intensivo', 'internar', 'justicar', 'magistrado', 'piorar', 'saudar', 'situacao']","[1, 1, 1, 1, 1, 1, 1, 1]","[]","[]",8,0,8,1
9850,"['balancar', 'infectar', 'infectar', 'infectar', 'saudar', 'saudar', 'subir', 'subir']","[1, 3, 3, 3, 2, 2, 2, 2]","[]","[]",8,0,8,1
9851,"['autoridad', 'autoridad', 'celebrar', 'hospitalizar', 'infectar', 'observar', 'reabertura', 'sabado', 'saudar']","[2, 2, 1, 1, 1, 1, 1, 1, 1]","[]","[]",9,0,9,1
9852,"['avancar', 'cronica', 'hipertensao', 'infectar', 'internar', 'quadro', 'vulneravel']","[1, 1, 1, 1, 1, 1, 1]","[]","[]",7,0,7,1
9853,"['aliviar', 'cardiologista', 'presenciar', 'recuperacao']","[1, 1, 1, 1]","[]","[]",4,0,4,1
9854,"['campino', 'capitar', 'exjuiz', 'exministro', 'exministro', 'inquerito', 'interferencia', 'investigacao', 'investigacao', 'justicar', 'pastar']","[1, 1, 1, 2, 2, 1, 1, 2, 2, 1, 1]","['realment']","[1]",11,1,12,1
9855,"['agravamento', 'decorrencia', 'fundacao', 'oswaldo', 'prazo', 'prazo', 'pulmonar', 'pulmonar', 'respiratorio', 'saudar']","[1, 1, 1, 1, 2, 2, 2, 2, 1, 1]","[]","[]",10,0,10,1
9856,"['adotada', 'ambientar', 'cenario', 'comportamento', 'consequencia', 'psicologo', 'quarentenar', 'quarentenar', 'saudar']","[1, 1, 1, 1, 1, 1, 2, 2, 1]","[]","[]",9,0,9,1
9858,"['aglomeracao', 'cenario', 'globonew', 'orientacao', 'temor']","[1, 1, 1, 1, 1]","[]","[]",5,0,5,1
9859,"['capitar', 'domingo', 'levantamento', 'recordar']","[1, 1, 1, 1]","[]","[]",4,0,4,1
9860,"['parceiro', 'precaucao', 'saudar', 'temporariament']","[1, 1, 1, 1]","[]","[]",4,0,4,1
9863,"['afp', 'colombio', 'mexico', 'provincia', 'reportar', 'reportar', 'sabado', 'viagem']","[1, 1, 1, 1, 2, 2, 1, 1]","['equador']","[1]",8,1,9,1
9864,"['articulacao', 'epidemiar', 'estatistico', 'estrategico', 'habitant', 'habitant', 'pastar', 'presenca', 'saudar', 'saudar', 'substituto', 'taxar', 'vigilancia']","[1, 1, 1, 1, 2, 2, 1, 1, 2, 2, 1, 1, 1]","[]","[]",13,0,13,1
9866,"['comparacao', 'crescimento', 'folhar', 'integro', 'saudar', 'superar']","[1, 1, 1, 1, 1, 1]","[]","[]",6,0,6,1
9868,"['autoridad', 'hubei', 'normalidad', 'provincia', 'quarentenar', 'rigoroso', 'ritmar', 'submetido', 'turistico']","[1, 1, 1, 1, 1, 1, 1, 1, 1]","[]","[]",9,0,9,1
9869,"['habitant', 'informaco', 'milho', 'plano', 'recurso', 'sabado', 'serao', 'tambem', 'tambem']","[1, 1, 1, 1, 1, 1, 1, 2, 2]","[]","[]",9,0,9,1
9871,"['decisao', 'depoimento', 'goncalv', 'goncalv', 'investigacao', 'justicar', 'ministrar', 'ministrar', 'necessario', 'pereira', 'pereira', 'prorrogar', 'prorrogar', 'saudar', 'temporario', 'wilson', 'witzel']","[1, 1, 2, 2, 1, 1, 2, 2, 1, 2, 2, 2, 2, 1, 1, 1, 1]","[]","[]",17,0,17,1
9873,"['client', 'regiao', 'regiao']","[1, 2, 2]","[]","[]",3,0,3,1
9876,"['alternativo', 'argumentar', 'autonomia', 'decisao', 'decisao', 'decisao', 'decorrent', 'depressao', 'infectar', 'julgamento', 'minimizar', 'ministrar', 'presenciar', 'reclamacao', 'saudar', 'saudar', 'saudar', 'situacao', 'situacao', 'situacao', 'subir', 'supremo', 'supremo']","[1, 1, 1, 3, 3, 3, 1, 1, 1, 1, 1, 1, 1, 1, 3, 3, 3, 3, 3, 3, 1, 2, 2]","[]","[]",23,0,23,1
9877,"['autorizacao', 'decisao', 'decisao', 'domingo', 'justicar', 'oficialment', 'prazo', 'reuter']","[1, 2, 2, 1, 1, 1, 1, 1]","[]","[]",8,0,8,1
9878,"['bbc', 'decisao', 'elaborar', 'impactar', 'inglaterra', 'plano', 'portavoz', 'portavoz', 'portavoz', 'quarentenar', 'quarentenar', 'realizacao', 'suprimento', 'surtir', 'viajant', 'viajant']","[1, 1, 1, 1, 1, 1, 3, 3, 3, 2, 2, 1, 1, 1, 2, 2]","[]","[]",16,0,16,1
9880,"['aliquota', 'aliquota', 'aliquota', 'anuncio', 'facilitar', 'facilitar', 'facilitar', 'importacao', 'importacao', 'importacao', 'reducao', 'republico', 'resolucao', 'temporario']","[3, 3, 3, 1, 3, 3, 3, 3, 3, 3, 1, 1, 1, 1]","[]","[]",14,0,14,1
9883,"['alvorar', 'colegio', 'comissao', 'comissao', 'comissao', 'comissao', 'comissao', 'comissao', 'comissao', 'compromisso', 'condicao', 'crise', 'dedicar', 'etapa', 'excecao', 'gabinet', 'henriqu', 'importancia', 'instalacao', 'instalacao', 'instalacao', 'investigacao', 'itamar', 'justicar', 'mello', 'minoria', 'nelson', 'palacio', 'processo', 'regiao', 'republico', 'republico', 'transicao', 'transicao', 'viagem']","[1, 1, 7, 7, 7, 7, 7, 7, 7, 1, 1, 1, 1, 1, 1, 1, 1, 1, 3, 3, 3, 1, 1, 1, 1, 1, 1, 1, 1, 1, 2, 2, 2, 2, 1]","['capturar', 'fotografo', 'imagem', 'motorista', 'protestar', 'protestar', 'torturar', 'torturar']","[1, 1, 1, 1, 2, 2, 2, 2]",35,8,43,1
9885,"['afetado', 'alcolumbr', 'biliao', 'biliao', 'conjuntar', 'conjuntar', 'converso', 'crise', 'crise', 'demap', 'demrj', 'distrito', 'manutencao', 'reuniao', 'reuniao', 'sancao', 'sancao', 'saudar', 'superar', 'vetar', 'videoconferencia']","[1, 1, 2, 2, 2, 2, 1, 2, 2, 1, 1, 1, 1, 2, 2, 2, 2, 1, 1, 1, 1]","[]","[]",21,0,21,1
9886,"['desenvolvido']","[1]","[]","[]",1,0,1,1
9888,"['decorrencia', 'espirito', 'intubacao', 'queixar', 'saudar', 'surtir', 'ventilacao']","[1, 1, 1, 1, 1, 1, 1]","[]","[]",7,0,7,1
9893,"['acordo', 'apostar', 'autoridad', 'avancar', 'desafiar', 'desempenhar', 'economia', 'economia', 'economia', 'epidemiar', 'estagio', 'letalidad', 'minoria', 'modelo', 'modelo', 'mudanca', 'mudanca', 'paralisar', 'preocupacao', 'privar', 'respostar', 'respostar', 'suprimento', 'surtir', 'velocidad', 'vulneravel', 'vulneravel']","[1, 1, 1, 1, 1, 1, 3, 3, 3, 1, 1, 1, 1, 2, 2, 2, 2, 1, 1, 1, 2, 2, 1, 1, 1, 2, 2]","['huawei', 'huawei', 'huawei']","[3, 3, 3]",27,3,30,1
9894,"['acordo', 'airlin', 'compromisso', 'discussao', 'eventualment', 'pedido', 'pedido', 'prazo', 'prazo', 'previsto', 'processo', 'proximo', 'recuperacao', 'recuperacao', 'sustentabilidad', 'tambem', 'voo']","[1, 1, 1, 1, 1, 2, 2, 2, 2, 1, 1, 1, 2, 2, 1, 1, 1]","['equador']","[1]",17,1,18,1
9896,"['adotada', 'amplo', 'antonio', 'congresso', 'crescimento', 'crise', 'crise', 'discussao', 'exministro', 'proposto', 'transferencia', 'transferencia', 'tributario', 'tributario']","[1, 1, 1, 1, 1, 2, 2, 1, 1, 1, 2, 2, 2, 2]","[]","[]",14,0,14,1
9898,"['adotada', 'adotada', 'avancar', 'determinacao', 'distrito', 'infectar', 'infectar', 'privar', 'quarentenar', 'quarentenar', 'realizacao', 'saudar', 'surtir', 'suspensao']","[2, 2, 1, 1, 1, 2, 2, 1, 2, 2, 1, 1, 1, 1]","[]","[]",14,0,14,1
9899,"['biliao', 'biliao', 'biliao', 'biliao', 'bruto', 'calamidad', 'calculo', 'conformar', 'despesa', 'despesa', 'economia', 'estimativo', 'expectativa', 'extensao', 'internar', 'mantido', 'pib', 'primario', 'primario', 'primario', 'projecao', 'quedo', 'tesourar']","[4, 4, 4, 4, 1, 1, 1, 1, 2, 2, 1, 1, 1, 1, 1, 1, 1, 3, 3, 3, 1, 1, 1]","[]","[]",23,0,23,1
9901,"['claudio', 'coordenar', 'destinar', 'exercicio', 'expectativa', 'imunizacao', 'logistico', 'metropolitano', 'pastar', 'planar', 'regiao', 'saudar', 'totalizar']","[1, 1, 1, 1, 1, 1, 1, 1, 1, 1, 1, 1, 1]","[]","[]",13,0,13,1
9902,"['sabado']","[1]","[]","[]",1,0,1,1
9904,"['condenacao', 'decisao', 'decisao', 'edson', 'fachin', 'fachin', 'integro', 'julgamento', 'ministrar', 'plenario', 'processo', 'proferir', 'supremo', 'supremo', 'varar']","[1, 2, 2, 1, 2, 2, 1, 1, 1, 1, 1, 1, 2, 2, 1]","[]","[]",15,0,15,1
9905,"['aglomeracao', 'aglomeracao', 'domingo', 'facilitar', 'palacio', 'palacio', 'planalto', 'planalto', 'presenca', 'saudar', 'transmissao']","[2, 2, 1, 1, 2, 2, 2, 2, 1, 1, 1]","[]","[]",11,0,11,1
9909,"['capitar', 'cerimonia', 'cerimonia', 'coordenar', 'fundacao', 'oswaldo']","[1, 2, 2, 1, 1, 1]","['revoltar']","[1]",6,1,7,1
9910,"['bolsonarista', 'recurso']","[1, 1]","[]","[]",2,0,2,1
9914,"['alteracao', 'comparacao', 'congresso', 'congresso', 'contrato', 'despesa', 'manutencao', 'mudanca', 'orcamentaria', 'prever', 'recurso', 'recurso', 'reducao', 'saudar']","[1, 1, 2, 2, 1, 1, 1, 1, 1, 1, 2, 2, 1, 1]","[]","[]",14,0,14,1
9915,"['cenario', 'competicao', 'competicao', 'europeu', 'paralisar', 'proliferacao', 'propagacao', 'realizacao', 'risco', 'tornear']","[1, 2, 2, 1, 1, 1, 1, 1, 1, 1]","['greve', 'protestar', 'versao']","[1, 1, 1]",10,3,13,1
9916,"['abordagem', 'imunizacao', 'infectar']","[1, 1, 1]","['nasal', 'versao']","[1, 1]",3,2,5,1
9917,"['converso', 'preservacao', 'subordinar', 'subordinar']","[1, 1, 2, 2]","['macho', 'macho']","[2, 2]",4,2,6,1
9920,"['acordo', 'adotada', 'augusto', 'colunista', 'crise', 'economia', 'instituto', 'organizado', 'parceria', 'possibilidad', 'relacao', 'sobretudo']","[1, 1, 1, 1, 1, 1, 1, 1, 1, 1, 1, 1]","['ideologia', 'supostament']","[1, 1]",12,2,14,1
9921,"['cerimonia', 'crise', 'economia', 'folhar', 'integro']","[1, 1, 1, 1, 1]","['parabem']","[1]",5,1,6,1
9925,"['autoridad', 'biliao', 'biliao', 'biliao', 'compromisso', 'crise', 'emprestimo', 'emprestimo', 'emprestimo', 'ministrar', 'pastar', 'quilometro', 'reuniao']","[1, 3, 3, 3, 1, 1, 3, 3, 3, 1, 1, 1, 1]","[]","[]",13,0,13,1
9926,"['afp', 'belgica', 'epidemia', 'espanha', 'espanha', 'habitant', 'letalidad', 'letalidad', 'relacao']","[1, 1, 1, 2, 2, 1, 2, 2, 1]","['espalh']","[1]",9,1,10,1
9927,"['alcolumbr', 'alcolumbr', 'demap', 'fornecimento', 'justicar', 'ministrar', 'previsao', 'reforcar', 'sabado', 'situacao', 'situacao']","[2, 2, 1, 1, 1, 1, 1, 1, 1, 2, 2]","[]","[]",11,0,11,1
9929,"['comparacao', 'congresso', 'crise', 'domingo', 'economia', 'economia', 'ministrar', 'necessario', 'parcelar', 'patamar', 'pratico', 'proposto', 'provisorio', 'recurso', 'tramitar', 'transferencia']","[1, 1, 1, 1, 2, 2, 1, 1, 1, 1, 1, 1, 1, 1, 1, 1]","['narrativo']","[1]",16,1,17,1
9932,"['argumentar', 'autoridad', 'autoridad', 'autorizacao', 'avancar', 'cenario', 'cenario', 'cenario', 'competicao', 'competicao', 'condicao', 'condicao', 'condicao', 'consequencia', 'economia', 'especifico', 'flexibilizar', 'mandatario', 'prever', 'processo', 'saudar', 'saudar', 'saudar', 'treinamento', 'treinar', 'treino']","[1, 2, 2, 1, 1, 3, 3, 3, 2, 2, 3, 3, 3, 1, 1, 1, 1, 1, 1, 1, 3, 3, 3, 1, 1, 1]","[]","[]",26,0,26,1
9934,"['adicionar', 'aglomeracao', 'autoridad', 'epidemiar', 'epidemiar', 'oficialment', 'particularment', 'propagacao', 'superar']","[1, 1, 1, 2, 2, 1, 1, 1, 1]","['atribuir']","[1]",9,1,10,1
9935,"['atrasar', 'ausencia', 'barroso', 'comparacao', 'funcao', 'justicar', 'previo', 'prtb', 'prtb', 'velocidad']","[1, 1, 1, 1, 1, 1, 1, 2, 2, 1]","[]","[]",10,0,10,1
9937,"['alerj', 'apreensao', 'argumentar', 'argumentar', 'colegiado', 'decisao', 'decisao', 'decisao', 'depoimento', 'edson', 'fachin', 'goncalv', 'goncalv', 'justicar', 'legislativo', 'ministrar', 'ministrar', 'ministrar', 'sobretudo', 'supremo', 'wilson', 'witzel', 'witzel', 'witzel', 'witzel']","[1, 1, 2, 2, 1, 3, 3, 3, 1, 1, 1, 2, 2, 1, 1, 3, 3, 3, 1, 1, 1, 4, 4, 4, 4]","[]","[]",25,0,25,1
9938,"['afetado', 'andrew', 'economia', 'prazo', 'primeiroministro']","[1, 1, 1, 1, 1]","[]","[]",5,0,5,1
9946,"['anvisa', 'anvisa', 'anvisa', 'conformar', 'decisao', 'decisao', 'decisao', 'decisao', 'descumprimento', 'integrant', 'interino', 'julgamento', 'julgamento', 'nelson', 'notificar', 'oficio', 'oficio', 'orientacao', 'parceiro', 'pastar', 'periodo', 'posicionamento', 'possibilidad', 'pratico', 'prever', 'privar', 'reclamacao', 'recurso', 'reforcar', 'regrar', 'regrar', 'rejeitar', 'saudar', 'saudar', 'saudar', 'supremo', 'supremo', 'teich', 'vigilancia']","[3, 3, 3, 1, 4, 4, 4, 4, 1, 1, 1, 2, 2, 1, 1, 2, 2, 1, 1, 1, 1, 1, 1, 1, 1, 1, 1, 1, 1, 2, 2, 1, 3, 3, 3, 2, 2, 1, 1]","[]","[]",39,0,39,1
9949,"['enfrentamento', 'estrategico', 'necessario', 'orientacao', 'parcelar', 'pastar', 'pastar', 'planar', 'prorrogacao', 'prorrogacao', 'prorrogar', 'prorrogar', 'saudar', 'saudar', 'saudar', 'saudar', 'saudar', 'taxar']","[1, 1, 1, 1, 1, 2, 2, 1, 2, 2, 2, 2, 5, 5, 5, 5, 5, 1]","[]","[]",18,0,18,1
9953,"['diagnosticar', 'diagnosticar', 'positivar']","[2, 2, 1]","['parir']","[1]",3,1,4,1
9957,"['espanha', 'pereira', 'pereira', 'positivar', 'temporada', 'treinar', 'treinar']","[1, 2, 2, 1, 1, 2, 2]","[]","[]",7,0,7,1
9958,"['afastamento', 'araujo', 'araujo', 'atuacao', 'cupula', 'cupula', 'distrito', 'distrito', 'distrito', 'esquema', 'fase', 'globonew', 'negativar', 'paralisar', 'pastar', 'preventivo', 'preventivo', 'rocha', 'saudar', 'saudar', 'saudar', 'saudar', 'servidor', 'servidor', 'servidor']","[1, 2, 2, 1, 2, 2, 3, 3, 3, 1, 1, 1, 1, 1, 1, 2, 2, 1, 4, 4, 4, 4, 3, 3, 3]","['falsar']","[1]",25,1,26,1
9959,"['circulacao', 'congresso', 'consumidor', 'decisao', 'estimular', 'impactar', 'legislativo', 'mudanca', 'projeco']","[1, 1, 1, 1, 1, 1, 1, 1, 1]","['greve']","[1]",9,1,10,1
9960,"['afastamento', 'afastamento', 'decisao', 'desvio', 'esquema', 'goncalv', 'investigacao', 'irregularidad', 'justicar', 'lavagem', 'ministrar', 'recurso', 'republico', 'saudar', 'saudar', 'supremo', 'wilson', 'witzel', 'witzel', 'witzel', 'witzel']","[2, 2, 1, 1, 1, 1, 1, 1, 1, 1, 1, 1, 1, 2, 2, 1, 1, 4, 4, 4, 4]","['supostament']","[1]",21,1,22,1
9961,"['alvorar', 'enxergar', 'fundeb', 'opcao', 'regrar', 'sugestao']","[1, 1, 1, 1, 1, 1]","[]","[]",6,0,6,1
9964,"['balancar', 'comparacao', 'consolidar', 'consorcio', 'consorcio', 'decorrent', 'domingo', 'levantamento', 'montant', 'patamar', 'quedo', 'quedo', 'ritmar', 'sabado', 'saudar', 'situacao', 'superar', 'tendencia', 'tendencia', 'tendencia', 'totalizar', 'variacao']","[1, 1, 1, 2, 2, 1, 1, 1, 1, 1, 2, 2, 1, 1, 1, 1, 1, 3, 3, 3, 1, 1]","[]","[]",22,0,22,1
9967,"['conjuntar', 'deflagrar', 'justicar', 'lewandowski', 'ministrar', 'ministrar', 'ministrar', 'ricardo']","[1, 1, 1, 1, 3, 3, 3, 1]","['vazar']","[1]",8,1,9,1
9970,"['adversario', 'adversario', 'apoio', 'bruno', 'parceria', 'spaulo']","[2, 2, 1, 1, 1, 1]","['imagem', 'numericament']","[1, 1]",6,2,8,1
9971,"['antecipar', 'azevedo', 'comorbidad', 'comorbidad', 'enquadrar', 'gestant', 'gestant', 'imunizacao', 'irregularidad', 'justicar', 'mudanca', 'prioridad', 'prioritario', 'prioritario', 'saudar', 'suspeito']","[1, 1, 2, 2, 1, 2, 2, 1, 1, 1, 1, 1, 2, 2, 1, 1]","[]","[]",16,0,16,1
9977,"['desgastar', 'eventualment', 'exministro', 'exministro', 'flexibilizacao', 'folhar', 'henriqu', 'integrant', 'interlocutor', 'ministrar', 'palacio', 'palacio', 'planalto', 'planalto', 'possibilidad', 'quarentenar', 'saudar', 'saudar']","[1, 1, 2, 2, 1, 1, 1, 1, 1, 1, 2, 2, 2, 2, 1, 1, 2, 2]","[]","[]",18,0,18,1
9978,"['boletim', 'diariament', 'funcao', 'portavoz']","[1, 1, 1, 1]","[]","[]",4,0,4,1
9980,"['autorizacao', 'carat', 'decorrent', 'destinar', 'destinar', 'destinar', 'flexibilizar', 'importancia', 'jorg', 'mudanca', 'periodo', 'regrar', 'resolucao', 'resolucao', 'sabado', 'sabado', 'saudar', 'situacao', 'viagem']","[1, 1, 1, 3, 3, 3, 1, 1, 1, 1, 1, 1, 2, 2, 2, 2, 1, 1, 1]","['basto', 'venezuelano']","[1, 1]",19,2,21,1
9981,"['amplo', 'comissao', 'demmg', 'entendimento', 'inquerito', 'internar', 'pacheco', 'pacheco', 'reforcar', 'secretariager', 'secretariager']","[1, 1, 1, 1, 1, 1, 2, 2, 1, 2, 2]","[]","[]",11,0,11,1
9982,"['atuacao', 'competicao', 'constituicao', 'esperancar', 'jurista', 'justicar', 'paralisar', 'pratico', 'previsto', 'republico', 'republico', 'republico', 'tramitacao']","[1, 1, 1, 1, 1, 1, 1, 1, 1, 3, 3, 3, 1]","[]","[]",13,0,13,1
9983,"['adotada', 'aplicacao', 'aplicacao', 'fez', 'imunizacao', 'orientacao', 'orientacao', 'pedido', 'proposta', 'proprio']","[1, 2, 2, 1, 1, 2, 2, 1, 1, 1]","[]","[]",10,0,10,1
9984,"['contabilizar', 'contagioso', 'etapa', 'europeu', 'genoma', 'infeccioso', 'instituto', 'mutacao', 'mutacao', 'sequenciam', 'tesourar']","[1, 1, 1, 1, 1, 1, 1, 2, 2, 1, 1]","['compartilhar', 'replicar', 'versao']","[1, 1, 1]",11,3,14,1
9990,"['adiamento', 'afetado', 'decisao', 'instituto', 'logistico', 'ministrar', 'preliminar', 'ribeiro']","[1, 1, 1, 1, 1, 1, 1, 1]","['atribuir']","[1]",8,1,9,1
9991,"['celebrar', 'depoimento', 'desempenhar', 'exministro', 'exministro', 'planalto', 'preocupacao', 'respostar', 'saudar', 'saudar', 'saudar']","[1, 1, 1, 2, 2, 1, 1, 1, 3, 3, 3]","['mencao']","[1]",11,1,12,1
9992,"['aurelio', 'aurelio', 'lesao', 'mello', 'ministrar', 'ministrar', 'ministrar', 'necessario', 'opcao', 'sessao', 'sessao', 'supremo', 'supremo', 'turma']","[2, 2, 1, 1, 3, 3, 3, 1, 1, 2, 2, 2, 2, 1]","['pelar']","[1]",14,1,15,1
9997,"['antonio', 'coordenar', 'desenvolvido', 'destinar', 'destinar', 'fundacao', 'interino', 'liderar', 'oswaldo', 'previsto', 'respostar', 'saudar', 'saudar']","[1, 1, 1, 2, 2, 1, 1, 1, 1, 1, 1, 2, 2]","[]","[]",13,0,13,1
9999,"['administrativo', 'advocaciager', 'amplo', 'argumentar', 'atuacao', 'augusto', 'autoridad', 'autoridad', 'avancar', 'barroso', 'calendario', 'coletivo', 'concedido', 'conformar', 'constituicao', 'constituicao', 'dedicar', 'desenvolvido', 'destacar', 'destacar', 'determinacao', 'domicilio', 'entregu', 'epidemiar', 'especifico', 'exercicio', 'exigencia', 'expressar', 'fundamentar', 'fux', 'fux', 'fux', 'implementar', 'implementar', 'imunizacao', 'imunizacao', 'imunizacao', 'imunizacao', 'imunizacao', 'instituto', 'interlocutor', 'julgamento', 'julgamento', 'julgamento', 'julgamento', 'lewandowski', 'lewandowski', 'lewandowski', 'lewandowski', 'lewandowski', 'limitacao', 'ministrar', 'ministrar', 'ministrar', 'ministrar', 'ministrar', 'ministrar', 'ministrar', 'ministrar', 'necessario', 'pagamento', 'parceria', 'pereira', 'planar', 'plenario', 'positivar', 'possibilidad', 'possibilidad', 'possibilidad', 'possibilidad', 'preservar', 'previsao', 'prioridad', 'prioridad', 'processo', 'processo', 'regulamentar', 'republico', 'ricardo', 'saudar', 'saudar', 'saudar', 'saudar', 'saudar', 'saudar', 'saudar', 'saudar', 'saudar', 'saudar', 'saudar', 'saudar', 'saudar', 'sessao', 'sessao', 'sessao', 'sessao', 'sessao', 'situacao', 'situacao', 'sobretudo', 'supremo']","[1, 1, 1, 1, 1, 1, 2, 2, 1, 1, 1, 1, 1, 1, 2, 2, 1, 1, 2, 2, 1, 1, 1, 1, 1, 1, 1, 1, 1, 3, 3, 3, 2, 2, 5, 5, 5, 5, 5, 1, 1, 4, 4, 4, 4, 5, 5, 5, 5, 5, 1, 8, 8, 8, 8, 8, 8, 8, 8, 1, 1, 1, 1, 1, 1, 1, 4, 4, 4, 4, 1, 1, 2, 2, 2, 2, 1, 1, 1, 13, 13, 13, 13, 13, 13, 13, 13, 13, 13, 13, 13, 13, 5, 5, 5, 5, 5, 2, 2, 1, 1]","['capturar', 'crech', 'humanar', 'sequer', 'usuario']","[1, 1, 1, 1, 1]",101,5,106,1
10000,"['coordenar', 'distrito', 'dosar', 'esquema', 'fase', 'igualitario', 'instituto', 'necessario', 'operacionalizacao', 'pastar', 'periodo', 'planar', 'publicoalvo', 'remessar', 'saudar']","[1, 1, 1, 1, 1, 1, 1, 1, 1, 1, 1, 1, 1, 1, 1]","[]","[]",15,0,15,1
10001,"['alvorar', 'bolsonarista', 'converso', 'converso', 'converso', 'converso', 'converso', 'jorg', 'recurso', 'supremo']","[1, 1, 5, 5, 5, 5, 5, 1, 1, 1]","[]","[]",10,0,10,1
10002,"['diariament', 'diariament', 'flavio', 'presidir', 'republico', 'republico', 'reuniao', 'reuniao', 'roraima']","[2, 2, 1, 1, 2, 2, 2, 2, 1]","['compartilhar']","[1]",9,1,10,1
10003,"['decorrent', 'espanha', 'espanha', 'infectar', 'infectar', 'instalacao', 'intensivo', 'internar', 'prever', 'privar', 'propagacao', 'regiao', 'saudar', 'saudar', 'taxar']","[1, 2, 2, 2, 2, 1, 1, 1, 1, 1, 1, 1, 2, 2, 1]","[]","[]",15,0,15,1
10004,"['administrativo', 'aplicacao', 'atrasar', 'decisao', 'decisao', 'dosar', 'improbidad', 'integro', 'justicar', 'lewandowski', 'lewandowski', 'ministrar', 'prioritario', 'ricardo', 'supremo']","[1, 1, 1, 2, 2, 1, 1, 1, 1, 2, 2, 1, 1, 1, 1]","[]","[]",15,0,15,1
10005,"['antonio', 'compromisso', 'impactar', 'lancamento', 'mudanca', 'situacao']","[1, 1, 1, 1, 1, 1]","[]","[]",6,0,6,1
10006,"['crise', 'funcao', 'funcao', 'moderno', 'normalment', 'plano', 'quarentenar', 'saudar', 'voo']","[1, 2, 2, 1, 1, 1, 1, 1, 1]","['usuario']","[1]",9,1,10,1
10008,"['henriqu', 'ministrar', 'saudar']","[1, 1, 1]","[]","[]",3,0,3,1
10010,"['bandeirant', 'converso', 'destacar', 'dialogo', 'exministro', 'exministro', 'exprefeito', 'henriqu', 'observar', 'palacio', 'particularment', 'posturar', 'precandidato', 'prioridad', 'saudar', 'tucano']","[1, 1, 1, 1, 2, 2, 1, 1, 1, 1, 1, 1, 1, 1, 1, 1]","[]","[]",16,0,16,1
10012,"['comportamento', 'monetario']","[1, 1]","['manchet']","[1]",2,1,3,1
10016,"['desenvolvimento', 'necessidad', 'possibilidad', 'regiao', 'relaxamento', 'vulneravel']","[1, 1, 1, 1, 1, 1]","[]","[]",6,0,6,1
10017,"['biliao', 'competicao', 'competicao', 'crise', 'decisao', 'decisao', 'enxergar', 'europeu', 'justicar', 'situacao', 'subir', 'tornear']","[1, 2, 2, 1, 2, 2, 1, 1, 1, 1, 1, 1]","['revoltar']","[1]",12,1,13,1
10020,"['domingo', 'regiao', 'regiao', 'reuter', 'reuter']","[1, 2, 2, 2, 2]","[]","[]",5,0,5,1
10024,"['adulto', 'boletim', 'campino', 'decorrencia', 'deteccao', 'metropolitano', 'regiao', 'saudar', 'subir', 'taxar']","[1, 1, 1, 1, 1, 1, 1, 1, 1, 1]","[]","[]",10,0,10,1
10026,"['argumentar', 'conflito', 'destacar', 'destacar', 'henriqu', 'iniciativo', 'ministrar', 'nelson', 'pastar', 'quarentenar', 'saudar', 'teich', 'teich']","[1, 1, 2, 2, 1, 1, 1, 1, 1, 1, 1, 2, 2]","[]","[]",13,0,13,1
10034,"['boletim', 'contabilizar', 'estatistico', 'infectar', 'intensivo', 'internacao']","[1, 1, 1, 1, 1, 1]","[]","[]",6,0,6,1
10035,"['apreensao', 'bolsonarista', 'bolsonarista', 'colaborar', 'congresso', 'escalar', 'expressivo', 'inquerito', 'investigacao', 'levantamento', 'levantamento', 'ministrar', 'monitoramento', 'movimentacao', 'recordar', 'supremo', 'supremo']","[1, 2, 2, 1, 1, 1, 1, 1, 1, 2, 2, 1, 1, 1, 1, 2, 2]","[]","[]",17,0,17,1
10038,"['antonio', 'anvisa', 'calheiro', 'comissao', 'cupula', 'depoimento', 'depoimento', 'exministro', 'exministro', 'henriqu', 'inquerito', 'investigacao', 'investigacao', 'mdbal', 'ministrar', 'nelson', 'pastar', 'pastar', 'queiroga', 'queiroga', 'randolf', 'requerimento', 'reuniao', 'saudar', 'saudar', 'sessao', 'teich', 'wajngarten']","[1, 1, 1, 1, 1, 2, 2, 2, 2, 1, 1, 2, 2, 1, 1, 1, 2, 2, 2, 2, 1, 1, 1, 2, 2, 1, 1, 1]","[]","[]",28,0,28,1
10039,"['destinar', 'gorinchteyn', 'intensivo', 'saudar']","[1, 1, 1, 1]","[]","[]",4,0,4,1
10040,"['anvisa', 'anvisa', 'depoimento', 'instituto', 'risco', 'risco', 'vigilancia']","[2, 2, 1, 1, 2, 2, 1]","[]","[]",7,0,7,1
10041,"['temporada']","[1]","[]","[]",1,0,1,1
10042,"['companhia', 'companhia', 'incerteza', 'situacao', 'viagem']","[2, 2, 1, 1, 1]","[]","[]",5,0,5,1
10046,"['consorcio', 'jn', 'minoria', 'proximo', 'renata', 'renata', 'reuniao', 'situacao', 'situacao', 'tambem', 'tambem']","[1, 1, 1, 1, 2, 2, 1, 2, 2, 2, 2]","['atribui', 'atribui', 'bonner', 'bonner', 'bonner', 'bonner', 'chora', 'telejorn']","[2, 2, 4, 4, 4, 4, 1, 1]",11,8,19,1
10048,"['associacao', 'fundacao', 'internar', 'respiratorio', 'roraima', 'subir']","[1, 1, 1, 1, 1, 1]","['invadir']","[1]",6,1,7,1
10050,"['depoimento', 'depoimento', 'depoimento', 'depoimento', 'estrategia', 'flavio', 'flavio', 'flavio', 'flavio', 'flavio', 'flavio', 'flavio', 'flavio', 'gabinet', 'infancia', 'inquerito', 'interpretar', 'investigacao', 'marinhar', 'marinhar', 'marinhar', 'marinhar', 'marinhar', 'marinhar', 'marinhar', 'marinhar', 'marinhar', 'percepcao', 'preocupacao', 'republicanosrj', 'republico', 'reuniao', 'reuniao', 'reuniao', 'situacao']","[4, 4, 4, 4, 1, 8, 8, 8, 8, 8, 8, 8, 8, 1, 1, 1, 1, 1, 9, 9, 9, 9, 9, 9, 9, 9, 9, 1, 1, 1, 1, 3, 3, 3, 1]","['amigar', 'amigar', 'atirar', 'imagem']","[2, 2, 1, 1]",35,4,39,1
10052,"['internar', 'positivar', 'positivar']","[1, 2, 2]","['imagem', 'imagem']","[2, 2]",3,2,5,1
10053,"['decisao', 'justicar', 'souza']","[1, 1, 1]","['soldar', 'soldar', 'soldar', 'soldar']","[4, 4, 4, 4]",3,4,7,1
10058,"['acompanhamento', 'facilitar', 'imunizacao', 'monitoramento', 'saudar', 'saudar', 'saudar']","[1, 1, 1, 1, 3, 3, 3]","['usuario']","[1]",7,1,8,1
10059,"['competicao', 'crescimento', 'decisao', 'positivar', 'surtir']","[1, 1, 1, 1, 1]","[]","[]",5,0,5,1
10061,"['andrew', 'autoridad', 'epicentro', 'funcionamento', 'infectar', 'internacao', 'monitoramento', 'mudanca', 'prazo', 'previsao', 'quedo', 'reabertura', 'reabrir', 'restritivo', 'saudar', 'suspeito', 'suspenso', 'testagem']","[1, 1, 1, 1, 1, 1, 1, 1, 1, 1, 1, 1, 1, 1, 1, 1, 1, 1]","['cristao']","[1]",18,1,19,1
10062,"['absoluto', 'absoluto', 'painel', 'quedo', 'saudar']","[2, 2, 1, 1, 1]","[]","[]",5,0,5,1
10063,"['avancar', 'avancar', 'congresso', 'conjuntar', 'dificuldad', 'periodo', 'plenario', 'proposto', 'ribeiro', 'tributario', 'tributario', 'tributario']","[2, 2, 1, 1, 1, 1, 1, 1, 1, 3, 3, 3]","[]","[]",12,0,12,1
10064,"['autorizacao', 'contemplar', 'curso', 'curso', 'enfermagem', 'estagio', 'pratico', 'presenca', 'presenciar', 'presenciar', 'sabado', 'treinamento']","[1, 1, 2, 2, 1, 1, 1, 1, 2, 2, 1, 1]","[]","[]",12,0,12,1
10067,"['alerj', 'depoimento', 'esquema', 'exministro', 'flavio', 'flavio', 'flavio', 'investigacao', 'lavagem', 'queiroz', 'rachadinha', 'ramagem', 'sido', 'supremo']","[1, 1, 1, 1, 3, 3, 3, 1, 1, 1, 1, 1, 1, 1]","[]","[]",14,0,14,1
10068,"['armazenamento', 'armazenamento', 'articulacao', 'conformar', 'curvo', 'deteccao', 'estrategico', 'imunizacao', 'infectar', 'medeiro', 'necessario', 'necessario', 'pastar', 'pastar', 'previsao', 'projeco', 'projeco', 'saudar', 'saudar', 'saudar', 'saudar', 'saudar', 'substituto', 'universitario', 'vigilancia', 'vigilancia']","[2, 2, 1, 1, 1, 1, 1, 1, 1, 1, 2, 2, 2, 2, 1, 2, 2, 5, 5, 5, 5, 5, 1, 1, 2, 2]","['sobrar']","[1]",26,1,27,1
10069,"['argumentar', 'comorbidad', 'confederacao', 'justicar', 'necessario', 'risco', 'saudar', 'saudar', 'supremo', 'suspensao', 'vieira', 'vulnerabilidad']","[1, 1, 1, 1, 1, 1, 2, 2, 1, 1, 1, 1]","[]","[]",12,0,12,1
10070,"['compromisso', 'dosar', 'dosar', 'dosar', 'dosar', 'esquema', 'esquema', 'esquema', 'federativo', 'imunizacao', 'operacionalizacao', 'periodo', 'planar', 'prioritario', 'saudar']","[1, 4, 4, 4, 4, 3, 3, 3, 1, 1, 1, 1, 1, 1, 1]","[]","[]",15,0,15,1
10074,"['academiar', 'aglomeracao', 'alerj', 'antonio', 'araujo', 'bruno', 'caxia', 'celso', 'coletivo', 'competicao', 'converso', 'crise', 'domingo', 'economia', 'favorito', 'fluminens', 'fluminens', 'fluminens', 'goncalo', 'habito', 'impactar', 'incerteza', 'isolar', 'jantar', 'jantar', 'jantar', 'jantar', 'jorg', 'machadar', 'mello', 'mergulhar', 'mergulhar', 'mergulhar', 'mergulhar', 'mergulhar', 'mergulhar', 'mergulhar', 'mergulhar', 'normalment', 'normalment', 'parceiro', 'pereira', 'periodo', 'quarentenar', 'quarentenar', 'reabrir', 'renata', 'respostar', 'reuniao', 'reuniao', 'ricardo', 'rotina', 'rotina', 'rotina', 'rotina', 'saudad', 'saudad', 'saudad', 'saudad', 'saudad', 'saudad', 'saudad', 'saudad', 'saudad', 'saudad', 'saudad', 'saudad', 'saudad', 'saudar', 'situacao', 'souza', 'souza', 'superar', 'superar', 'toquio', 'tornear', 'treinar', 'treinar', 'treino', 'universitario', 'wilson', 'witzel']","[1, 1, 1, 1, 1, 1, 1, 1, 1, 1, 1, 1, 1, 1, 1, 3, 3, 3, 1, 1, 1, 1, 1, 4, 4, 4, 4, 1, 1, 1, 8, 8, 8, 8, 8, 8, 8, 8, 2, 2, 1, 1, 1, 2, 2, 1, 1, 1, 2, 2, 1, 4, 4, 4, 4, 13, 13, 13, 13, 13, 13, 13, 13, 13, 13, 13, 13, 13, 1, 1, 2, 2, 2, 2, 1, 1, 2, 2, 1, 1, 1, 1]","['adorar', 'chorar', 'filmar', 'filmar', 'filmar', 'gravacao', 'lazaro', 'pelar', 'realment']","[1, 1, 3, 3, 3, 1, 1, 1, 1]",82,9,91,1
10075,"['aliviar', 'assistencia', 'bbc', 'cenario', 'etapa', 'saudar']","[1, 1, 1, 1, 1, 1]","[]","[]",6,0,6,1
10076,"['amplo', 'colleg', 'crise', 'curvo', 'inglaterra', 'monetario']","[1, 1, 1, 1, 1, 1]","[]","[]",6,0,6,1
10077,"['biliao', 'biliao', 'crise', 'crise', 'despesa', 'despesa', 'despesa', 'economia', 'monitoramento', 'painel', 'painel', 'pastar', 'previsao', 'previsto', 'provisorio', 'saudar', 'tesourar']","[2, 2, 2, 2, 3, 3, 3, 1, 1, 2, 2, 1, 1, 1, 1, 1, 1]","[]","[]",17,0,17,1
10078,"['bolsonarista', 'bolsonarista', 'colunista', 'colunista', 'decisao', 'edson', 'fachin', 'magistrado', 'ministrar', 'pslrj', 'silveiro', 'supremo', 'supremo', 'supremo']","[2, 2, 2, 2, 1, 1, 1, 1, 1, 1, 1, 3, 3, 3]","[]","[]",14,0,14,1
10081,"['apreensao', 'contrato', 'contrato', 'contrato', 'deltan', 'favorito', 'legislativo', 'preventivo', 'republico', 'witzel']","[1, 3, 3, 3, 1, 1, 1, 1, 1, 1]","[]","[]",10,0,10,1
10082,"['airlin', 'amplo', 'biliao', 'biliao', 'companhia', 'companhia', 'crise', 'curvo', 'dinamarca', 'enfermagem', 'expectativa', 'fronteiro', 'funcao', 'impactar', 'intensivo', 'reducao', 'respectivament', 'restritivo', 'ritmar', 'temporariament', 'temporariament', 'trafego', 'treinamento', 'treinar']","[1, 1, 2, 2, 2, 2, 1, 1, 1, 1, 1, 1, 1, 1, 1, 1, 1, 1, 1, 2, 2, 1, 1, 1]","[]","[]",24,0,24,1
10083,"['aglomeracao', 'ausencia', 'periodo', 'turma']","[1, 1, 1, 1]","[]","[]",4,0,4,1
10085,"['condicao', 'crise', 'crise', 'economia', 'economia', 'exministro', 'henriqu', 'privar', 'recuperacao', 'recurso', 'tesourar', 'transmissao']","[1, 2, 2, 2, 2, 1, 1, 1, 1, 1, 1, 1]","[]","[]",12,0,12,1
10086,"['corpu', 'edson', 'exjuiz', 'exjuiz', 'fachin', 'fachin', 'fachin', 'forcatarefa', 'forcatarefa', 'habea', 'julgamento', 'julgamento', 'julgamento', 'processo', 'relacao', 'supremo', 'suspeicao', 'suspeicao', 'turma']","[1, 1, 2, 2, 3, 3, 3, 2, 2, 1, 3, 3, 3, 1, 1, 1, 2, 2, 1]","[]","[]",19,0,19,1
10088,"['aglomeracao', 'associacao', 'compilar', 'coreia', 'deslocamento', 'destacar', 'destinar', 'deteccao', 'dinamarca', 'disseminacao', 'espanha', 'especifico', 'especifico', 'europeu', 'exigencia', 'extraordinario', 'fronteiro', 'fronteiro', 'humanitario', 'itamarati', 'justificativo', 'levantamento', 'mexico', 'passageiro', 'quarentenar', 'regiao', 'regiao', 'regrar', 'regrar', 'republico', 'reuniao', 'sigla', 'situacao', 'situacao', 'situacao', 'tripulacao', 'viagem', 'viagem', 'viagem', 'viagem', 'viagem', 'viajant', 'visitant', 'voo', 'voo', 'voo', 'voo', 'voo']","[1, 1, 1, 1, 1, 1, 1, 1, 1, 1, 1, 2, 2, 1, 1, 1, 2, 2, 1, 1, 1, 1, 1, 1, 1, 2, 2, 2, 2, 1, 1, 1, 3, 3, 3, 1, 5, 5, 5, 5, 5, 1, 1, 5, 5, 5, 5, 5]","['checar', 'verdadeiro']","[1, 1]",48,2,50,1
10090,"['afp', 'autoridad', 'normalment', 'portavoz', 'propagacao', 'reforcar', 'saudar']","[1, 1, 1, 1, 1, 1, 1]","['invadir']","[1]",7,1,8,1
10096,"['comissao', 'cupula', 'milho', 'milho', 'reuniao']","[1, 1, 2, 2, 1]","[]","[]",5,0,5,1
10097,"['associacao', 'associacao', 'atuam', 'ausencia', 'compromisso', 'decisao', 'elaborar', 'intensivo', 'intensivo', 'orientacao', 'saudar', 'saudar', 'saudar', 'triagem']","[2, 2, 1, 1, 1, 1, 1, 2, 2, 1, 3, 3, 3, 1]","[]","[]",14,0,14,1
10099,"['acordo', 'afetado', 'anuncio', 'apostar', 'autorizacao', 'autorizacao', 'avancar', 'colombio', 'colombio', 'colombio', 'colombio', 'comorbidad', 'desenvolvido', 'duqu', 'duqu', 'economia', 'estrategia', 'imunizacao', 'iniciativo', 'mexico', 'parceria', 'relaxar', 'saudar', 'saudar', 'saudar', 'situacao']","[1, 1, 1, 1, 2, 2, 1, 4, 4, 4, 4, 1, 1, 2, 2, 1, 1, 1, 1, 1, 1, 1, 3, 3, 3, 1]","[]","[]",26,0,26,1
10100,"['atuacao', 'cenario', 'distrito', 'estimativo', 'folhar', 'inquerito', 'investigacao', 'molecular', 'molecular', 'republico', 'republico', 'saudar', 'saudar', 'saudar', 'spaulo', 'vencimento', 'vencimento']","[1, 1, 1, 1, 1, 1, 1, 2, 2, 2, 2, 3, 3, 3, 1, 2, 2]","[]","[]",17,0,17,1
10101,"['alcolumbr', 'alcolumbr', 'comissao', 'demap', 'demmg', 'favorito', 'pacheco', 'pacheco', 'palacio', 'planalto', 'republico']","[2, 2, 1, 1, 1, 1, 2, 2, 1, 1, 1]","[]","[]",11,0,11,1
10102,"['atuacao', 'esquema', 'flavio', 'gabinet', 'investigacao', 'julgamento', 'justicar', 'justicar', 'prtb', 'rachadinha', 'republicanosrj', 'segredar', 'segredar']","[1, 1, 1, 1, 1, 1, 2, 2, 1, 1, 1, 2, 2]","['ganhar']","[1]",13,1,14,1
10103,"['adhanom', 'agravar', 'associacao', 'demandar', 'destacar', 'epidemiar', 'escassez', 'fundacao', 'parceiro', 'possibilidad', 'preocupacao', 'saudar', 'situacao', 'suprimento', 'suprimento', 'surtir', 'tedro']","[1, 1, 1, 1, 1, 1, 1, 1, 1, 1, 1, 1, 1, 2, 2, 1, 1]","[]","[]",17,0,17,1
10104,"['argumentar', 'comparacao', 'complicacao', 'discussao', 'espanha', 'estatistico', 'instituto', 'notificar', 'oficialment', 'periodo']","[1, 1, 1, 1, 1, 1, 1, 1, 1, 1]","[]","[]",10,0,10,1
10109,"['adotada', 'aspecto', 'distrito', 'higienizacao', 'instituto', 'saudar', 'substituicao']","[1, 1, 1, 1, 1, 1, 1]","[]","[]",7,0,7,1
10110,"['aprovacao', 'desenvolvido', 'domingo', 'domingo', 'milho', 'parceria', 'preocupacao', 'sendo', 'tambem']","[1, 1, 2, 2, 1, 1, 1, 1, 1]","[]","[]",9,0,9,1
10111,"['autoridad', 'bandeirant', 'comparacao', 'comportamento', 'crescimento', 'desenvolvimento', 'desenvolvimento', 'distant', 'expressivo', 'expressivo', 'metropolitano', 'mudanca', 'palacio', 'preocupacao', 'preocupacao', 'regiao', 'regiao', 'taxar', 'velocidad', 'velocidad']","[1, 1, 1, 1, 1, 2, 2, 1, 2, 2, 1, 1, 1, 2, 2, 2, 2, 1, 2, 2]","['verificar', 'verificar']","[2, 2]",20,2,22,1
10115,"['integro', 'recordar', 'regiao']","[1, 1, 1]","['incendio']","[1]",3,1,4,1
10118,"['atuacao', 'bruto', 'integrant', 'integrant', 'rocha', 'saudar', 'saudar', 'servidor']","[1, 1, 2, 2, 1, 2, 2, 1]","['enganar', 'ganhar', 'sequer']","[1, 1, 1]",8,3,11,1
10122,"['diminuicao', 'diminuicao', 'observar', 'prever', 'quedo']","[2, 2, 1, 1, 1]","[]","[]",5,0,5,1
10123,"['comissao', 'especialment', 'ministrar', 'ministrar', 'primeiroministro', 'reuniao', 'reuniao', 'saudar', 'vespera']","[1, 1, 2, 2, 1, 2, 2, 1, 1]","[]","[]",9,0,9,1
10128,"['apostar', 'biliao', 'condicao', 'consorcio', 'desenvolvimento', 'destinar', 'instituto', 'insuficient', 'opcao', 'testagem']","[1, 1, 1, 1, 1, 1, 1, 1, 1, 1]","[]","[]",10,0,10,1
10129,"['argumentar', 'celso', 'celso', 'delacao', 'empatar', 'gripezinha', 'minimizar', 'saudar', 'subir', 'tatto']","[1, 2, 2, 1, 1, 1, 1, 1, 1, 1]","['ganhar', 'imagem']","[1, 1]",10,2,12,1
10130,"['adicionar', 'adotada', 'crescimento', 'desenvolvido', 'desenvolvimento', 'economia', 'economia', 'economia', 'economia', 'economia', 'estrategia', 'estrategico', 'exemplo', 'exministro', 'expectativa', 'impacto', 'infraestrutura', 'infraestrutura', 'medida', 'milho', 'mudanca', 'mudanca', 'pib', 'pib', 'proprio', 'recuperacao', 'recurso', 'recurso', 'relacao', 'ufrj']","[1, 1, 1, 1, 1, 5, 5, 5, 5, 5, 1, 1, 1, 1, 1, 1, 2, 2, 1, 1, 2, 2, 2, 2, 1, 1, 2, 2, 1, 1]","[]","[]",30,0,30,1
10135,"['algun', 'medida', 'necessario', 'opcao', 'plano', 'treino']","[1, 1, 1, 1, 1, 1]","[]","[]",6,0,6,1
10137,"['assistencia', 'biliao', 'capitar', 'capitar', 'decorrent', 'destinar', 'enfrentamento', 'especializar', 'estrategia', 'insuficient', 'jurista', 'logistico', 'prever', 'primario', 'recurso', 'recurso', 'recurso', 'recurso', 'saudar', 'saudar', 'saudar', 'saudar', 'suprimento', 'tcu', 'tcu', 'vigilancia']","[1, 1, 2, 2, 1, 1, 1, 1, 1, 1, 1, 1, 1, 1, 4, 4, 4, 4, 4, 4, 4, 4, 1, 2, 2, 1]","[]","[]",26,0,26,1
10139,"['depoimento', 'domingo', 'especialment', 'instituto', 'randolf']","[1, 1, 1, 1, 1]","['circular']","[1]",5,1,6,1
10140,"['estatistico', 'geografia', 'ibg', 'instituto', 'levantamento', 'respectivament', 'respectivament', 'saudar', 'saudar', 'saudar']","[1, 1, 1, 1, 1, 2, 2, 3, 3, 3]","[]","[]",10,0,10,1
10143,"['ambientar', 'ambientar', 'integro', 'ministrar', 'ministrar', 'pastar', 'ricardo', 'sall', 'sall', 'sall']","[2, 2, 1, 2, 2, 1, 1, 3, 3, 3]","['replicar']","[1]",10,1,11,1
10144,"['boletim', 'caxia', 'caxia', 'domingo', 'duqu', 'duqu', 'federar', 'goncalo', 'infectar', 'liderar', 'redondo', 'saudar', 'saudar', 'saudar', 'taxar', 'totalizar']","[1, 2, 2, 1, 2, 2, 1, 1, 1, 1, 1, 3, 3, 3, 1, 1]","[]","[]",16,0,16,1
10147,"['anticorpo', 'aplicacao', 'estrategia', 'moderno', 'moderno', 'moderno', 'preliminar', 'reforcar', 'reforcar', 'reforcar', 'reforcar', 'respostar']","[1, 1, 1, 3, 3, 3, 1, 4, 4, 4, 4, 1]","[]","[]",12,0,12,1
10149,"['afp', 'associacao', 'habitant', 'pfizerbiontech', 'primeiroministro', 'provincia', 'provincia', 'serao']","[1, 1, 1, 1, 1, 2, 2, 1]","['canadens']","[1]",8,1,9,1
10150,"['disseminacao', 'implementacao', 'medida', 'necessidad', 'panamericana', 'recuperacao', 'reforcar', 'videoconferencia']","[1, 1, 1, 1, 1, 1, 1, 1]","[]","[]",8,0,8,1
10153,"['desenvolvimento', 'institut', 'liderar']","[1, 1, 1]","['implantar']","[1]",3,1,4,1
10154,"['acompanhamento', 'saudar']","[1, 1]","[]","[]",2,0,2,1
10155,"['decisao', 'funcionamento', 'implementar', 'presenciar', 'propagacao']","[1, 1, 1, 1, 1]","['circular']","[1]",5,1,6,1
10157,"['alvorar', 'alvorar', 'negativar', 'normalidad', 'palacio', 'palacio', 'respiratorio', 'videoconferencia']","[2, 2, 1, 1, 2, 2, 1, 1]","[]","[]",8,0,8,1
10158,"['articulacao', 'condenacao', 'corpu', 'facilitar', 'fundacao', 'habea', 'supremo', 'varga']","[1, 1, 1, 1, 1, 1, 1, 1]","['cedula']","[1]",8,1,9,1
10159,"[]","[]","['ganhar', 'ganhar']","[2, 2]",0,2,2,1
10161,"['comissao', 'equipamento', 'externo', 'orcamentaria', 'orcamentaria', 'recurso', 'recurso', 'recurso', 'recurso', 'recurso', 'recurso', 'recurso', 'respostar', 'respostar', 'respostar']","[1, 1, 1, 2, 2, 7, 7, 7, 7, 7, 7, 7, 3, 3, 3]","['incendio']","[1]",15,1,16,1
10164,"['destacar', 'enfrentamento', 'mudanca', 'mudanca', 'republico', 'resistencia']","[1, 1, 2, 2, 1, 1]","[]","[]",6,0,6,1
10167,"['academiar', 'adotada', 'associacao', 'colleg', 'consequencia', 'consequencia', 'desigualdad', 'desmatamento', 'destacar', 'destacar', 'destacar', 'equipamento', 'henriqu', 'implementacao', 'infectar', 'infectar', 'justicar', 'respirador', 'respostar', 'respostar', 'respostar', 'saudar', 'saudar', 'saudar', 'saudar', 'saudar', 'surtir', 'taxar', 'taxar', 'taxar', 'taxar', 'transmissao', 'transmissao']","[1, 1, 1, 1, 2, 2, 1, 1, 3, 3, 3, 1, 1, 1, 2, 2, 1, 1, 3, 3, 3, 5, 5, 5, 5, 5, 1, 4, 4, 4, 4, 2, 2]","['intitular']","[1]",33,1,34,1
10170,"['economia', 'situacao']","[1, 1]","[]","[]",2,0,2,1
10173,"['comparacao', 'desempenhar', 'destacar', 'economia', 'economia', 'ibg', 'quedo', 'recuperacao', 'recuperacao', 'reuter', 'trimestr', 'volumar']","[1, 1, 1, 2, 2, 1, 1, 2, 2, 1, 1, 1]","[]","[]",12,0,12,1
10174,"['assistencia', 'dificuldad', 'epidemiar', 'epidemiar', 'exigencia', 'gabbardo', 'gabbardo', 'gabbardo', 'henriqu', 'ministrar', 'pastar', 'recurso', 'regiao', 'saudar', 'secretarioexecutivo', 'surtir', 'taxar']","[1, 1, 2, 2, 1, 3, 3, 3, 1, 1, 1, 1, 1, 1, 1, 1, 1]","[]","[]",17,0,17,1
10177,"['ambientar', 'assintomatico', 'autonomia', 'conformar', 'decisao', 'epidemiar', 'esforco', 'especifico', 'necessario', 'orientacao', 'regulamentar', 'restritivo', 'saudar', 'saudar', 'supremo']","[1, 1, 1, 1, 1, 1, 1, 1, 1, 1, 1, 1, 2, 2, 1]","['espalhar', 'versao']","[1, 1]",15,2,17,1
10179,"['impactar', 'infectar', 'instituto', 'quadro', 'saudar', 'saudar']","[1, 1, 1, 1, 2, 2]","[]","[]",6,0,6,1
10182,"['augusto', 'augusto', 'federar', 'flavio', 'gabinet', 'heleno', 'heleno', 'integro', 'investigacao', 'irregularidad', 'ministrar', 'ramagem', 'republicanosrj', 'reuniao', 'reuniao']","[2, 2, 1, 1, 1, 2, 2, 1, 1, 1, 1, 1, 1, 2, 2]","[]","[]",15,0,15,1
10183,"['compromisso', 'inglaterra', 'saudar']","[1, 1, 1]","[]","[]",3,0,3,1
10184,"['disseminacao', 'esforco', 'estrategia', 'estrategia', 'importancia', 'orientacao', 'parceria', 'preliminar', 'publicoalvo', 'publicoalvo', 'rotina', 'sarampo', 'sarampo', 'sarampo', 'sarampo', 'sarampo', 'saudar', 'saudar', 'saudar', 'transmissao']","[1, 1, 2, 2, 1, 1, 1, 1, 2, 2, 1, 5, 5, 5, 5, 5, 3, 3, 3, 1]","[]","[]",20,0,20,1
10185,"['aplicacao', 'bolsonarista', 'celso', 'decisao', 'descumprimento', 'estrategia', 'folhar', 'gabinet', 'justicar', 'oswaldo', 'oswaldo', 'prever', 'republico']","[1, 1, 1, 1, 1, 1, 1, 1, 1, 2, 2, 1, 1]","[]","[]",13,0,13,1
10191,"['afetado', 'associacao', 'biliao', 'consequencia', 'crise', 'decisao', 'destinar', 'exportacao', 'pagamento', 'suspenso']","[1, 1, 1, 1, 1, 1, 1, 1, 1, 1]","[]","[]",10,0,10,1
10193,"['aplicacao', 'comparacao', 'dosar', 'infeccioso', 'intervalar', 'intervalar', 'merkel', 'moderno']","[1, 1, 1, 1, 2, 2, 1, 1]","[]","[]",8,0,8,1
10194,"['domingo', 'perspectivo', 'planar', 'saudar', 'suspenso']","[1, 1, 1, 1, 1]","[]","[]",5,0,5,1
10196,"['afetado', 'afp', 'milho', 'oficialment', 'porqu', 'sendo']","[1, 1, 1, 1, 1, 1]","[]","[]",6,0,6,1
10199,"['compilar', 'decorrencia', 'intervalar', 'levantamento', 'mexico', 'oficialment', 'periodo', 'recebido', 'saudar', 'subir', 'taxar']","[1, 1, 1, 1, 1, 1, 1, 1, 1, 1, 1]","[]","[]",11,0,11,1
10202,"['aglomeracao', 'aglomeracao', 'antecipar', 'disseminacao', 'feriar', 'periodo', 'sabado']","[2, 2, 1, 1, 1, 1, 1]","['sacar']","[1]",7,1,8,1
10203,"['afetado', 'autoridad', 'desenvolvido', 'dosar', 'fase', 'instituto', 'preliminar', 'prever', 'sudest', 'transferencia']","[1, 1, 1, 1, 1, 1, 1, 1, 1, 1]","[]","[]",10,0,10,1
10204,"['anvisa', 'aprovacao', 'avancar', 'calculo', 'calculo', 'calculo', 'capitar', 'consecutivo', 'consorcio', 'consorcio', 'consorcio', 'contabilizar', 'converso', 'converso', 'diariament', 'dosar', 'dosar', 'enxergar', 'equivalent', 'escassez', 'estabilidad', 'estatistico', 'folhar', 'inconsistencia', 'infectar', 'iniciativo', 'notificar', 'paralelo', 'plantao', 'quedo', 'recordar', 'recurso', 'rejeitar', 'restritivo', 'saudar', 'saudar', 'saudar', 'spaulo', 'tendencia', 'tendencia', 'totalizar', 'vigilancia']","[1, 1, 1, 3, 3, 3, 1, 1, 3, 3, 3, 1, 2, 2, 1, 2, 2, 1, 1, 1, 1, 1, 1, 1, 1, 1, 1, 1, 1, 1, 1, 1, 1, 1, 3, 3, 3, 1, 2, 2, 1, 1]","['narrativo']","[1]",42,1,43,1
10205,"['atuacao', 'calheiro', 'calheiro', 'comissao', 'conjuntar', 'enfrentamento', 'mdbal', 'permanencia', 'randolf', 'recurso', 'requerimento', 'sugestao']","[1, 2, 2, 1, 1, 1, 1, 1, 1, 1, 1, 1]","[]","[]",12,0,12,1
10206,"['biliao', 'iniciativo', 'ministrar', 'ministrar', 'pagamento', 'reuniao', 'saudar', 'suspensao']","[1, 1, 2, 2, 1, 1, 1, 1]","[]","[]",8,0,8,1
10207,"['client', 'depoimento', 'estagio', 'orientacao', 'parceria', 'quarentenar']","[1, 1, 1, 1, 1, 1]","['imagem']","[1]",6,1,7,1
10210,"['contagioso', 'converso', 'desenvolvido', 'especialment', 'fabricacao', 'intenso', 'reforcar']","[1, 1, 1, 1, 1, 1, 1]","['amplament', 'disseminar', 'versao']","[1, 1, 1]",7,3,10,1
10212,"['assintomatico', 'assintomatico', 'balancar', 'oficialment', 'saudar', 'submetido']","[2, 2, 1, 1, 1, 1]","[]","[]",6,0,6,1
10213,"['fabricacao', 'fundacao', 'oswaldo', 'remessar', 'sabado', 'saudar']","[1, 1, 1, 1, 1, 1]","[]","[]",6,0,6,1
10217,"['ambientar', 'armazenamento', 'autoridad', 'infectar', 'internar', 'periodo', 'periodo', 'positivar', 'quarentenar', 'saudar', 'surtir', 'suspeito', 'suspeito', 'viagem']","[1, 1, 1, 1, 1, 2, 2, 1, 1, 1, 1, 2, 2, 1]","[]","[]",14,0,14,1
10218,"['alcolumbr', 'aprovacao', 'atrair', 'autonomia', 'cenario', 'consequencia', 'constituicao', 'crise', 'demap', 'demrj', 'economia', 'economia', 'economia', 'emendar', 'gued', 'gued', 'gued', 'integro', 'ministrar', 'necessidad', 'oficio', 'oficio', 'prioritario', 'privatizacao', 'proposto', 'proposto', 'proposto', 'proposto', 'provisorio', 'provisorio', 'saneamento', 'tramitacao']","[1, 1, 1, 1, 1, 1, 1, 1, 1, 1, 3, 3, 3, 1, 3, 3, 3, 1, 1, 1, 2, 2, 1, 1, 4, 4, 4, 4, 2, 2, 1, 1]","[]","[]",32,0,32,1
10219,"['equipamento', 'saudar']","[1, 1]","['atribuir', 'circular', 'verdadeiro']","[1, 1, 1]",2,3,5,1
10220,"['propagacao', 'proximo', 'rastreamento', 'rastreamento']","[1, 1, 2, 2]","[]","[]",4,0,4,1
10222,"['acompanhamento', 'balancar', 'saudar', 'saudar']","[1, 1, 2, 2]","[]","[]",4,0,4,1
10223,"['amplo', 'aspecto', 'colunista', 'consequencia', 'contencao', 'converso', 'desafio', 'especializar', 'exigencia', 'inedito', 'internacao', 'perspectivo', 'propagacao', 'saudar', 'saudar', 'transmissao', 'videoconferencia']","[1, 1, 1, 1, 1, 1, 1, 1, 1, 1, 1, 1, 1, 2, 2, 1, 1]","[]","[]",17,0,17,1
10224,"['acordo', 'anuncio', 'anvisa', 'desenvolvido', 'distrito', 'fornecimento', 'instituto', 'parceria', 'prever', 'saudar', 'sputnik', 'vigilancia']","[1, 1, 1, 1, 1, 1, 1, 1, 1, 1, 1, 1]","[]","[]",12,0,12,1
10228,"['adicionar', 'biliao', 'biliao', 'destinar', 'destinar', 'economia', 'pratico', 'prever', 'provisorio', 'regrar', 'tesourar', 'tesourar']","[1, 2, 2, 2, 2, 1, 1, 1, 1, 1, 2, 2]","[]","[]",12,0,12,1
10230,"['complicacao', 'consecutivo', 'consorcio', 'obtido', 'quedo', 'regiao', 'regiao', 'saudar', 'sudest', 'tendencia', 'variacao']","[1, 1, 1, 1, 1, 2, 2, 1, 1, 1, 1]","[]","[]",11,0,11,1
10231,"['absoluto', 'atuacao', 'coletivo', 'etapa', 'henriqu', 'jorg', 'jorg', 'michael', 'michael', 'movimentacao', 'mudanca', 'ribeiro', 'ribeiro', 'ritmar', 'rocha', 'rocha', 'treinar']","[1, 1, 1, 1, 1, 2, 2, 2, 2, 1, 1, 2, 2, 1, 2, 2, 1]","['camisa', 'invadir', 'soltar']","[1, 1, 1]",17,3,20,1
10232,"['afetado', 'agravamento', 'avancar', 'avancar', 'avancar', 'circulacao', 'epidemiar', 'epidemiologico', 'imunizacao', 'recordar', 'recuar', 'reuter', 'ritmar', 'situacao', 'surtir']","[1, 1, 3, 3, 3, 1, 1, 1, 1, 1, 1, 1, 1, 1, 1]","[]","[]",15,0,15,1
10233,"['carat', 'colegio', 'conformar', 'decisao', 'fase', 'justicar', 'justicar', 'planar', 'planar', 'reabrir', 'recurso', 'regiao', 'sindicato', 'sindicato', 'sindicato']","[1, 1, 1, 1, 1, 2, 2, 2, 2, 1, 1, 1, 3, 3, 3]","[]","[]",15,0,15,1
10235,"['assistencia', 'distrito', 'distrito', 'esforco', 'milho', 'milho', 'parcela', 'recurso', 'recurso', 'serao']","[1, 2, 2, 1, 2, 2, 1, 2, 2, 1]","[]","[]",10,0,10,1
10240,"['anvisa', 'desenvolvido', 'mudanca', 'mudanca', 'pastar', 'pastar', 'prever', 'prever', 'previsao', 'saudar', 'sputnik', 'vigilancia']","[1, 1, 2, 2, 2, 2, 2, 2, 1, 1, 1, 1]","[]","[]",12,0,12,1
10241,"['demandar', 'insuficient', 'integro', 'intubacao', 'intubacao', 'saudar']","[1, 1, 1, 2, 2, 1]","[]","[]",6,0,6,1
10243,"['companhia', 'companhia', 'congresso', 'dificuldad', 'infectar', 'metropolitano', 'mudanca', 'possibilidad', 'regiao', 'regiao', 'respiratorio', 'saneamento', 'temporario']","[2, 2, 1, 1, 1, 1, 1, 1, 2, 2, 1, 1, 1]","[]","[]",13,0,13,1
10244,"['bbc', 'bbc', 'cenario', 'cenario', 'comparacao', 'crescimento', 'habitant', 'habitant', 'habitant', 'habitant', 'pib', 'pib', 'pib', 'previsao', 'previsao', 'situacao', 'situacao', 'taxar', 'taxar', 'taxar', 'taxar', 'taxar', 'taxar', 'taxar', 'taxar', 'transmissao']","[2, 2, 2, 2, 1, 1, 4, 4, 4, 4, 3, 3, 3, 2, 2, 2, 2, 8, 8, 8, 8, 8, 8, 8, 8, 1]","[]","[]",26,0,26,1
10245,"['anticorpo', 'circulacao', 'conformar', 'infectar', 'michael', 'necessario', 'normalment', 'reforcar', 'sarampo', 'saudar', 'saudar', 'taxar', 'taxar']","[1, 1, 1, 1, 1, 1, 1, 1, 1, 2, 2, 2, 2]","['circular', 'parir']","[1, 1]",13,2,15,1
10246,"['aumento', 'cenario', 'distrito', 'patamar', 'piora', 'relacao']","[1, 1, 1, 1, 1, 1]","[]","[]",6,0,6,1
10247,"['adulto', 'expectativa', 'hospitalizar', 'hospitalizar', 'hospitalizar', 'hospitalizar', 'hospitalizar', 'instituto', 'prescricao', 'prescricao']","[1, 1, 5, 5, 5, 5, 5, 1, 2, 2]","[]","[]",10,0,10,1
10248,"['levantamento', 'recordar', 'recordar', 'recordar', 'superar']","[1, 3, 3, 3, 1]","['sequer']","[1]",5,1,6,1
10249,"['adicionar', 'balancar', 'consorcio', 'consorcio', 'contabilizar', 'decorrencia', 'inclusao', 'infectar', 'infectar', 'levantamento', 'periodo', 'periodo', 'recordar', 'recordar', 'saudar']","[1, 1, 2, 2, 1, 1, 1, 2, 2, 1, 2, 2, 2, 2, 1]","[]","[]",15,0,15,1
10252,"['autoridad', 'impactar', 'panamericana', 'recordar', 'risco', 'saudar', 'saudar', 'saudar', 'situacao', 'situacao']","[1, 1, 1, 1, 1, 3, 3, 3, 2, 2]","[]","[]",10,0,10,1
10253,"['economia', 'economia', 'equilibrio', 'equilibrio', 'gued', 'ministrar', 'recuar', 'recuar', 'republico', 'temporario']","[2, 2, 2, 2, 1, 1, 2, 2, 1, 1]","[]","[]",10,0,10,1
10254,"['alerj', 'esquema', 'esquema', 'fabricio', 'flavio', 'flavio', 'gabinet', 'integro', 'investigacao', 'justicar', 'lavagem', 'legislativo', 'oferecido', 'parcelar', 'queiroz', 'rachadinha', 'republicanosrj']","[1, 2, 2, 1, 2, 2, 1, 1, 1, 1, 1, 1, 1, 1, 1, 1, 1]","[]","[]",17,0,17,1
10255,"['crise', 'fluminens', 'porqu', 'porqu']","[1, 1, 2, 2]","[]","[]",4,0,4,1
10256,"['diariament', 'infectar', 'infectar', 'infectar', 'minoria']","[1, 3, 3, 3, 1]","['replicar']","[1]",5,1,6,1
10258,"['propagacao', 'reducao', 'ritmar', 'ritmar']","[1, 1, 2, 2]","['versao', 'versao']","[2, 2]",4,2,6,1
10259,"['contabilizar', 'contabilizar', 'regiao', 'saudar']","[2, 2, 1, 1]","[]","[]",4,0,4,1
10260,"['condicao', 'condicao', 'conflito', 'deslocamento', 'deslocamento', 'especialment', 'internar', 'observar', 'recordar', 'respectivament', 'sigla', 'sobretudo', 'totalizar']","[2, 2, 1, 2, 2, 1, 1, 1, 1, 1, 1, 1, 1]","['expulsar', 'incendio']","[1, 1]",13,2,15,1
10262,"['europeu', 'fronteiro', 'fronteiro', 'previsao', 'previsao', 'quedo', 'reabertura', 'turista']","[1, 2, 2, 2, 2, 1, 1, 1]","[]","[]",8,0,8,1
10265,"['boletim', 'contabilizar', 'dengu', 'dengu', 'epidemiologico', 'infeccioso', 'saudar', 'saudar', 'suspeito']","[1, 1, 2, 2, 1, 1, 2, 2, 1]","[]","[]",9,0,9,1
10266,"['balancar', 'consorcio', 'superar', 'variacao', 'variacao']","[1, 1, 1, 2, 2]","[]","[]",5,0,5,1
10267,"['avancar', 'crescimento', 'despesa', 'esforco', 'milho', 'particularment', 'periodo', 'tendencia', 'trimestr', 'trimestr']","[1, 1, 1, 1, 1, 1, 1, 1, 2, 2]","['carrefour', 'carrefour', 'carrefour', 'carrefour']","[4, 4, 4, 4]",10,4,14,1
10270,"['adulto', 'especializar', 'fase', 'institut', 'respostar']","[1, 1, 1, 1, 1]","[]","[]",5,0,5,1
10271,"['compromisso', 'condenacao', 'decisao', 'edson', 'fachin', 'ministrar', 'privatizacao', 'subir', 'subir', 'supremo']","[1, 1, 1, 1, 1, 1, 1, 2, 2, 1]","['atribuir']","[1]",10,1,11,1
10272,"['circulacao', 'crise', 'primeiroministro', 'saudar']","[1, 1, 1, 1]","['circular']","[1]",4,1,5,1
10274,"['adversario', 'antonio', 'anvisa', 'anvisa', 'anvisa', 'anvisa', 'anvisa', 'anvisa', 'aprovacao', 'autoridad', 'desenvolvimento', 'estagio', 'estrategia', 'imunizacao', 'independentement', 'instituto', 'instituto', 'journal', 'materiaprima', 'parceria', 'piorar', 'preconceito', 'reuter', 'saudar', 'sputnik', 'sputnik', 'surto', 'taxar', 'taxar']","[1, 1, 6, 6, 6, 6, 6, 6, 1, 1, 1, 1, 1, 1, 1, 2, 2, 1, 1, 1, 1, 1, 1, 1, 2, 2, 1, 2, 2]","[]","[]",29,0,29,1
10284,"['congresso', 'decisao', 'desenvolvimento', 'funcao', 'fundeb']","[1, 1, 1, 1, 1]","[]","[]",5,0,5,1
10285,"['cenario', 'crise', 'economia', 'europeu', 'europeu', 'levantamento', 'observar', 'quedo', 'quedo', 'reabertura', 'reabrir', 'respectivament', 'restritivo', 'viagem', 'viajant']","[1, 1, 1, 2, 2, 1, 1, 2, 2, 1, 1, 1, 1, 1, 1]","[]","[]",15,0,15,1
10286,"['boletim', 'etapa', 'periodo', 'periodo', 'ricardo', 'sessao']","[1, 1, 2, 2, 1, 1]","[]","[]",6,0,6,1
10292,"['anvisa', 'aprovacao', 'exministro', 'expressar', 'henriqu', 'ministrar', 'ministrar', 'pastar', 'saudar', 'vigilancia']","[1, 1, 1, 1, 1, 2, 2, 1, 1, 1]","[]","[]",10,0,10,1
10293,"['folhar', 'integro', 'transferir']","[1, 1, 1]","['incendio']","[1]",3,1,4,1
10295,"['almeida', 'anvisa', 'comissao', 'crise', 'enfrentamento', 'instituto', 'instituto', 'pedido', 'requerimento', 'sendo', 'suspensao', 'suspensao', 'suspensao', 'tambem', 'tucano', 'vigilancia']","[1, 1, 1, 1, 1, 2, 2, 1, 1, 1, 3, 3, 3, 1, 1, 1]","['plam']","[1]",16,1,17,1
10301,"['anuncio', 'funcao', 'modelo', 'necessidad', 'opcao', 'opcao', 'painel', 'painel', 'painel', 'painel', 'parceria', 'rastreamento', 'recurso', 'transmissao']","[1, 1, 1, 1, 2, 2, 4, 4, 4, 4, 1, 1, 1, 1]","['selecionar', 'usuario']","[1, 1]",14,2,16,1
10304,"['epidemiar', 'instituto', 'possibilidad', 'respiratorio', 'respiratorio']","[1, 1, 1, 2, 2]","['humanar', 'interaco']","[1, 1]",5,2,7,1
10306,"['queiroga', 'queiroga', 'recebido', 'reuniao', 'tambem']","[2, 2, 1, 1, 1]","['cartaz']","[1]",5,1,6,1
10309,"['alvorar', 'contrato', 'contrato', 'infraestrutura', 'ministrar', 'negativar', 'palacio']","[1, 2, 2, 1, 1, 1, 1]","[]","[]",7,0,7,1
10310,"['alcolumbr', 'decisao', 'demap', 'demrj', 'domingo', 'emendar', 'legislativo', 'supremo']","[1, 1, 1, 1, 1, 1, 1, 1]","[]","[]",8,0,8,1
10311,"['necessario', 'regiao']","[1, 1]","['atribuir', 'incendio', 'manobrar']","[1, 1, 1]",2,3,5,1
10313,"['constituicao']","[1]","[]","[]",1,0,1,1
10317,"['alteracao', 'alteracao', 'armazenamento', 'armazenamento', 'imunizacao', 'imunizacao', 'imunizacao', 'mantido', 'notificar', 'planalto', 'saudar', 'saudar', 'saudar', 'saudar', 'sudest']","[2, 2, 2, 2, 3, 3, 3, 1, 1, 1, 4, 4, 4, 4, 1]","[]","[]",15,0,15,1
10318,"['autoridad', 'domingo', 'importancia', 'investigacao', 'mexico', 'notificar', 'saudar']","[1, 1, 1, 1, 1, 1, 1]","[]","[]",7,0,7,1
10319,"['acordo', 'calheiro', 'calheiro', 'conduta', 'conselho', 'deltan', 'deltan', 'deltan', 'deltan', 'destinar', 'forcatarefa', 'fundacao', 'julgamento', 'mdbal', 'porqu', 'processo', 'processo', 'proprio', 'relacao', 'sessao', 'sociai', 'supremo', 'supremo', 'supremo']","[1, 2, 2, 1, 1, 4, 4, 4, 4, 1, 1, 1, 1, 1, 1, 2, 2, 1, 1, 1, 1, 3, 3, 3]","[]","[]",24,0,24,1
10321,"['companhia', 'companhia', 'companhia', 'lancamento', 'significativo']","[3, 3, 3, 1, 1]","[]","[]",5,0,5,1
10322,"['augusto', 'espirito', 'inquerito', 'investigacao', 'investigacao', 'pratico', 'preliminar', 'queixar', 'republico', 'republico', 'supremo']","[1, 1, 1, 2, 2, 1, 1, 1, 2, 2, 1]","['abortar', 'estuprar', 'menino']","[1, 1, 1]",11,3,14,1
10323,"['afetado', 'consequencia', 'decisao', 'destinar', 'fronteiro', 'necessario', 'situacao', 'sudest', 'turista', 'turista', 'turista', 'turistico']","[1, 1, 1, 1, 1, 1, 1, 1, 3, 3, 3, 1]","['amigar', 'sortir']","[1, 1]",12,2,14,1
10326,"['absoluto', 'anuncio', 'arthur', 'compromisso', 'congresso', 'congresso', 'demmg', 'economia', 'gued', 'lira', 'ministrar', 'pacheco', 'ppal', 'pratico', 'prioridad']","[1, 1, 1, 1, 2, 2, 1, 1, 1, 1, 1, 1, 1, 1, 1]","[]","[]",15,0,15,1
10327,"['crise', 'crise', 'globonew', 'instituto', 'pratico', 'recuperacao']","[2, 2, 1, 1, 1, 1]","[]","[]",6,0,6,1
10330,"['argumentar', 'destacar', 'henri', 'insuficient', 'periodo']","[1, 1, 1, 1, 1]","['verdadeiro', 'verificar', 'wagner']","[1, 1, 1]",5,3,8,1
10331,"[]","[]","[]","[]",0,0,0,1
10332,"['agravar', 'cometido', 'constituicao', 'excecao', 'inquerito', 'justicar', 'oficio', 'portavoz', 'privar']","[1, 1, 1, 1, 1, 1, 1, 1, 1]","[]","[]",9,0,9,1
10333,"['apreensao', 'apurar', 'contrato', 'deflagrar', 'desvio', 'distrito', 'infraestrutura', 'justicar', 'periodo', 'temporario']","[1, 1, 1, 1, 1, 1, 1, 1, 1, 1]","[]","[]",10,0,10,1
10336,"['cupula', 'cupula', 'cupula', 'medida', 'reuniao', 'reuniao', 'reuniao', 'tambem', 'ultimo', 'videoconferencia', 'videoconferencia']","[3, 3, 3, 1, 3, 3, 3, 1, 1, 2, 2]","[]","[]",11,0,11,1
10339,"['autoridad', 'circulacao', 'dedicar', 'destinar', 'europeu', 'facilitar', 'facilitar', 'lancamento', 'regrar', 'saudar', 'viagem']","[1, 1, 1, 1, 1, 2, 2, 1, 1, 1, 1]","[]","[]",11,0,11,1
10340,"['adiamento', 'agravamento', 'capitar', 'distant', 'feriar', 'intenso', 'oficialment', 'previsto', 'situacao', 'suspensao', 'suspenso']","[1, 1, 1, 1, 1, 1, 1, 1, 1, 1, 1]","[]","[]",11,0,11,1
10341,"['alternativo', 'arthur', 'boletim', 'boletim', 'boletim', 'calculo', 'consorcio', 'crise', 'decisao', 'destacar', 'diariament', 'dosar', 'dosar', 'emergenciai', 'enfrentamento', 'enxergar', 'equivalent', 'escassez', 'estabilidad', 'estatistico', 'folhar', 'funcionamento', 'iniciativo', 'internacao', 'levantamento', 'levantamento', 'lira', 'lira', 'lira', 'notificar', 'observar', 'periodo', 'plantao', 'ppal', 'quedo', 'recordar', 'recordar', 'recurso', 'reuniao', 'roraima', 'sabado', 'sabado', 'sabado', 'saudar', 'saudar', 'spaulo', 'sugestao', 'sugestao', 'taxar', 'tendencia', 'tendencia', 'tramitar', 'vigilancia']","[1, 1, 3, 3, 3, 1, 1, 1, 1, 1, 1, 2, 2, 1, 1, 1, 1, 1, 1, 1, 1, 1, 1, 1, 2, 2, 3, 3, 3, 1, 1, 1, 1, 1, 1, 2, 2, 1, 1, 1, 3, 3, 3, 2, 2, 1, 2, 2, 1, 2, 2, 1, 1]","[]","[]",53,0,53,1
10342,"['araujo', 'araujo', 'arthur', 'ministrar', 'positivar', 'respectivament', 'tucano']","[2, 2, 1, 1, 1, 1, 1]","[]","[]",7,0,7,1
10344,"['alergia', 'autoridad', 'boletim', 'observacao', 'pfizerbiontech', 'sendo', 'ultimo']","[1, 1, 1, 1, 1, 1, 1]","[]","[]",7,0,7,1
10347,"['augusto', 'colunista', 'posturar', 'republico', 'republico', 'sabado']","[1, 1, 1, 2, 2, 1]","[]","[]",6,0,6,1
10348,"['equipamento', 'fluminens', 'fluminens', 'necessidad', 'prever', 'regulamentar', 'transmissao', 'treinamento', 'treinamento']","[1, 2, 2, 1, 1, 1, 1, 2, 2]","[]","[]",9,0,9,1
10350,"['acumular', 'afetado', 'arrecadacao', 'arrecadacao', 'arrecadacao', 'biliao', 'biliao', 'biliao', 'concedido', 'desempenhar', 'desempenhar', 'expectativa', 'periodo', 'periodo', 'quedo', 'recuar', 'reuter']","[1, 1, 3, 3, 3, 3, 3, 3, 1, 2, 2, 1, 2, 2, 1, 1, 1]","[]","[]",17,0,17,1
10353,"['constatar', 'diminuicao', 'facilitar', 'levantamento', 'necessario', 'prescricao', 'prever', 'saudar', 'saudar', 'sigla', 'taxar']","[1, 1, 1, 1, 1, 1, 1, 2, 2, 1, 1]","['verificar']","[1]",11,1,12,1
10355,"['adiamento', 'calamidad', 'congresso', 'constituicao', 'crise', 'diariament', 'excecao', 'infectar', 'reducao', 'suspensao', 'suspensao', 'temporario']","[1, 1, 1, 1, 1, 1, 1, 1, 1, 2, 2, 1]","[]","[]",12,0,12,1
10356,"['alvaro', 'equipamento', 'especifico', 'mudanca', 'suportar']","[1, 1, 1, 1, 1]","[]","[]",5,0,5,1
10358,"['ambito', 'ambito', 'colaborar', 'diagnosticar', 'enfrentamento', 'eventualment', 'parceria', 'parceria', 'reafirmar', 'saudar', 'saudar', 'saudar', 'saudar']","[2, 2, 1, 1, 1, 1, 2, 2, 1, 4, 4, 4, 4]","[]","[]",13,0,13,1
10360,"['agravamento', 'comparacao', 'condicao', 'consorcio', 'impactar', 'mudanca', 'palacio', 'planalto', 'preservar', 'saudar', 'tendencia', 'totalizar', 'variacao']","[1, 1, 1, 1, 1, 1, 1, 1, 1, 1, 1, 1, 1]","[]","[]",13,0,13,1
10361,"['parceria']","[1]","[]","[]",1,0,1,1
10363,"['ambientar', 'autoridad', 'dosar', 'reuter', 'transicao']","[1, 1, 1, 1, 1]","[]","[]",5,0,5,1
10367,"['acompanhamento', 'boletim', 'consecutivo', 'diagnosticar', 'observar', 'periodo', 'saudar', 'taxar']","[1, 1, 1, 1, 1, 1, 1, 1]","[]","[]",8,0,8,1
10369,"['antecipar', 'depoimento', 'guaruja', 'julgamento', 'julgamento', 'lewandowski', 'necessidad', 'negativar', 'parceiro', 'republico', 'ricardo', 'sentenca', 'supremo', 'supremo', 'suspeicao', 'suspeicao', 'triplex', 'vespera']","[1, 1, 1, 2, 2, 1, 1, 1, 1, 1, 1, 1, 2, 2, 2, 2, 1, 1]","['imagem']","[1]",18,1,19,1
10374,"['administrativo', 'decisao', 'imunizacao', 'imunizacao', 'justicar', 'previsto', 'regiao', 'saudar', 'saudar', 'saudar', 'suspenso']","[1, 1, 2, 2, 1, 1, 1, 3, 3, 3, 1]","['atribuir']","[1]",11,1,12,1
10378,"['autoridad', 'cenario', 'coordenar', 'desempenhar', 'etapa', 'funcao', 'jorg', 'ministrar', 'ministrar', 'observar', 'regiao', 'revisar']","[1, 1, 1, 1, 1, 1, 1, 2, 2, 1, 1, 1]","['manobrar', 'venezuelano']","[1, 1]",12,2,14,1
10381,"['adotada', 'assintomatico', 'autoridad', 'autoridad', 'autoridad', 'balancar', 'balancar', 'contabilizar', 'discussao', 'epidemiar', 'epidemiar', 'epidemiar', 'especializar', 'estrategia', 'etapa', 'examinar', 'examinar', 'examinar', 'impacto', 'infectar', 'instituto', 'instituto', 'instituto', 'isolar', 'ministrar', 'positivar', 'presenca', 'provincia', 'regiao', 'saudar', 'saudar', 'saudar', 'saudar', 'subordinar', 'suspeito']","[1, 1, 3, 3, 3, 2, 2, 1, 1, 3, 3, 3, 1, 1, 1, 3, 3, 3, 1, 1, 3, 3, 3, 1, 1, 1, 1, 1, 1, 4, 4, 4, 4, 1, 1]","['realment', 'verdadeiro']","[1, 1]",35,2,37,1
10384,"['sociai', 'ultimo']","[1, 1]","['bonner']","[1]",2,1,3,1
10386,"['fronteiro', 'fronteiro', 'fronteiro', 'fronteiro', 'justicar', 'ministrar', 'situacao']","[4, 4, 4, 4, 1, 1, 1]","['sequer']","[1]",7,1,8,1
10387,"['agravar', 'constatar', 'fase', 'internacao', 'internar', 'intubacao', 'necessidad', 'preliminar', 'quadro', 'ventilacao']","[1, 1, 1, 1, 1, 1, 1, 1, 1, 1]","[]","[]",10,0,10,1
10388,"['aplicacao', 'aurelio', 'aurelio', 'constituicao', 'decisao', 'decisao', 'portavoz', 'preventivo', 'preventivo', 'processo', 'submetido']","[1, 2, 2, 1, 2, 2, 1, 2, 2, 1, 1]","['fraudar', 'soltar']","[1, 1]",11,2,13,1
10389,"['comparacao', 'crescimento', 'impulsionar', 'periodo']","[1, 1, 1, 1]","[]","[]",4,0,4,1
10391,"['ambientar', 'californio', 'californio', 'client', 'client', 'discussao', 'propagacao']","[1, 2, 2, 2, 2, 1, 1]","['atirar', 'atirar']","[2, 2]",7,2,9,1
10396,"['embora', 'medida', 'medida', 'tambem']","[1, 2, 2, 1]","[]","[]",4,0,4,1
10398,"['biliao', 'biliao', 'comparacao', 'expressivo', 'montant', 'pagamento', 'painel', 'reducao']","[2, 2, 1, 1, 1, 1, 1, 1]","[]","[]",8,0,8,1
10402,"['converso', 'equipamento', 'humanitario', 'portavoz']","[1, 1, 1, 1]","['imagem']","[1]",4,1,5,1
10404,"['aglomeracao', 'agravamento', 'associacao', 'cometido', 'estimular', 'exonerar', 'fundamentar', 'gripezinha', 'imunizacao', 'inicialment', 'magistrado', 'preventivo', 'prever', 'prever', 'prever', 'republico', 'saudar', 'saudar', 'saudar', 'saudar']","[1, 1, 1, 1, 1, 1, 1, 1, 1, 1, 1, 1, 3, 3, 3, 1, 4, 4, 4, 4]","[]","[]",20,0,20,1
10405,"['ambito', 'compromisso', 'marilia']","[1, 1, 1]","[]","[]",3,0,3,1
10407,"['autorizacao', 'desenvolvido', 'moderno', 'moderno', 'moderno', 'moderno', 'particularment', 'regrar']","[1, 1, 4, 4, 4, 4, 1, 1]","[]","[]",8,0,8,1
10408,"['espanha', 'exprefeito', 'provincia', 'quarentenar', 'quarentenar']","[1, 1, 1, 2, 2]","['renunciar']","[1]",5,1,6,1
10410,"['congresso', 'ministrar', 'motivacao', 'reabrir', 'reabrir', 'ricardo']","[1, 1, 1, 2, 2, 1]","[]","[]",6,0,6,1
10411,"['afetado', 'agravar', 'ausencia', 'diminuicao', 'inglaterra', 'negativar', 'observar', 'primario', 'quarentenar', 'regulamentar', 'situacao']","[1, 1, 1, 1, 1, 1, 1, 1, 1, 1, 1]","[]","[]",11,0,11,1
10412,"['positivar', 'positivar', 'rotina', 'saudar', 'saudar']","[2, 2, 1, 2, 2]","['menino', 'menino']","[2, 2]",5,2,7,1
10414,"['atrasar', 'autoridad', 'autoridad', 'balancar', 'belgica', 'belgica', 'consequencia', 'europeu', 'habitant', 'saudar']","[1, 2, 2, 1, 2, 2, 1, 1, 1, 1]","[]","[]",10,0,10,1
10416,"['carat', 'interlocutor', 'interlocutor', 'levantamento', 'palacio', 'percepcao', 'planalto']","[1, 2, 2, 1, 1, 1, 1]","[]","[]",7,0,7,1
10417,"['apreensao', 'apurar', 'contrato', 'desvio', 'economia', 'federar', 'fornecimento', 'investigacao', 'respiratorio', 'saudar', 'saudar', 'saudar', 'totalizar', 'varar']","[1, 1, 1, 1, 1, 1, 1, 1, 1, 3, 3, 3, 1, 1]","[]","[]",14,0,14,1
10421,"['respostar', 'reuter', 'reuter', 'sabado', 'velocidad', 'vigilancia']","[1, 2, 2, 1, 1, 1]","['renunciar']","[1]",6,1,7,1
10426,"['associacao', 'associacao', 'desvio', 'flavio', 'integrant', 'preocupacao', 'rachadinha', 'servidor', 'servidor']","[2, 2, 1, 1, 1, 1, 1, 2, 2]","['verificar']","[1]",9,1,10,1
10427,"['destinar', 'elaborar', 'imunizacao', 'justificativo', 'pastar', 'saudar', 'situacao']","[1, 1, 1, 1, 1, 1, 1]","[]","[]",7,0,7,1
10429,"['deltan', 'dialogo', 'dialogo', 'dialogo', 'especialment', 'forcatarefa', 'guaruja', 'inclusao', 'obtido', 'ribeiro', 'triplex']","[1, 3, 3, 3, 1, 1, 1, 1, 1, 1, 1]","[]","[]",11,0,11,1
10431,"['autoridad', 'decisao', 'destacar', 'destacar', 'orientacao', 'saudar', 'saudar']","[1, 1, 2, 2, 1, 2, 2]","['mencao']","[1]",7,1,8,1
10432,"['expectativa', 'presenca', 'saudar']","[1, 1, 1]","[]","[]",3,0,3,1
10434,"['espanha', 'ministrar', 'ministrar', 'nelson', 'saudar', 'saudar', 'teich', 'teich']","[1, 2, 2, 1, 2, 2, 2, 2]","[]","[]",8,0,8,1
10443,"['decisao', 'exercicio', 'inquerito', 'investigacao', 'justicar', 'magistrado', 'martim', 'medeiro', 'mendonca', 'ministrar', 'varar']","[1, 1, 1, 1, 1, 1, 1, 1, 1, 1, 1]","[]","[]",11,0,11,1
10444,"['adulto', 'carat', 'conformar', 'correspondent', 'distrito', 'pastar', 'reforcar', 'saudar', 'saudar', 'sorocaba', 'temporario']","[1, 1, 1, 1, 1, 1, 1, 2, 2, 1, 1]","[]","[]",11,0,11,1
10445,"['ventilacao', 'viagem']","[1, 1]","[]","[]",2,0,2,1
10447,"['campino', 'campino', 'cerimonia', 'desembarcar', 'guarulho', 'ministrar', 'presenca', 'prever', 'queiroga', 'recebido', 'remessar', 'remessar', 'saudar', 'saudar', 'totalizar', 'voo', 'voo']","[2, 2, 1, 1, 1, 1, 1, 1, 1, 1, 2, 2, 2, 2, 1, 2, 2]","[]","[]",17,0,17,1
10449,"['comportamento', 'crise', 'decisao', 'decisao', 'depoimento', 'divergencia', 'enfrentamento', 'exministro', 'henriqu', 'hospitalizacao', 'impacto', 'monitoramento', 'relacao', 'testagem']","[1, 1, 2, 2, 1, 1, 1, 1, 1, 1, 1, 1, 1, 1]","[]","[]",14,0,14,1
10451,"['anvisa', 'aplicacao', 'aprovacao', 'autorizacao', 'comissao', 'equivalent', 'europeu', 'europeu', 'europeu', 'europeu', 'moderno', 'moderno', 'regiao', 'reuter', 'saudar']","[1, 1, 1, 1, 1, 1, 4, 4, 4, 4, 2, 2, 1, 1, 1]","[]","[]",15,0,15,1
10453,"['antonio', 'anvisa', 'folhar']","[1, 1, 1]","[]","[]",3,0,3,1
10463,"['aglomeracao', 'avancar', 'decisao', 'determinacao', 'enfrentamento', 'enfrentamento', 'inicialment', 'necessario', 'precaucao', 'propagacao', 'proporcao', 'prorrogar', 'regrar']","[1, 1, 1, 1, 2, 2, 1, 1, 1, 1, 1, 1, 1]","['ganhar']","[1]",13,1,14,1
10465,"['colegiado', 'comissao', 'inquerito', 'saudar', 'transmissao']","[1, 1, 1, 1, 1]","[]","[]",5,0,5,1
10466,"['afetado', 'associacao', 'balancar', 'equivalent', 'espirito', 'funcionamento', 'funcionamento', 'prever', 'regiao', 'regiao']","[1, 1, 1, 1, 1, 2, 2, 1, 2, 2]","[]","[]",10,0,10,1
10467,"['colunista', 'desenvolvido', 'fabricacao', 'folhar', 'fundacao', 'globonew', 'instituto', 'oswaldo', 'parceria']","[1, 1, 1, 1, 1, 1, 1, 1, 1]","[]","[]",9,0,9,1
10469,"['academiar', 'academiar', 'decisao', 'decisao', 'flexibilizacao', 'isolar', 'justicar', 'reabertura', 'recurso', 'regulamentar', 'rocha', 'rocha', 'treinar']","[2, 2, 2, 2, 1, 1, 1, 1, 1, 1, 2, 2, 1]","['amplament', 'compartilhar']","[1, 1]",13,2,15,1
10471,"['companhia', 'contribuicao', 'desenvolvimento', 'equipamento', 'equipamento', 'equipamento', 'fabricacao', 'guarulho', 'inovacao', 'inovacao', 'materiaprima', 'parceiro', 'parceiro', 'parceiro', 'saudar', 'saudar']","[1, 1, 1, 3, 3, 3, 1, 1, 2, 2, 1, 3, 3, 3, 2, 2]","['realment']","[1]",16,1,17,1
10472,"['comissao', 'comportamento', 'fundamentar', 'levantamento', 'vulneravel']","[1, 1, 1, 1, 1]","[]","[]",5,0,5,1
10473,"['colaboracao', 'economia', 'espirito', 'importancia', 'necessario', 'necessidad', 'preocupacao', 'preservacao', 'preservacao', 'reafirmar', 'recurso', 'saudar', 'temor']","[1, 1, 1, 1, 1, 1, 1, 2, 2, 1, 1, 1, 1]","[]","[]",13,0,13,1
10475,"['arthur', 'fez', 'henriqu', 'henriqu', 'henriqu', 'prtb', 'roraima']","[1, 1, 3, 3, 3, 1, 1]","['numerica']","[1]",7,1,8,1
10476,"['acordo', 'augusto', 'colegio', 'colegio', 'diretoria', 'disseminacao', 'instituto', 'oliveira', 'pedido', 'vigilancia']","[1, 1, 2, 2, 1, 1, 1, 1, 1, 1]","[]","[]",10,0,10,1
10477,"['ausencia', 'justificativo', 'prazo', 'situacao']","[1, 1, 1, 1]","[]","[]",4,0,4,1
10478,"['consecutivo', 'depoimento', 'domingo', 'imunizacao', 'regrar', 'superar']","[1, 1, 1, 1, 1, 1]","[]","[]",6,0,6,1
10480,"['externo', 'painel', 'possibilidad']","[1, 1, 1]","['galaxi', 'galaxi', 'visualizar']","[2, 2, 1]",3,3,6,1
10481,"['inquerito', 'instaurar', 'planar', 'planar', 'saudar']","[1, 1, 2, 2, 1]","[]","[]",5,0,5,1
10482,"['corpu', 'corpu', 'dificultar', 'edson', 'empatar', 'empatar', 'empatar', 'empatar', 'entendimento', 'entendimento', 'fachin', 'fachin', 'habea', 'habea', 'julgamento', 'julgamento', 'julgamento', 'ministrar', 'plenario', 'processo', 'proposto', 'recurso', 'regrar', 'sessao', 'supremo', 'supremo', 'turma', 'turma', 'turma']","[2, 2, 1, 1, 4, 4, 4, 4, 2, 2, 2, 2, 2, 2, 3, 3, 3, 1, 1, 1, 1, 1, 1, 1, 2, 2, 3, 3, 3]","[]","[]",29,0,29,1
10483,"['assistencia', 'atuam', 'curso', 'curso', 'desenvolvimento', 'desenvolvimento', 'oferecido', 'parceria', 'pratico', 'presenca', 'saudar', 'saudar', 'saudar', 'saudar', 'saudar']","[1, 1, 2, 2, 2, 2, 1, 1, 1, 1, 5, 5, 5, 5, 5]","[]","[]",15,0,15,1
10484,"['portavoz', 'portavoz']","[2, 2]","[]","[]",2,0,2,1
10485,"['escassez', 'instituto', 'proprio', 'proximo', 'revogar', 'revogar', 'rotina', 'supremo']","[1, 1, 1, 1, 2, 2, 1, 1]","[]","[]",8,0,8,1
10489,"['adhanom', 'autoridad', 'domingo', 'epicentro', 'epidemiar', 'epidemiar', 'hubei', 'propagacao', 'provincia', 'saudar', 'saudar', 'surtir', 'tedro']","[1, 1, 1, 1, 2, 2, 1, 1, 1, 2, 2, 1, 1]","['incendio']","[1]",13,1,14,1
10493,"['araujo', 'araujo', 'assistencia', 'autorizacao', 'companhia', 'disseminacao', 'enfrentamento', 'epidemiar', 'fabricacao', 'irregularidad', 'mantido', 'minimizar', 'monitoramento', 'respirador', 'saudar', 'suspeito', 'suspenso', 'temporariament']","[2, 2, 1, 1, 1, 1, 1, 1, 1, 1, 1, 1, 1, 1, 1, 1, 1, 1]","['fraudar', 'inscricao']","[1, 1]",18,2,20,1
10496,"['amplo', 'amplo', 'avancar', 'converso', 'exgovernador', 'proposto', 'rocha', 'semestr', 'sustentabilidad']","[2, 2, 1, 1, 1, 1, 1, 1, 1]","[]","[]",9,0,9,1
10498,"['adotada', 'epidemiar', 'estrategia', 'metropolitano', 'prioridad', 'processo', 'prorrogar', 'quarentenar', 'quarentenar', 'saudar']","[1, 1, 1, 1, 1, 1, 1, 2, 2, 1]","['imagem', 'libertador', 'protestar']","[1, 1, 1]",10,3,13,1
10512,"['acordo', 'atuacao', 'atuacao', 'atuacao', 'atuam', 'conjunta', 'conjunta', 'conselho', 'decisao', 'decisao', 'decisao', 'decisao', 'desvio', 'forcatarefa', 'forcatarefa', 'integrant', 'oficio', 'oliveira', 'oliveira', 'quadro', 'tambem']","[1, 3, 3, 3, 1, 2, 2, 1, 4, 4, 4, 4, 1, 2, 2, 1, 1, 2, 2, 1, 1]","[]","[]",21,0,21,1
10514,"['colegio', 'conduta', 'empatar', 'levantamento', 'liderar', 'reabertura', 'rejeicao', 'taxar']","[1, 1, 1, 1, 1, 1, 1, 1]","[]","[]",8,0,8,1
10517,"['balancar', 'balancar', 'cnj', 'cnj', 'contabilizar', 'contribuicao', 'coordenar', 'humberto', 'implementacao', 'justicar', 'justicar', 'martim', 'periodo', 'proposto', 'proposto', 'republico', 'sugestao', 'sugestao']","[2, 2, 2, 2, 1, 1, 1, 1, 1, 2, 2, 1, 1, 2, 2, 1, 2, 2]","[]","[]",18,0,18,1
10518,"['abordagem', 'aglomeracao', 'desafiar', 'normalment', 'periferia', 'regiao', 'reuniao', 'saudar', 'unanimidad']","[1, 1, 1, 1, 1, 1, 1, 1, 1]","['circular', 'manobrar']","[1, 1]",9,2,11,1
10519,"['aliviar', 'desenvolvido', 'dosar', 'dosar', 'instituto', 'parceria']","[1, 1, 2, 2, 1, 1]","[]","[]",6,0,6,1
10520,"['companhia', 'constatar', 'crise', 'crise', 'crise', 'domingo', 'exministro', 'pastar', 'quadro', 'regrar', 'saudar', 'subordinar', 'turma']","[1, 1, 3, 3, 3, 1, 1, 1, 1, 1, 1, 1, 1]","['tampouco']","[1]",13,1,14,1
10521,"['contribuicao', 'decisao', 'fundacao', 'fundacao', 'ideologico', 'justicar', 'justicar', 'manutencao', 'nomeacao']","[1, 1, 2, 2, 1, 2, 2, 1, 1]","[]","[]",9,0,9,1
10522,"['alcolumbr', 'bancada', 'decisao', 'decisao', 'demap', 'demmg', 'pacheco', 'pratico', 'respostar', 'sigla']","[1, 1, 2, 2, 1, 1, 1, 1, 1, 1]","[]","[]",10,0,10,1
10524,"['client', 'equipamento', 'expansao', 'limitacao', 'limitacao', 'necessidad', 'pagamento', 'pagamento', 'pratico', 'pratico', 'tendencia', 'transferencia', 'transferencia', 'transferencia', 'transferencia', 'velocidad']","[1, 1, 1, 2, 2, 1, 2, 2, 2, 2, 1, 4, 4, 4, 4, 1]","['usuario', 'usuario']","[2, 2]",16,2,18,1
10528,"['aplicacao', 'aplicacao', 'capitar', 'dosar', 'dosar', 'dosar', 'escassez', 'imunizacao', 'prazo', 'previsao', 'remessar', 'saudar', 'saudar', 'saudar', 'saudar', 'suspenso', 'suspenso', 'suspenso']","[2, 2, 1, 3, 3, 3, 1, 1, 1, 1, 1, 4, 4, 4, 4, 3, 3, 3]","[]","[]",18,0,18,1
10534,"['anvisa', 'folhar', 'integro', 'interrupcao', 'saudar', 'temporariament', 'vigilancia']","[1, 1, 1, 1, 1, 1, 1]","[]","[]",7,0,7,1
10535,"['avancar', 'consumidor', 'consumidor', 'decisao', 'diretoria', 'discussao', 'impacto', 'parcelar', 'periodo', 'recurso', 'reuniao', 'tramitar']","[1, 2, 2, 1, 1, 1, 1, 1, 1, 1, 1, 1]","[]","[]",12,0,12,1
10537,"['apurar', 'conflito', 'fundacao', 'integro', 'investigacao', 'saudar']","[1, 1, 1, 1, 1, 1]","[]","[]",6,0,6,1
10540,"['argumentar', 'aurelio', 'bandeirant', 'corpu', 'corpu', 'crise', 'decisao', 'decisao', 'decisao', 'decisao', 'decisao', 'fux', 'habea', 'habea', 'mello', 'ministrar', 'ministrar', 'necessario', 'plenario', 'preventivo', 'preventivo', 'sabado', 'supremo']","[1, 1, 1, 2, 2, 1, 5, 5, 5, 5, 5, 1, 2, 2, 1, 2, 2, 1, 1, 2, 2, 1, 1]","['soltar']","[1]",23,1,24,1
10542,"['algun', 'exemplo']","[1, 1]","['sobra']","[1]",2,1,3,1
10544,"['associacao', 'atuacao', 'avancar', 'congresso', 'federar', 'federar', 'investigacao', 'regulamentar', 'resolucao']","[1, 1, 1, 1, 2, 2, 1, 1, 1]","['ganhar', 'realment', 'realment']","[1, 2, 2]",9,3,12,1
10546,"['domicilio', 'estatistico', 'geografia', 'ibg', 'instituto', 'levantamento', 'trimestr']","[1, 1, 1, 1, 1, 1, 1]","[]","[]",7,0,7,1
10547,"['andrew', 'conformar', 'epicentro', 'infectar', 'infectar', 'propagacao']","[1, 1, 1, 2, 2, 1]","[]","[]",6,0,6,1
10548,"['administrativo', 'argumentar', 'augusto', 'cupula', 'decisao', 'enfrentamento', 'extensao', 'forcatarefa', 'integrant', 'integrant', 'oficio', 'prazo', 'prorrogacao', 'prorrogar', 'republico', 'republico']","[1, 1, 1, 1, 1, 1, 1, 1, 2, 2, 1, 1, 1, 1, 2, 2]","[]","[]",16,0,16,1
10549,"['conselho', 'desgastar', 'interferencia', 'interferencia', 'interferencia', 'reajust', 'reajust', 'reajust']","[1, 1, 3, 3, 3, 3, 3, 3]","['gasolina']","[1]",8,1,9,1
10553,"['ccj', 'colunista', 'comissao', 'constituicao', 'economia', 'epidemiar', 'exministro', 'exministro', 'importancia', 'justicar', 'posturar', 'quarentenar', 'randolf', 'saudar']","[1, 1, 1, 1, 1, 1, 2, 2, 1, 1, 1, 1, 1, 1]","[]","[]",14,0,14,1
10555,"['adiamento', 'aprovacao', 'argumentar', 'argumentar', 'calculo', 'discussao', 'discussao', 'disseminacao', 'elaborar', 'emendar', 'plenario', 'presenca', 'previsao', 'proposto', 'regulamentar', 'rejeitar', 'situacao']","[1, 1, 2, 2, 1, 2, 2, 1, 1, 1, 1, 1, 1, 1, 1, 1, 1]","[]","[]",17,0,17,1
10556,"['apurar', 'argumentar', 'decisao', 'decisao', 'decisao', 'esquema', 'flavio', 'flavio', 'flavio', 'integro', 'justicar', 'justicar', 'justicar', 'justicar', 'magistrado', 'ministrar', 'privilegiar', 'provisorio', 'rachadinha', 'rejeitar', 'republicanosrj', 'republico', 'turma', 'varar']","[1, 1, 3, 3, 3, 1, 3, 3, 3, 1, 4, 4, 4, 4, 1, 1, 1, 1, 1, 1, 1, 1, 1, 1]","[]","[]",24,0,24,1
10558,"['antecipar', 'florido', 'michael', 'moderno', 'recordar', 'recordar', 'reuter', 'superar']","[1, 1, 1, 1, 2, 2, 1, 1]","['cedula']","[1]",8,1,9,1
10559,"['acompanhamento', 'circulacao', 'comportamento', 'fase', 'implementar', 'instituto', 'instituto', 'instituto', 'investigacao', 'medeiro', 'mutacao', 'mutacao', 'mutacao', 'respostar', 'saudar', 'saudar', 'saudar', 'sequenciamento', 'vigilancia', 'vigilancia', 'vigilancia']","[1, 1, 1, 1, 1, 3, 3, 3, 1, 1, 3, 3, 3, 1, 3, 3, 3, 1, 3, 3, 3]","[]","[]",21,0,21,1
10560,"['afetado', 'afetado', 'bandeirant', 'concedido', 'crise', 'crise', 'crise', 'crise', 'crise', 'economia', 'economia', 'economia', 'economia', 'economia', 'exministro', 'gued', 'gued', 'henriqu', 'ministrar', 'palacio', 'preocupacao', 'quarentenar', 'quarentenar', 'quarentenar', 'reuniao', 'supremo']","[2, 2, 1, 1, 5, 5, 5, 5, 5, 5, 5, 5, 5, 5, 1, 2, 2, 1, 1, 1, 1, 3, 3, 3, 1, 1]","['verdadeiro']","[1]",26,1,27,1
10561,"['avancar', 'possibilidad', 'quarentenar', 'recuar', 'recuar', 'semestr']","[1, 1, 1, 2, 2, 1]","[]","[]",6,0,6,1
10562,"['associacao', 'contemplar', 'supremo']","[1, 1, 1]","[]","[]",3,0,3,1
10563,"['adesao', 'adesao', 'adesao', 'antecipar', 'aplicacao', 'capitar', 'desenvolvido', 'excecao', 'fluminens', 'folhar', 'imunizacao', 'imunizacao', 'instituto', 'instituto', 'instituto', 'instituto', 'instituto', 'instituto', 'levantamento', 'levantamento', 'levantamento', 'margem', 'parcelar', 'periodo', 'quedo', 'quedo', 'quedo', 'rejeicao', 'resistencia', 'resistencia', 'resistencia', 'respectivament', 'sabado', 'subir', 'taxar', 'taxar', 'taxar']","[3, 3, 3, 1, 1, 1, 1, 1, 1, 1, 2, 2, 6, 6, 6, 6, 6, 6, 3, 3, 3, 1, 1, 1, 3, 3, 3, 1, 3, 3, 3, 1, 1, 1, 3, 3, 3]","[]","[]",37,0,37,1
10564,"['aprovacao', 'aprovacao', 'calheiro', 'comissao', 'congresso', 'desempenhar', 'desempenhar', 'fundamentar', 'inquerito', 'instalacao', 'investigacao', 'mdbal', 'prazo', 'provisorio', 'regrar', 'vigilancia']","[2, 2, 1, 1, 1, 2, 2, 1, 1, 1, 1, 1, 1, 1, 1, 1]","[]","[]",16,0,16,1
10566,"['avancar', 'demrj', 'depoimento', 'exministro', 'exministro', 'exministro', 'henriqu', 'legislativo', 'planar', 'preocupacao', 'preocupacao', 'republico', 'republico', 'saudar', 'saudar', 'situacao', 'supremo']","[1, 1, 1, 3, 3, 3, 1, 1, 1, 2, 2, 2, 2, 2, 2, 1, 1]","[]","[]",17,0,17,1
10567,"['aglomeracao', 'destinar', 'mantido']","[1, 1, 1]","['amigar', 'secreto', 'telegram', 'telegram', 'verificar']","[1, 1, 2, 2, 1]",3,5,8,1
10569,"['compromisso', 'iniciativo', 'orientacao', 'reforcar', 'turma']","[1, 1, 1, 1, 1]","['disseminar', 'verificar']","[1, 1]",5,2,7,1
10575,"['anvisa', 'aplicacao', 'aplicacao', 'autorizacao', 'condicao', 'coordenar', 'distrito', 'especifico', 'prioritario']","[1, 2, 2, 1, 1, 1, 1, 1, 1]","[]","[]",9,0,9,1
10577,"['administrativo', 'instituto', 'ministrar', 'plano', 'saudar', 'supremo', 'vigilancia']","[1, 1, 1, 1, 1, 1, 1]","[]","[]",7,0,7,1
10579,"['domingo', 'exministro', 'exministro', 'henriqu', 'iniciativo', 'iniciativo', 'integro', 'justicar', 'ministrar', 'preconceito', 'privar', 'saudar', 'saudar', 'supremo']","[1, 2, 2, 1, 2, 2, 1, 1, 1, 1, 1, 2, 2, 1]","[]","[]",14,0,14,1
10580,"['comissao', 'entregu', 'preservar', 'proposto', 'proposto', 'recebido', 'republico', 'wajngarten']","[1, 1, 1, 2, 2, 1, 1, 1]","[]","[]",8,0,8,1
10581,"[]","[]","[]","[]",0,0,0,1
10583,"['academiar', 'ambientar', 'desmatamento', 'destacar', 'instituto', 'moderno', 'processo', 'regiao', 'regiao', 'transmissao']","[1, 1, 1, 1, 1, 1, 1, 2, 2, 1]","['trafico']","[1]",10,1,11,1
10584,"['autoridad', 'crise', 'crise', 'decorrencia', 'diagnosticar', 'distrito', 'epidemiar', 'europeu', 'extraordinario', 'infectar', 'inicialment', 'instituto', 'ministrar', 'plenario', 'quarentenar', 'reuniao', 'saudar', 'sessao', 'subir', 'suspeito', 'transferir']","[1, 2, 2, 1, 1, 1, 1, 1, 1, 1, 1, 1, 1, 1, 1, 1, 1, 1, 1, 1, 1]","[]","[]",21,0,21,1
10585,"['anuncio', 'client', 'decisao', 'expectativa', 'expectativa', 'expectativa', 'externo', 'limitacao', 'possibilidad', 'pratico', 'previsao', 'quarentenar', 'reabertura', 'reabertura', 'reabertura', 'reabrir', 'reabrir', 'reabrir', 'treinar']","[1, 1, 1, 3, 3, 3, 1, 1, 1, 1, 1, 1, 3, 3, 3, 3, 3, 3, 1]","['enderecar']","[1]",19,1,20,1
10587,"['converso', 'parceiro', 'ricardo', 'ricardo', 'ricardo', 'suspeito']","[1, 1, 3, 3, 3, 1]","['crech']","[1]",6,1,7,1
10589,"['antecipar', 'colegio', 'decisao', 'decisao', 'itamarati', 'itamarati', 'orientacao', 'posturar']","[1, 1, 2, 2, 2, 2, 1, 1]","[]","[]",8,0,8,1
10593,"['adulto', 'comportamento', 'crescimento', 'cronica', 'cronica', 'desenvolvimento', 'epidemiologico', 'habito', 'habito', 'habito', 'impactar', 'letalidad', 'mudanca', 'mudanca', 'mudanca', 'mudanca', 'periodo', 'proposto', 'regiao', 'regiao', 'saudar', 'saudar']","[1, 1, 1, 2, 2, 1, 1, 3, 3, 3, 1, 1, 4, 4, 4, 4, 1, 1, 2, 2, 2, 2]","['questionario']","[1]",22,1,23,1
10595,"['sancao', 'servidor', 'servidor']","[1, 2, 2]","[]","[]",3,0,3,1
10596,"['inquerito', 'reafirmar', 'respostar']","[1, 1, 1]","['dioxido', 'vitaminar', 'zincar']","[1, 1, 1]",3,3,6,1
10597,"['adicionar', 'aprovacao', 'autoridad', 'autoridad', 'espirito', 'instalacao', 'saudar', 'saudar']","[1, 1, 2, 2, 1, 1, 2, 2]","[]","[]",8,0,8,1
10599,"['autorizacao', 'funcao', 'precisao', 'rastreamento', 'rastreamento', 'rastreamento']","[1, 1, 1, 3, 3, 3]","[]","[]",6,0,6,1
10600,"['adicionar', 'argumentar', 'autoridad', 'decisao', 'estrategia', 'funcao', 'gabinet', 'liderar', 'reuter', 'saudar']","[1, 1, 1, 1, 1, 1, 1, 1, 1, 1]","[]","[]",10,0,10,1
10602,"['crise', 'fase', 'imunizacao', 'patamar', 'precedent', 'reconhecimento', 'viagem']","[1, 1, 1, 1, 1, 1, 1]","['fotografia', 'ganhar']","[1, 1]",7,2,9,1
10604,"['adesao', 'adesao', 'adesao', 'algun', 'assistencia', 'flexibilizacao', 'importancia', 'milho', 'milho', 'periodo', 'reforcar', 'sendo']","[3, 3, 3, 1, 1, 1, 1, 2, 2, 1, 1, 1]","[]","[]",12,0,12,1
10605,"['absoluto', 'demandar', 'desempenhar', 'deslocamento', 'deslocamento', 'especialment', 'fluminens', 'fundacao', 'internacao', 'internacao', 'internacao', 'internar', 'necessidad', 'oswaldo', 'recurso', 'ricardo', 'saudar', 'saudar']","[1, 1, 1, 2, 2, 1, 1, 1, 3, 3, 3, 1, 1, 1, 1, 1, 2, 2]","[]","[]",18,0,18,1
10606,"['alvorar', 'biliao', 'definitivo', 'instituto', 'ministrar', 'ministrar', 'ministrar', 'necessidad', 'parceria', 'presidir', 'provisorio', 'saudar']","[1, 1, 1, 1, 3, 3, 3, 1, 1, 1, 1, 1]","[]","[]",12,0,12,1
10607,"['atrasar', 'congresso', 'cupula', 'emendar', 'folhar', 'integro', 'prever', 'proposto', 'provisorio', 'regrar']","[1, 1, 1, 1, 1, 1, 1, 1, 1, 1]","[]","[]",10,0,10,1
10609,"['autoridad', 'diagnosticar', 'domingo', 'domingo', 'espanha', 'espanha', 'hospitalizar', 'infectar', 'saudar']","[1, 1, 2, 2, 2, 2, 1, 1, 1]","[]","[]",9,0,9,1
10610,"['colunista', 'henriqu', 'necessario', 'negativar']","[1, 1, 1, 1]","['ganhar', 'ganhar']","[2, 2]",4,2,6,1
10611,"['batalhar', 'distant', 'inglaterra', 'inglaterra', 'internacao', 'positivar', 'quedo', 'quilometro', 'saudar', 'saudar']","[1, 1, 2, 2, 1, 1, 1, 1, 2, 2]","[]","[]",10,0,10,1
10613,"['autoridad', 'sputnik', 'sputnik', 'sputnik']","[1, 3, 3, 3]","[]","[]",4,0,4,1
10616,"['balancar', 'capitar', 'consorcio', 'crise', 'destacar', 'disseminacao', 'fundacao', 'levantamento', 'varga']","[1, 1, 1, 1, 1, 1, 1, 1, 1]","[]","[]",9,0,9,1
10617,"['alvorar', 'mantido', 'palacio']","[1, 1, 1]","['filmar']","[1]",3,1,4,1
10618,"['aglomeracao', 'ambientar', 'atendido', 'client', 'client', 'client', 'client', 'client', 'gestant', 'instalacao', 'prioritario', 'reforcar', 'reforcar', 'triagem', 'triagem']","[1, 1, 1, 5, 5, 5, 5, 5, 1, 1, 1, 2, 2, 2, 2]","[]","[]",15,0,15,1
10619,"['anuncio', 'anuncio', 'contabilizar', 'desempenhar', 'funcao', 'mudanca', 'publicitario', 'publicitario', 'suspeito']","[2, 2, 1, 1, 1, 1, 2, 2, 1]","[]","[]",9,0,9,1
10620,"['algun', 'anvisa', 'aprovacao', 'imunizacao', 'imunizacao', 'imunizacao', 'instituto', 'milho', 'paralelo', 'parceria', 'plano', 'plano', 'plano', 'plano', 'plano', 'profissionai', 'proposta', 'proprio', 'rejeicao', 'tambem', 'vigilancia']","[1, 1, 1, 3, 3, 3, 1, 1, 1, 1, 5, 5, 5, 5, 5, 1, 1, 1, 1, 1, 1]","[]","[]",21,0,21,1
10622,"['apurar', 'autoridad', 'delacao', 'folhar', 'inquerito', 'inquerito', 'integro', 'investigacao', 'ministrar', 'necessidad', 'segredar']","[1, 1, 1, 1, 2, 2, 1, 1, 1, 1, 1]","['abusar']","[1]",11,1,12,1
10624,"['acordo', 'colaboracao', 'colaboracao', 'companhia', 'instaurar', 'irregularidad', 'pagamento', 'pagamento', 'pagamento', 'reforcar', 'republico']","[1, 2, 2, 1, 1, 1, 3, 3, 3, 1, 1]","[]","[]",11,0,11,1
10625,"['californio', 'convencao', 'convencao']","[1, 2, 2]","['obama']","[1]",3,1,4,1
10626,"['converso', 'deltan', 'deltan', 'deltan', 'dialogo', 'justicar', 'mello', 'ministrar', 'turma']","[1, 3, 3, 3, 1, 1, 1, 1, 1]","['bandeiro', 'vazar']","[1, 1]",9,2,11,1
10627,"['alteracao', 'carat', 'colunista', 'economia', 'exministro', 'gued', 'ministrar', 'parceria', 'parceria', 'parceria', 'parceria', 'pratico', 'preocupacao', 'privar', 'privar', 'privatizacao', 'saudar', 'saudar', 'saudar', 'saudar']","[1, 1, 1, 1, 1, 1, 1, 4, 4, 4, 4, 1, 1, 2, 2, 1, 4, 4, 4, 4]","[]","[]",20,0,20,1
10629,"['campino', 'comparacao', 'desenvolvido', 'indicador', 'internacao', 'piorar', 'pratico', 'projeco', 'propagacao', 'regiao', 'significativo', 'situacao', 'sorocaba', 'subir', 'suspeito', 'taxar', 'transmissao']","[1, 1, 1, 1, 1, 1, 1, 1, 1, 1, 1, 1, 1, 1, 1, 1, 1]","[]","[]",17,0,17,1
10630,"['antecipar', 'anvisa', 'anvisa', 'reafirm', 'risco', 'sociai', 'vigilancia']","[1, 2, 2, 1, 1, 1, 1]","[]","[]",7,0,7,1
10631,"['congresso', 'contabilizar', 'crise', 'henriqu', 'instituto', 'integrant', 'ministrar', 'preocupacao', 'quarentenar', 'roraima', 'saudar', 'saudar', 'saudar', 'videoconferencia']","[1, 1, 1, 1, 1, 1, 1, 1, 1, 1, 3, 3, 3, 1]","['ganhar']","[1]",14,1,15,1
10632,"['acumular', 'cenario', 'depressao', 'economia', 'economia', 'impactar', 'impulsionar', 'incerteza', 'monetario', 'perspectivo', 'pib', 'piorar', 'prever', 'previsao', 'recuperacao', 'recuperacao', 'reuter', 'situacao', 'taxar']","[1, 1, 1, 2, 2, 1, 1, 1, 1, 1, 1, 1, 1, 1, 2, 2, 1, 1, 1]","[]","[]",19,0,19,1
10633,"['preconceito', 'resultado', 'sendo', 'ufrj', 'ufrj']","[1, 1, 1, 2, 2]","[]","[]",5,0,5,1
10634,"['fabricacao', 'fundacao', 'instituto', 'instituto', 'materiaprima', 'oswaldo', 'previsao']","[1, 1, 2, 2, 1, 1, 1]","[]","[]",7,0,7,1
10635,"['aplicacao', 'decisao', 'decisao', 'lewandowski', 'lewandowski', 'ministrar', 'ministrar', 'ministrar', 'recebido', 'recurso', 'recurso', 'regrar', 'regrar', 'regrar', 'regrar', 'ricardo', 'ricardo', 'supremo']","[1, 2, 2, 2, 2, 3, 3, 3, 1, 2, 2, 4, 4, 4, 4, 2, 2, 1]","[]","[]",18,0,18,1
10636,"['crise', 'crise', 'desafiar', 'desafio', 'europeu', 'impulsionar', 'merkel', 'mudanca', 'recuperacao']","[2, 2, 1, 1, 1, 1, 1, 1, 1]","[]","[]",9,0,9,1
10637,"['facilitar', 'habito', 'necessario', 'pratico', 'rotina']","[1, 1, 1, 1, 1]","['imagem']","[1]",5,1,6,1
10638,"['alergia', 'associacao', 'destacar', 'discussao', 'imunizacao', 'imunizacao', 'infectar', 'infectar', 'marinhar', 'michael', 'necessidad', 'necessidad', 'pratico', 'prazo', 'reforcar', 'reforcar', 'rotina', 'sarampo', 'sarampo', 'sarampo', 'sarampo', 'sarampo', 'sarampo', 'sarampo', 'sarampo', 'sarampo', 'saudar']","[1, 1, 1, 1, 2, 2, 2, 2, 1, 1, 2, 2, 1, 1, 2, 2, 1, 9, 9, 9, 9, 9, 9, 9, 9, 9, 1]","[]","[]",27,0,27,1
10640,"['articulacao', 'comunitario', 'comunitario', 'destacar', 'destacar', 'necessidad', 'regiao', 'souza']","[1, 2, 2, 2, 2, 1, 1, 1]","[]","[]",8,0,8,1
10642,"['administrativo', 'aplicacao', 'atuacao', 'aurelio', 'autoridad', 'eventualment', 'instaurar', 'instituto', 'investigacao', 'investigacao', 'julgamento', 'ministrar', 'possibilidad', 'processo', 'punicao', 'reafirmar', 'sabado', 'sancao']","[1, 1, 1, 1, 1, 1, 1, 1, 2, 2, 1, 1, 1, 1, 1, 1, 1, 1]","[]","[]",18,0,18,1
10644,"['anteontem', 'anteontem', 'californio', 'crescimento', 'crescimento', 'decorrencia', 'ritmar', 'ritmar', 'subir']","[2, 2, 1, 2, 2, 1, 2, 2, 1]","[]","[]",9,0,9,1
10645,"['avancar', 'celebrar', 'decisao', 'domicilio', 'enfrentamento', 'expansao', 'fase', 'justicar', 'previsto', 'regiao', 'regiao', 'reuniao', 'reuniao', 'revogar', 'suspenso', 'suspenso']","[1, 1, 1, 1, 1, 1, 1, 1, 1, 2, 2, 2, 2, 1, 2, 2]","[]","[]",16,0,16,1
10648,"['celebrar', 'competicao', 'converso', 'desafiar', 'desafiar', 'domingo', 'espanha', 'viagem', 'videoconferencia']","[1, 1, 1, 2, 2, 1, 1, 1, 1]","[]","[]",9,0,9,1
10660,"['advocaciager', 'disseminacao', 'integrant', 'justicar', 'mello', 'rejeicao', 'rejeitar', 'republico', 'servidor', 'supremo', 'suspensao', 'suspensao', 'sustentabilidad', 'universitario']","[1, 1, 1, 1, 1, 1, 1, 1, 1, 1, 2, 2, 1, 1]","[]","[]",14,0,14,1
10661,"['aliviar', 'assistencia', 'cronica', 'diagnosticar', 'enfrentamento', 'especializar', 'pastar', 'planar', 'saudar', 'saudar', 'saudar', 'transferencia', 'transferir']","[1, 1, 1, 1, 1, 1, 1, 1, 3, 3, 3, 1, 1]","[]","[]",13,0,13,1
10664,"['apurar', 'temporario', 'temporario']","[1, 2, 2]","[]","[]",3,0,3,1
10666,"['antecipar', 'boletim', 'consolidar', 'crescimento', 'diariament', 'elaborar', 'implementar', 'jorg', 'levantamento', 'necessidad', 'possibilidad', 'prever']","[1, 1, 1, 1, 1, 1, 1, 1, 1, 1, 1, 1]","[]","[]",12,0,12,1
10672,"['parceria']","[1]","[]","[]",1,0,1,1
10674,"['client', 'crise', 'domicilio', 'florido', 'florido']","[1, 1, 1, 2, 2]","['realment']","[1]",5,1,6,1
10676,"['comissao', 'infectar', 'kong', 'saudar', 'subir', 'suspeito']","[1, 1, 1, 1, 1, 1]","[]","[]",6,0,6,1
10679,"['europeu']","[1]","[]","[]",1,0,1,1
10680,"['epidemiar', 'equipamento', 'europeu', 'fronteiro', 'fronteiro', 'intervalar', 'passageiro', 'passageiro', 'quedo', 'reabertura', 'reabertura', 'regiao', 'turista', 'viagem', 'viajant', 'voo', 'voo']","[1, 1, 1, 2, 2, 1, 2, 2, 1, 2, 2, 1, 1, 1, 1, 2, 2]","['circular', 'circular', 'verificacao']","[2, 2, 1]",17,3,20,1
10682,"['autoridad', 'carat', 'consequencia', 'decorrent', 'disseminacao', 'medida', 'medida', 'plano', 'restritivo', 'supremo']","[1, 1, 1, 1, 1, 2, 2, 1, 1, 1]","['implantar']","[1]",10,1,11,1
10684,"['associacao', 'coletivo', 'crescimento', 'emergenciai', 'periferia', 'piorar', 'respiratorio', 'saudar']","[1, 1, 1, 1, 1, 1, 1, 1]","[]","[]",8,0,8,1
10687,"['bastidor', 'desgastar', 'intenso', 'jorg', 'jorg', 'justicar', 'justicar', 'justicar', 'justicar', 'mendonca', 'mendonca', 'ministrar', 'oliveira', 'oliveira', 'pastar', 'ramagem', 'ramagem', 'ramagem']","[1, 1, 1, 2, 2, 4, 4, 4, 4, 2, 2, 1, 2, 2, 1, 3, 3, 3]","[]","[]",18,0,18,1
10690,"['crise', 'distant', 'henriqu', 'ministrar', 'ministrar', 'ministrar', 'ministrar', 'nelson', 'preocupacao', 'saudar', 'saudar', 'saudar', 'saudar', 'teich']","[1, 1, 1, 4, 4, 4, 4, 1, 1, 4, 4, 4, 4, 1]","['arquivar']","[1]",14,1,15,1
10691,"['integro', 'periodo', 'periodo', 'respiratorio', 'respiratorio']","[1, 2, 2, 2, 2]","[]","[]",5,0,5,1
10694,"['epidemiar', 'europeu', 'infectar', 'intenso', 'journal', 'variacao']","[1, 1, 1, 1, 1, 1]","['crer']","[1]",6,1,7,1
10696,"['contagioso', 'destinar', 'fronteiro', 'interrupcao', 'merkel', 'ministrar', 'ministrar', 'mutacao', 'propagacao', 'reducao', 'regiao', 'reuniao', 'reuter', 'suspensao', 'trafego', 'trafego', 'turistico', 'viagem', 'voo']","[1, 1, 1, 1, 1, 2, 2, 1, 1, 1, 1, 1, 1, 1, 2, 2, 1, 1, 1]","[]","[]",19,0,19,1
10697,"['apurar', 'calheiro', 'calheiro', 'comissao', 'comissao', 'comissao', 'converso', 'converso', 'dialogo', 'inquerito', 'instaurar', 'investigacao', 'jorg', 'oficialment', 'pacheco', 'pacheco', 'republico']","[1, 2, 2, 3, 3, 3, 2, 2, 1, 1, 1, 1, 1, 1, 2, 2, 1]","['verificar']","[1]",17,1,18,1
10700,"['conjuntar', 'crise', 'destacar', 'economia', 'interferencia', 'mudanca', 'necessario', 'privilegiar', 'proposto', 'quarentenar', 'republico', 'republico']","[1, 1, 1, 1, 1, 1, 1, 1, 1, 1, 2, 2]","[]","[]",12,0,12,1
10701,"['acumular', 'andrew', 'bbc', 'etapa', 'etapa', 'fase', 'imunizacao', 'imunizacao', 'liderar', 'necessario', 'respostar', 'revisar']","[1, 1, 1, 2, 2, 1, 2, 2, 1, 1, 1, 1]","[]","[]",12,0,12,1
10702,"['converso', 'dificuldad', 'preconceito']","[1, 1, 1]","[]","[]",3,0,3,1
10705,"['aspecto', 'associacao', 'crise', 'domicilio', 'equipamento', 'estatistico', 'geografia', 'ibg', 'impactar', 'impactar', 'instituto', 'levantamento', 'manutencao', 'quedo', 'reducao', 'trimestr']","[1, 1, 1, 1, 1, 1, 1, 1, 2, 2, 1, 1, 1, 1, 1, 1]","[]","[]",16,0,16,1
10707,"['alternativo', 'anteriorment', 'condicao', 'domingo', 'periodo', 'prever', 'regrar']","[1, 1, 1, 1, 1, 1, 1]","[]","[]",7,0,7,1
10708,"['ambientar', 'balancar', 'escalar', 'integrant', 'ministrar', 'necessario', 'palacio', 'palacio', 'planalto', 'planalto', 'positivar', 'positivar', 'republico', 'republico', 'secretariager', 'servidor', 'servidor', 'servidor']","[1, 1, 1, 1, 1, 1, 2, 2, 2, 2, 2, 2, 2, 2, 1, 3, 3, 3]","[]","[]",18,0,18,1
10710,"['atrasar', 'atrasar', 'atrasar', 'atrasar', 'contrato', 'contrato', 'contrato', 'contrato', 'contrato', 'contrato', 'crise', 'economia', 'economia', 'economia', 'economia', 'gued', 'gued', 'manutencao', 'ministrar', 'reforcar', 'sabado', 'sabado', 'videoconferencia']","[4, 4, 4, 4, 6, 6, 6, 6, 6, 6, 1, 4, 4, 4, 4, 2, 2, 1, 1, 1, 2, 2, 1]","[]","[]",23,0,23,1
10712,"['associacao', 'associacao', 'crise', 'decorrencia', 'levantamento', 'possibilidad']","[2, 2, 1, 1, 1, 1]","['parir']","[1]",6,1,7,1
10713,"['anticorpo']","[1]","['amigar']","[1]",1,1,2,1
10714,"['disseminacao', 'parceria', 'regiao', 'saudar', 'saudar']","[1, 1, 1, 2, 2]","[]","[]",5,0,5,1
10716,"['alternativo', 'autoridad', 'autoridad', 'coletivo', 'coletivo', 'consolidar', 'consorcio', 'consorcio', 'consorcio', 'consorcio', 'consorcio', 'consorcio', 'consorcio', 'contabilizar', 'contencao', 'destacar', 'diariament', 'diariament', 'disseminacao', 'folhar', 'funcao', 'globonew', 'humberto', 'imunizacao', 'imunizacao', 'inedito', 'iniciativo', 'intenso', 'mutacao', 'necessidad', 'precedent', 'reforcar', 'ricardo', 'saudar', 'spaulo', 'superar']","[1, 2, 2, 2, 2, 1, 7, 7, 7, 7, 7, 7, 7, 1, 1, 1, 2, 2, 1, 1, 1, 1, 1, 2, 2, 1, 1, 1, 1, 1, 1, 1, 1, 1, 1, 1]","['basto', 'checar', 'imenso', 'preencher']","[1, 1, 1, 1]",36,4,40,1
10717,"['afp', 'aliviar', 'avancar', 'contagioso', 'periodo', 'situacao', 'situacao', 'toquio', 'transmissao']","[1, 1, 1, 1, 1, 2, 2, 1, 1]","[]","[]",9,0,9,1
10718,"['condicao', 'florido', 'movimentacao', 'quilometro']","[1, 1, 1, 1]","[]","[]",4,0,4,1
10719,"['consequencia', 'crise', 'impacto', 'informaco', 'informaco', 'milho', 'necessario', 'necessidad', 'sendo']","[1, 1, 1, 2, 2, 1, 1, 1, 1]","[]","[]",9,0,9,1
10722,"['pulmonar', 'saudar', 'suportar', 'ventilatorio']","[1, 1, 1, 1]","[]","[]",4,0,4,1
10724,"['cerimonia', 'cerimonia', 'chefiar', 'chefiar', 'destacar', 'equipamento', 'justicar', 'justicar', 'mello', 'mendonca', 'mendonca', 'mendonca', 'ministrar', 'ministrar', 'palacio', 'planalto', 'republico', 'republico', 'republico', 'respiratorio', 'saudar', 'saudar', 'supremo']","[2, 2, 2, 2, 1, 1, 2, 2, 1, 3, 3, 3, 2, 2, 1, 1, 3, 3, 3, 1, 2, 2, 1]","['enderecar']","[1]",23,1,24,1
10725,"['infectar', 'quarentenar', 'respiratorio']","[1, 1, 1]","[]","[]",3,0,3,1
10726,"['aglomeracao', 'agravamento', 'avancar', 'calamidad', 'calamidad', 'decisao', 'decisao', 'europeu', 'isolar', 'mantido', 'recordar', 'regrar', 'sabado', 'saudar', 'situacao', 'situacao']","[1, 1, 1, 2, 2, 2, 2, 1, 1, 1, 1, 1, 1, 1, 2, 2]","[]","[]",16,0,16,1
10727,"['inclusao', 'inicialment', 'mudanca', 'mudanca', 'notificar', 'notificar', 'possibilidad', 'respiratorio', 'saudar', 'saudar']","[1, 1, 2, 2, 2, 2, 1, 1, 2, 2]","['imagem']","[1]",10,1,11,1
10728,"['aprovacao', 'congresso', 'demmg', 'economia', 'economia', 'ministrar', 'necessario', 'pacheco', 'prorrogar', 'quarentenar', 'republico', 'saudar']","[1, 1, 1, 2, 2, 1, 1, 1, 1, 1, 1, 1]","[]","[]",12,0,12,1
10730,"['republico', 'secom']","[1, 1]","['compartilhar']","[1]",2,1,3,1
10731,"['balancar', 'californio', 'coreia', 'espanha', 'florido', 'monitoramento']","[1, 1, 1, 1, 1, 1]","[]","[]",6,0,6,1
10733,"['calheiro', 'crise', 'depoimento', 'desenvolvido', 'exministro', 'mdbal', 'saudar', 'saudar']","[1, 1, 1, 1, 1, 1, 2, 2]","['desmentir', 'versao']","[1, 1]",8,2,10,1
10734,"['autoridad', 'colombio', 'disseminacao', 'fronteiro', 'fronteiro', 'regrar', 'sabado', 'saudar', 'saudar', 'saudar', 'superar', 'viagem']","[1, 1, 1, 2, 2, 1, 1, 3, 3, 3, 1, 1]","[]","[]",12,0,12,1
10738,"['flavio', 'gabinet', 'gabinet', 'palacio']","[1, 2, 2, 1]","[]","[]",4,0,4,1
10739,"['assistencia', 'cilindro', 'equipamento', 'ministrar', 'recurso', 'recurso', 'regiao', 'saudar', 'saudar', 'situacao']","[1, 1, 1, 1, 2, 2, 1, 2, 2, 1]","[]","[]",10,0,10,1
10744,"['ambito', 'apreensao', 'apurar', 'aspecto', 'autorizacao', 'barroso', 'barroso', 'condicao', 'congresso', 'desvio', 'desvio', 'edson', 'especialment', 'fachin', 'gabinet', 'infraestrutura', 'justicar', 'ministrar', 'ministrar', 'ministrar', 'ministrar', 'movimentacao', 'regiao', 'rejeitar', 'republico', 'subordinar', 'supremo']","[1, 1, 1, 1, 1, 2, 2, 1, 1, 2, 2, 1, 1, 1, 1, 1, 1, 4, 4, 4, 4, 1, 1, 1, 1, 1, 1]","['atribuir', 'transposicao']","[1, 1]",27,2,29,1
10751,"['acordo', 'adversario', 'expectativa', 'mantido', 'milho', 'negativa', 'proprio']","[1, 1, 1, 1, 1, 1, 1]","['solta']","[1]",7,1,8,1
10753,"['aglomeracao', 'autoridad', 'compromisso', 'comunitario', 'condicao', 'crise', 'crise', 'destacar', 'dificultar', 'estrategia', 'etapa', 'implementar', 'intenso', 'intenso', 'parceiro', 'preocupacao', 'proliferacao', 'saudar', 'situacao', 'situacao', 'situacao', 'superar', 'transmissao', 'transmissao', 'transmissao']","[1, 1, 1, 1, 1, 2, 2, 1, 1, 1, 1, 1, 2, 2, 1, 1, 1, 1, 3, 3, 3, 1, 3, 3, 3]","[]","[]",25,0,25,1
10754,"['afastamento', 'apurar', 'broadcast', 'crise', 'decisao', 'despesa', 'funcao', 'justicar', 'periodo', 'pratico', 'ritmar', 'situacao']","[1, 1, 1, 1, 1, 1, 1, 1, 1, 1, 1, 1]","['abusar', 'ganhar', 'ganhar']","[1, 2, 2]",12,3,15,1
10756,"['algun', 'funcao', 'opcao', 'risco', 'risco']","[1, 1, 1, 2, 2]","[]","[]",5,0,5,1
10757,"['carla', 'carla', 'viagem']","[2, 2, 1]","[]","[]",3,0,3,1
10761,"['balancar', 'domingo', 'domingo', 'levantamento', 'saudar', 'saudar']","[1, 2, 2, 1, 2, 2]","[]","[]",6,0,6,1
10762,"['vespera']","[1]","[]","[]",1,0,1,1
10764,"['autoridad', 'avancar', 'economia', 'equivalent', 'esforco', 'importancia', 'interino', 'interino', 'minimizar', 'ministrar', 'ministrar', 'necessario', 'necessidad', 'necessidad', 'nelson', 'panamericana', 'pastar', 'reabertura', 'reafirmar', 'reforcar', 'saudar', 'saudar', 'saudar', 'saudar', 'situacao', 'teich', 'testagem', 'testagem']","[1, 1, 1, 1, 1, 1, 2, 2, 1, 2, 2, 1, 2, 2, 1, 1, 1, 1, 1, 1, 4, 4, 4, 4, 1, 1, 2, 2]","[]","[]",28,0,28,1
10765,"['decisao', 'descumprimento', 'justicar', 'pagamento', 'renata', 'varar']","[1, 1, 1, 1, 1, 1]","[]","[]",6,0,6,1
10771,"['associacao', 'associacao', 'client', 'client', 'espirito', 'geraldo', 'imunizacao', 'iniciativo', 'privar', 'privar']","[2, 2, 2, 2, 1, 1, 1, 1, 2, 2]","[]","[]",10,0,10,1
10772,"['consorcio', 'levantamento', 'milho']","[1, 1, 1]","[]","[]",3,0,3,1
10777,"['condicao', 'economia', 'equipamento', 'especifico', 'especifico', 'federar', 'interino', 'planar', 'planar', 'plano', 'reabertura', 'reabrir', 'suportar']","[1, 1, 1, 2, 2, 1, 1, 2, 2, 1, 1, 1, 1]","['obama', 'sortir']","[1, 1]",13,2,15,1
10784,"['calculo', 'calculo', 'calculo', 'consorcio', 'diariament', 'domingo', 'domingo', 'dosar', 'dosar', 'enxergar', 'equivalent', 'escassez', 'estabilidad', 'estatistico', 'folhar', 'inconsistencia', 'iniciativo', 'notificar', 'plantao', 'quedo', 'recordar', 'recurso', 'roraima', 'saudar', 'saudar', 'spaulo', 'tendencia', 'tendencia', 'totalizar']","[3, 3, 3, 1, 1, 2, 2, 2, 2, 1, 1, 1, 1, 1, 1, 1, 1, 1, 1, 1, 1, 1, 1, 2, 2, 1, 2, 2, 1]","[]","[]",29,0,29,1
10790,"['bbc', 'desafiar']","[1, 1]","['estranhar']","[1]",2,1,3,1
10793,"['alteracao', 'facilitar', 'facilitar', 'impactar', 'importancia', 'milho', 'milho', 'observar', 'opcao', 'periodo', 'positivar', 'proliferacao', 'reforcar', 'respiratorio', 'temporada', 'temporada']","[1, 2, 2, 1, 1, 2, 2, 1, 1, 1, 1, 1, 1, 1, 2, 2]","['limao', 'verificar', 'vitaminar', 'vitaminar']","[1, 1, 2, 2]",16,4,20,1
10796,"['internar', 'sabado']","[1, 1]","[]","[]",2,0,2,1
10797,"['adicionar', 'circulacao', 'circulacao', 'companhia', 'companhia', 'crescimento', 'demandar', 'demandar', 'fluxo', 'metropolitano', 'metropolitano', 'passageiro', 'passageiro', 'passageiro', 'passageiro', 'passageiro', 'passageiro', 'passageiro', 'periodo', 'periodo', 'quarentenar', 'regiao', 'variacao', 'variacao']","[1, 2, 2, 2, 2, 1, 2, 2, 1, 2, 2, 7, 7, 7, 7, 7, 7, 7, 2, 2, 1, 1, 2, 2]","['verificar']","[1]",24,1,25,1
10798,"['crise', 'impacto', 'primario']","[1, 1, 1]","[]","[]",3,0,3,1
10800,"['alvorar', 'converso', 'decisao', 'decisao', 'investigacao', 'investigacao', 'investigacao', 'justicar', 'justicar', 'ministrar', 'motivacao', 'nomeacao', 'oliveira', 'palacio', 'ramagem', 'ramagem']","[1, 1, 2, 2, 3, 3, 3, 2, 2, 1, 1, 1, 1, 1, 2, 2]","['adelio', 'adelio', 'amigar', 'bispar', 'bispar', 'facada', 'facada']","[2, 2, 1, 2, 2, 2, 2]",16,7,23,1
10801,"['biliao', 'biliao', 'biliao', 'conformar', 'conformar', 'congresso', 'emendar', 'esforco', 'federar', 'ministrar', 'ministrar', 'ministrar', 'ministrar', 'mudanca', 'nelson', 'pastar', 'pastar', 'prioridad', 'recurso', 'recurso', 'reforcar', 'reuniao', 'saudar', 'situacao', 'teich', 'teich', 'transferir']","[3, 3, 3, 2, 2, 1, 1, 1, 1, 4, 4, 4, 4, 1, 1, 2, 2, 1, 2, 2, 1, 1, 1, 1, 2, 2, 1]","[]","[]",27,0,27,1
10804,"['academia', 'academia', 'acordo', 'aprovacao', 'contrato', 'diariament', 'funcao', 'imunizacao', 'milho', 'milho', 'plano', 'primeiroministro', 'primeiroministro', 'prioridad', 'prioridad', 'risco', 'sendo', 'sendo', 'sendo', 'tambem', 'tambem']","[2, 2, 1, 1, 1, 1, 1, 1, 2, 2, 1, 2, 2, 2, 2, 1, 3, 3, 3, 2, 2]","[]","[]",21,0,21,1
10805,"['flexibilizacao', 'individuar', 'mudanca', 'prorrogar', 'suspenso']","[1, 1, 1, 1, 1]","[]","[]",5,0,5,1
10806,"['possibilidad']","[1]","['parir']","[1]",1,1,2,1
10807,"['guarulho', 'guarulho', 'internar', 'ricardo', 'saudar']","[2, 2, 1, 1, 1]","[]","[]",5,0,5,1
10810,"['apurar', 'calamidad', 'deflagrar', 'distrito', 'distrito', 'distrito', 'emergenciai', 'enfrentamento', 'esforco', 'investigacao', 'irregularidad', 'previsto', 'regrar', 'saudar', 'saudar', 'servidor', 'situacao', 'suspeito']","[1, 1, 1, 3, 3, 3, 1, 1, 1, 1, 1, 1, 1, 2, 2, 1, 1, 1]","[]","[]",18,0,18,1
10811,"['alteracao', 'anteriorment', 'infectar', 'mudanca', 'pratico', 'saudar', 'saudar', 'situacao']","[1, 1, 1, 1, 1, 2, 2, 1]","[]","[]",8,0,8,1
10812,"['afastamento', 'amplo', 'apurar', 'atuacao', 'comissao', 'comissao', 'converso', 'converso', 'converso', 'inquerito', 'instalacao', 'instalacao', 'investigacao', 'jorg', 'ministrar', 'mudanca', 'sabado', 'supremo', 'supremo', 'supremo', 'supremo', 'vespera']","[1, 1, 1, 1, 2, 2, 3, 3, 3, 1, 2, 2, 1, 1, 1, 1, 1, 4, 4, 4, 4, 1]","['limao']","[1]",22,1,23,1
10813,"['deteccao', 'domingo', 'domingo', 'domingo', 'espanha', 'primeiroministro', 'propagacao', 'provincia', 'regiao', 'saudar', 'surtir', 'surto']","[1, 3, 3, 3, 1, 1, 1, 1, 1, 1, 1, 1]","[]","[]",12,0,12,1
10816,"['concessionario', 'equipamento', 'previsao', 'previsao', 'suportar']","[1, 1, 2, 2, 1]","['imagem']","[1]",5,1,6,1
10817,"['algun', 'condicao', 'dificuldad', 'esforco', 'exemplo', 'fez', 'minimizar', 'minimizar', 'periodo', 'proprio', 'sido', 'situacao', 'situacao', 'sociai']","[1, 1, 1, 1, 1, 1, 2, 2, 1, 1, 1, 2, 2, 1]","[]","[]",14,0,14,1
10818,"['acompanhamento', 'habito', 'importancia', 'lesao', 'positivar', 'primario', 'reforcar', 'saudar', 'saudar', 'saudar', 'saudar', 'suspeito']","[1, 1, 1, 1, 1, 1, 1, 4, 4, 4, 4, 1]","[]","[]",12,0,12,1
10820,"['alvorar', 'ambientar', 'calculo', 'comportamento', 'condicao', 'congresso', 'constituicao', 'insuficient', 'palacio', 'palacio', 'planalto', 'republico', 'republico', 'respostar', 'sabado', 'supremo']","[1, 1, 1, 1, 1, 1, 1, 1, 2, 2, 1, 2, 2, 1, 1, 1]","['espalhar', 'insinuar']","[1, 1]",16,2,18,1
10823,"['anteontem', 'associacao', 'legislativo', 'magistrado', 'presidir', 'renata']","[1, 1, 1, 1, 1, 1]","[]","[]",6,0,6,1
10825,"['congresso', 'economia', 'economia', 'extensao', 'gued', 'gued', 'manutencao', 'ministrar', 'pagamento', 'pagamento', 'situacao']","[1, 2, 2, 1, 2, 2, 1, 1, 2, 2, 1]","['vazio', 'vazio', 'vazio']","[3, 3, 3]",11,3,14,1
10826,"['augusto', 'autoridad', 'crise', 'decisao', 'importancia', 'integrant', 'minimizar', 'orientacao', 'orientacao', 'planar', 'republico', 'republico', 'saudar', 'saudar', 'saudar']","[1, 1, 1, 1, 1, 1, 1, 2, 2, 1, 2, 2, 3, 3, 3]","[]","[]",15,0,15,1
10827,"['boletim', 'condicao', 'especifico', 'intensivo', 'intensivo', 'internar', 'jorg', 'jorg', 'previsao', 'previsao', 'respostar', 'respostar']","[1, 1, 1, 2, 2, 1, 2, 2, 2, 2, 2, 2]","[]","[]",12,0,12,1
10828,"['dedicar', 'desenvolvimento', 'esperancar', 'fundamentar', 'instituto']","[1, 1, 1, 1, 1]","['boicotar']","[1]",5,1,6,1
10829,"['compromisso', 'corpu', 'forcatarefa', 'habea', 'julgamento', 'julgamento', 'jurista', 'supremo', 'triplex', 'turma', 'turma', 'varar']","[1, 1, 1, 1, 2, 2, 1, 1, 1, 2, 2, 1]","[]","[]",12,0,12,1
10838,"['acordo', 'afp', 'circulacao', 'desenvolvimento', 'mexico', 'mexico', 'mexico', 'propagacao', 'prorrogacao', 'revisar', 'trafego', 'trafego', 'turista', 'visitant']","[1, 1, 1, 1, 3, 3, 3, 1, 1, 1, 2, 2, 1, 1]","[]","[]",14,0,14,1
10840,"['apurar', 'colunista', 'colunista', 'depoimento', 'depoimento', 'instaurar', 'palacio', 'planalto', 'republicanosrj', 'reuniao']","[1, 2, 2, 2, 2, 1, 1, 1, 1, 1]","[]","[]",10,0,10,1
10842,"['administrativo', 'adversario', 'afastamento', 'afetado', 'antecipar', 'antecipar', 'antecipar', 'aprovacao', 'aprovacao', 'aprovacao', 'aspecto', 'avancar', 'bolsonarista', 'calamidad', 'calculo', 'calendario', 'comportamento', 'compromisso', 'compromisso', 'congresso', 'congresso', 'consequencia', 'desempenhar', 'desgastar', 'despesa', 'despesa', 'discussao', 'economia', 'esquema', 'estrategia', 'fabricio', 'flavia', 'flavio', 'flexibilizar', 'governista', 'gued', 'gued', 'impactar', 'inicialment', 'integrant', 'investigacao', 'justicar', 'legislativo', 'legislativo', 'levantamento', 'liderar', 'mandatario', 'martim', 'martim', 'ministrar', 'mudanca', 'necessidad', 'pagamento', 'palacio', 'parceria', 'particularment', 'planalto', 'pratico', 'pratico', 'proposto', 'queiroz', 'rachadinha', 'regiao', 'regiao', 'regiao', 'regrar', 'semestr', 'servidor', 'subir', 'suspenso', 'transferencia', 'transferencia', 'tributario', 'viagem', 'viagem', 'wilson', 'witzel', 'witzel']","[1, 1, 1, 1, 3, 3, 3, 3, 3, 3, 1, 1, 1, 1, 1, 1, 1, 2, 2, 2, 2, 1, 1, 1, 2, 2, 1, 1, 1, 1, 1, 1, 1, 1, 1, 2, 2, 1, 1, 1, 1, 1, 2, 2, 1, 1, 1, 2, 2, 1, 1, 1, 1, 1, 1, 1, 1, 2, 2, 1, 1, 1, 3, 3, 3, 1, 1, 1, 1, 1, 2, 2, 1, 2, 2, 1, 2, 2]","['atribuir', 'crer']","[1, 1]",78,2,80,1
10843,"['conflito', 'conflito', 'consultoria', 'consultoria', 'domingo', 'exministro', 'integro', 'justicar', 'quadro']","[2, 2, 2, 2, 1, 1, 1, 1, 1]","[]","[]",9,0,9,1
10848,"['advocaciager', 'autoridad', 'autoridad', 'azevedo', 'decisao', 'exonerar', 'fundamentar', 'inclusao', 'justicar', 'justicar', 'justicar', 'ministrar', 'recurso', 'recurso', 'republico']","[1, 2, 2, 1, 1, 1, 1, 1, 3, 3, 3, 1, 2, 2, 1]","['atribuir', 'atribuir']","[2, 2]",15,2,17,1
10850,"['desenvolvimento', 'fundacao', 'instalacao', 'instituto', 'instituto', 'interino', 'ministrar', 'ministrar', 'oswaldo', 'saudar', 'saudar', 'saudar', 'saudar']","[1, 1, 1, 2, 2, 1, 2, 2, 1, 4, 4, 4, 4]","[]","[]",13,0,13,1
10852,"['calendario', 'competicao', 'confederacao', 'etapa', 'etapa', 'etapa', 'etapa', 'etapa', 'etapa', 'ricardo', 'temporada', 'temporada', 'temporada', 'toquio']","[1, 1, 1, 6, 6, 6, 6, 6, 6, 1, 3, 3, 3, 1]","[]","[]",14,0,14,1
10853,"['antonio', 'crescimento', 'epidemiologico', 'fase', 'letalidad', 'obtido', 'taxar']","[1, 1, 1, 1, 1, 1, 1]","[]","[]",7,0,7,1
10854,"['alteracao', 'folhar', 'integro', 'proposto', 'provisorio']","[1, 1, 1, 1, 1]","[]","[]",5,0,5,1
10855,"['autonomia', 'autorizacao', 'confederacao', 'conflito', 'crise', 'decisao', 'enfrentamento', 'enfrentamento', 'enfrentamento', 'equipamento', 'plenario', 'previo', 'previo', 'privar', 'privar', 'privar', 'saudar', 'saudar', 'saudar', 'saudar', 'supremo', 'unanimidad']","[1, 1, 1, 1, 1, 1, 3, 3, 3, 1, 1, 2, 2, 3, 3, 3, 4, 4, 4, 4, 1, 1]","[]","[]",22,0,22,1
10860,"['atuam', 'distrito', 'intubacao', 'intubacao', 'painel', 'painel', 'previsao', 'previsao']","[1, 1, 2, 2, 2, 2, 2, 2]","[]","[]",8,0,8,1
10861,"['aglomeracao', 'avancar', 'circulacao', 'circulacao', 'decisao', 'desenvolvimento', 'discussao', 'periodo', 'periodo']","[1, 1, 2, 2, 1, 1, 1, 2, 2]","[]","[]",9,0,9,1
10862,"['aglomeracao', 'autoridad', 'condicao', 'constituicao', 'defendido', 'disseminacao', 'domingo', 'orientacao', 'saudar', 'saudar', 'saudar', 'transmissao', 'velocidad']","[1, 1, 1, 1, 1, 1, 1, 1, 3, 3, 3, 1, 1]","[]","[]",13,0,13,1
10864,"['proposto', 'requerimento']","[1, 1]","['versao']","[1]",2,1,3,1
10868,"['administrativo', 'congresso', 'desembarcar', 'economia', 'gued', 'gued', 'gued']","[1, 1, 1, 1, 3, 3, 3]","[]","[]",7,0,7,1
10869,"['cerimonia', 'exministro', 'exministro', 'exministro', 'henriqu', 'minimizar', 'ministrar', 'nelson', 'palacio', 'pastar', 'planalto', 'possibilidad', 'republico', 'saudar', 'saudar', 'teich', 'teich']","[1, 3, 3, 3, 1, 1, 1, 1, 1, 1, 1, 1, 1, 2, 2, 2, 2]","[]","[]",17,0,17,1
10870,"['academico', 'andrew', 'anuncio', 'bbc', 'conformar', 'desenvolvido', 'desenvolvido', 'dosar', 'dosar', 'dosar', 'dosar', 'dosar', 'dosar', 'dosar', 'estrategia', 'expectativa', 'hospitalizar', 'implementacao', 'imunizacao', 'infectar', 'intervalar', 'intervalar', 'intervalar', 'intervalar', 'mantido', 'ministrar', 'necessario', 'necessario', 'necessidad', 'oferecido', 'parceria', 'periodo', 'preliminar', 'realizacao', 'reforcar', 'relaxar', 'respostar', 'revisar', 'ritmar', 'saudar', 'saudar', 'sputnik', 'transmissao', 'transmissao', 'transmissao', 'transmissao', 'transmissao', 'transmissao', 'transmissao']","[1, 1, 1, 1, 1, 2, 2, 7, 7, 7, 7, 7, 7, 7, 1, 1, 1, 1, 1, 1, 4, 4, 4, 4, 1, 1, 2, 2, 1, 1, 1, 1, 1, 1, 1, 1, 1, 1, 1, 2, 2, 1, 7, 7, 7, 7, 7, 7, 7]","['disseminar', 'parir']","[1, 1]",49,2,51,1
10871,"['decisao', 'decisao', 'irregularidad', 'justicar', 'ministrar', 'plenario', 'plenario', 'privilegiar', 'republico', 'sessao']","[2, 2, 1, 1, 1, 2, 2, 1, 1, 1]","[]","[]",10,0,10,1
10873,"['etapa', 'fase', 'flexibilizacao', 'intenso', 'movimentacao', 'planar', 'sabado', 'transicao']","[1, 1, 1, 1, 1, 1, 1, 1]","[]","[]",8,0,8,1
10876,"['absoluto', 'absoluto', 'estabilidad', 'monitoramento', 'ritmar']","[2, 2, 1, 1, 1]","['gravacao']","[1]",5,1,6,1
10878,"['intensivo', 'internar', 'saudar']","[1, 1, 1]","[]","[]",3,0,3,1
10879,"['comissao', 'complicacao', 'henriqu', 'henriqu', 'periodo', 'ribeiro']","[1, 1, 2, 2, 1, 1]","[]","[]",6,0,6,1
10880,"['deslocamento', 'mexico']","[1, 1]","['imagem']","[1]",2,1,3,1
10882,"['afp', 'autoridad', 'balancar', 'comissao', 'diagnosticar', 'epicentro', 'epidemiar', 'hubei', 'hubei', 'kong', 'provincia', 'provincia', 'quarentenar', 'saudar', 'saudar']","[1, 1, 1, 1, 1, 1, 1, 2, 2, 1, 2, 2, 1, 2, 2]","[]","[]",15,0,15,1
10883,"['bruto', 'coletivo', 'crise', 'demandar', 'desenvolvimento', 'desigu', 'escalar', 'estrategico', 'fundacao', 'fundacao', 'importacao', 'importancia', 'internar', 'mudanca', 'necessidad', 'oswaldo', 'periodo', 'pib', 'planar', 'respirador', 'saudar', 'saudar', 'saudar', 'saudar', 'saudar', 'saudar', 'ventilador']","[1, 1, 1, 1, 1, 1, 1, 1, 2, 2, 1, 1, 1, 1, 1, 1, 1, 1, 1, 1, 6, 6, 6, 6, 6, 6, 1]","[]","[]",27,0,27,1
10887,"['associacao', 'epidemiar', 'extraordinario', 'organizador', 'preocupacao', 'reuter', 'salao', 'salao', 'salao', 'surtir']","[1, 1, 1, 1, 1, 1, 3, 3, 3, 1]","[]","[]",10,0,10,1
10893,"['distant', 'infectar', 'isolar', 'isolar', 'piorar', 'positivar', 'preocupacao']","[1, 1, 2, 2, 1, 1, 1]","['compartilhar']","[1]",7,1,8,1
10894,"['margem']","[1]","[]","[]",1,0,1,1
10899,"['anteontem', 'anteontem', 'crescimento', 'crescimento', 'decorrencia', 'ritmar', 'ritmar', 'subir']","[2, 2, 2, 2, 1, 2, 2, 1]","[]","[]",8,0,8,1
10900,"['atrasar', 'contemplar', 'estrategia', 'logistico', 'logistico', 'logistico', 'ministrar', 'mudanca', 'palacio', 'planalto', 'previsao', 'saudar']","[1, 1, 1, 3, 3, 3, 1, 1, 1, 1, 1, 1]","['atribuir']","[1]",12,1,13,1
10901,"['avancar', 'companhia', 'feriar', 'intervalar', 'normalment', 'passageiro', 'passageiro', 'patamar', 'percepcao', 'quilometro', 'trafego']","[1, 1, 1, 1, 1, 2, 2, 1, 1, 1, 1]","['motorista']","[1]",11,1,12,1
10906,"['apurar', 'inclusao', 'prioritario', 'prioritario', 'regiao', 'ritmar', 'saudar', 'ufrj']","[1, 1, 2, 2, 1, 1, 1, 1]","[]","[]",8,0,8,1
10907,"['enfermagem', 'enfermagem', 'enfermagem', 'enfermagem']","[4, 4, 4, 4]","[]","[]",4,0,4,1
10908,"['boletim', 'europeu', 'infectar', 'intensivo', 'internar', 'totalizar']","[1, 1, 1, 1, 1, 1]","[]","[]",6,0,6,1
10911,"['edson', 'ministrar', 'recordar', 'republico']","[1, 1, 1, 1]","[]","[]",4,0,4,1
10912,"['emendar', 'legislativo', 'preconceito', 'presenca', 'renata', 'renata', 'renata', 'souza']","[1, 1, 1, 1, 3, 3, 3, 1]","['faccao', 'insinuar']","[1, 1]",8,2,10,1
10917,"['desenvolvimento', 'economia', 'estrategia', 'gued', 'gued', 'imunizacao', 'organizado', 'queiroga', 'tambem']","[1, 1, 1, 2, 2, 1, 1, 1, 1]","[]","[]",9,0,9,1
10919,"['biliao', 'cupula', 'folhar', 'integro', 'journal', 'journal', 'nelson', 'proposto']","[1, 1, 1, 1, 2, 2, 1, 1]","[]","[]",8,0,8,1
10921,"['agravamento', 'previsto', 'sociai']","[1, 1, 1]","[]","[]",3,0,3,1
10922,"['alvorar', 'contabilizar', 'folhar', 'oficialment', 'palacio', 'patamar', 'recordar', 'sabado', 'spaulo', 'subir', 'superar']","[1, 1, 1, 1, 1, 1, 1, 1, 1, 1, 1]","['atribuir']","[1]",11,1,12,1
10925,"['comparacao', 'contabilizar', 'contabilizar', 'deteccao', 'reducao', 'saudar', 'superar']","[1, 2, 2, 1, 1, 1, 1]","[]","[]",7,0,7,1
10926,"['anteriorment', 'anuncio', 'michael']","[1, 1, 1]","['filmar', 'filmar', 'filmar']","[3, 3, 3]",3,3,6,1
10927,"['afastam', 'apoio', 'apoio', 'atuam', 'bruno', 'celso', 'embora', 'etapa', 'jantar', 'milho', 'none', 'parcela', 'pereira', 'pereira', 'pereira', 'precandidato', 'preocupacao', 'proximo', 'resistencia', 'servido', 'sociai', 'tucano']","[1, 2, 2, 1, 1, 1, 1, 1, 1, 1, 1, 1, 3, 3, 3, 1, 1, 1, 1, 1, 1, 1]","[]","[]",22,0,22,1
10929,"['estimativo', 'quedo', 'quedo', 'regiao', 'regiao', 'respostar', 'saudar', 'situacao', 'situacao', 'situacao', 'taxar', 'tendencia', 'tendencia', 'transmissao', 'transmissao']","[1, 2, 2, 2, 2, 1, 1, 3, 3, 3, 1, 2, 2, 2, 2]","[]","[]",15,0,15,1
10932,"['saudar']","[1]","['circular', 'compartilhar', 'realment', 'verdadeiro', 'verdadeiro']","[1, 1, 1, 2, 2]",1,5,6,1
10933,"['condicao', 'flavio', 'internar', 'internar', 'positivar', 'prever']","[1, 1, 2, 2, 1, 1]","[]","[]",6,0,6,1
10935,"['comissao', 'demandar', 'desigualdad', 'esperancar', 'estatistico', 'europeu', 'europeu', 'fronteiro', 'humanitario', 'pratico', 'respostar', 'saudar', 'saudar', 'suspensao']","[1, 1, 1, 1, 1, 2, 2, 1, 1, 1, 1, 2, 2, 1]","['realment']","[1]",14,1,15,1
10936,"['desembarcar', 'desembarcar', 'especialment', 'infraestrutura', 'passageiro', 'passageiro', 'passageiro', 'transmissao', 'tripulacao']","[2, 2, 1, 1, 3, 3, 3, 1, 1]","[]","[]",9,0,9,1
10937,"['antonio', 'decisao', 'fase', 'henriqu', 'internar', 'planar', 'saudar']","[1, 1, 1, 1, 1, 1, 1]","[]","[]",7,0,7,1
10938,"['arthur', 'arthur', 'aurelio', 'constituicao', 'converso', 'lira', 'lira', 'mello', 'ministrar', 'necessario', 'planalto', 'ppal', 'presidir', 'presidir', 'privar', 'republico', 'republico', 'republico', 'republico', 'supremo', 'supremo', 'supremo', 'supremo']","[2, 2, 1, 1, 1, 2, 2, 1, 1, 1, 1, 1, 2, 2, 1, 4, 4, 4, 4, 4, 4, 4, 4]","[]","[]",23,0,23,1
10947,"['antonio', 'anvisa', 'anvisa', 'aplicacao', 'diretoria', 'estrategico', 'interrupcao', 'jorg', 'ministrar', 'nelson', 'pastar', 'saudar', 'saudar', 'secretarioexecutivo', 'teich', 'vigilancia']","[1, 2, 2, 1, 1, 1, 1, 1, 1, 1, 1, 2, 2, 1, 1, 1]","['basto']","[1]",16,1,17,1
10948,"['boletim', 'consorcio', 'fundacao', 'investigacao', 'ritmar', 'saudar', 'saudar', 'situacao', 'totalizar', 'vigilancia']","[1, 1, 1, 1, 1, 2, 2, 1, 1, 1]","[]","[]",10,0,10,1
10950,"['academiar', 'academiar', 'academiar', 'academiar', 'distrito', 'quarentenar', 'saudar', 'saudar']","[4, 4, 4, 4, 1, 1, 2, 2]","['caixao', 'caixao', 'sequer', 'telejorn']","[2, 2, 1, 1]",8,4,12,1
10957,"['acordo', 'confirmado', 'edson', 'impacto', 'oficialment', 'tambem']","[1, 1, 1, 1, 1, 1]","[]","[]",6,0,6,1
10959,"['afastamento', 'afastamento', 'afastamento', 'afastamento', 'aprovacao', 'levantamento', 'levantamento', 'margem', 'margem', 'presenciar', 'sabado', 'superar', 'taxar']","[4, 4, 4, 4, 1, 2, 2, 2, 2, 1, 1, 1, 1]","['numericament']","[1]",13,1,14,1
10960,"['anteriorment', 'assistencia', 'autoridad', 'decisao', 'distrito', 'economia', 'gued', 'ministrar', 'periodo', 'possibilidad', 'reajustar', 'reajustar', 'saudar', 'saudar', 'servidor', 'servidor', 'urbano', 'vetar', 'vetar', 'vetar']","[1, 1, 1, 1, 1, 1, 1, 1, 1, 1, 2, 2, 2, 2, 2, 2, 1, 3, 3, 3]","[]","[]",20,0,20,1
10962,"['arrecadacao', 'arrecadar', 'client', 'especialment', 'lancamento', 'quedo', 'respectivament']","[1, 1, 1, 1, 1, 1, 1]","[]","[]",7,0,7,1
10963,"['agravar', 'dengu', 'dengu', 'domingo', 'domingo', 'escalar', 'hipertensao', 'infectar', 'internar', 'internar', 'rocha', 'saudar', 'saudar']","[1, 2, 2, 2, 2, 1, 1, 1, 2, 2, 1, 2, 2]","[]","[]",13,0,13,1
10966,"['anuncio', 'desenvolvido', 'folhar', 'instituto', 'instituto', 'integro']","[1, 1, 1, 2, 2, 1]","[]","[]",6,0,6,1
10967,"['afetado', 'autoridad', 'biliao', 'circulacao', 'companhia', 'companhia', 'destacar', 'flexibilizar', 'impacto', 'impacto', 'intervalar', 'observar', 'periodo', 'quedo', 'recuar', 'reportar', 'significativo', 'significativo', 'trimestr', 'trimestr', 'trimestr', 'trimestr', 'trimestr']","[1, 1, 1, 1, 2, 2, 1, 1, 2, 2, 1, 1, 1, 1, 1, 1, 2, 2, 5, 5, 5, 5, 5]","[]","[]",23,0,23,1
10974,"['alvorar', 'alvorar', 'calculo', 'calculo', 'calculo', 'calculo', 'palacio', 'palacio', 'planalto', 'republico']","[2, 2, 4, 4, 4, 4, 2, 2, 1, 1]","[]","[]",10,0,10,1
10981,"['companhia', 'integrant', 'investigacao', 'sindicato', 'sindicato', 'sindicato', 'suspensao']","[1, 1, 1, 3, 3, 3, 1]","['compartilhar', 'supostament']","[1, 1]",7,2,9,1
10982,"['autoridad', 'companhia', 'competicao', 'periodo', 'quarentenar']","[1, 1, 1, 1, 1]","[]","[]",5,0,5,1
10984,"['conformar', 'economia', 'economia', 'economia', 'especialment', 'impacto', 'impulsionar', 'impulsionar', 'impulsionar', 'prazo', 'provincia', 'reuter', 'tendencia', 'xinhua']","[1, 3, 3, 3, 1, 1, 3, 3, 3, 1, 1, 1, 1, 1]","[]","[]",14,0,14,1
10986,"['ambientar', 'colegio', 'presenciar']","[1, 1, 1]","[]","[]",3,0,3,1
10987,"[]","[]","[]","[]",0,0,0,1
10990,"['acordo', 'parcela', 'sabado']","[1, 1, 1]","['inscricao']","[1]",3,1,4,1
10991,"['boletim', 'consorcio', 'domingo', 'infectar', 'saudar']","[1, 1, 1, 1, 1]","[]","[]",5,0,5,1
10992,"['bandeirant', 'calculo', 'comparacao', 'consecutivo', 'consorcio', 'consorcio', 'epidemiologico', 'estabilidad', 'palacio', 'periodo', 'variacao']","[1, 1, 1, 1, 2, 2, 1, 1, 1, 1, 1]","[]","[]",11,0,11,1
10994,"['hospitalizar', 'infectar', 'prever', 'prever', 'respostar', 'respostar', 'saudar']","[1, 1, 2, 2, 2, 2, 1]","['realment']","[1]",7,1,8,1
10995,"['aplicacao', 'armazenamento', 'enfatizar', 'especifico', 'exercicio', 'facilitar', 'folhar', 'habito', 'habito', 'mergulhar', 'periodo', 'pratico', 'previsao', 'saudar', 'saudar', 'transmissao']","[1, 1, 1, 1, 1, 1, 1, 2, 2, 1, 1, 1, 1, 2, 2, 1]","['camiseta', 'compartilhar', 'pelar', 'pelar', 'pelar', 'pelar', 'pelar', 'pelar', 'pelar', 'pelar', 'sapato', 'suco', 'suco', 'suco', 'vitaminar', 'vitaminar']","[1, 1, 8, 8, 8, 8, 8, 8, 8, 8, 1, 3, 3, 3, 2, 2]",16,16,32,1
10996,"['atuacao', 'especialment', 'impactar', 'integro', 'julgamento', 'plenario', 'supremo']","[1, 1, 1, 1, 1, 1, 1]","[]","[]",7,0,7,1
10997,"['fase', 'fase', 'flexibilizacao', 'flexibilizacao', 'intubacao', 'porqu', 'quadro', 'reducao', 'relaxamento', 'risco', 'transicao', 'transicao', 'transmissao', 'transmissao', 'ultimo']","[2, 2, 2, 2, 1, 1, 1, 1, 1, 1, 2, 2, 2, 2, 1]","[]","[]",15,0,15,1
10998,"['bbc', 'crescimento', 'enquadrar', 'ministrar', 'nelson', 'oficialment', 'saudar', 'saudar', 'saudar', 'situacao', 'teich']","[1, 1, 1, 1, 1, 1, 3, 3, 3, 1, 1]","['verificacao']","[1]",11,1,12,1
10999,"['bandeirant', 'exministro', 'iniciativo', 'integrant', 'saudar', 'sessao', 'sobretudo', 'subir', 'universitario']","[1, 1, 1, 1, 1, 1, 1, 1, 1]","['bispar', 'catolico', 'catolico', 'humanar', 'humanar', 'humanar', 'torturar', 'torturar']","[1, 2, 2, 3, 3, 3, 2, 2]",9,8,17,1
11000,"['ambientar', 'batalhar', 'desafio', 'domingo', 'palacio']","[1, 1, 1, 1, 1]","[]","[]",5,0,5,1
11001,"['crise', 'economia', 'economia', 'gued', 'ministrar', 'proposto', 'saudar']","[1, 2, 2, 1, 1, 1, 1]","[]","[]",7,0,7,1
11002,"['deteccao', 'estatistico', 'instituto', 'internar', 'necessidad', 'respiratorio', 'respiratorio', 'respiratorio', 'sigla', 'suspeito']","[1, 1, 1, 1, 1, 3, 3, 3, 1, 1]","['gravacao']","[1]",10,1,11,1
11005,"['apurar', 'bolsonarista', 'coletivo', 'eventualment', 'inquerito', 'regrar']","[1, 1, 1, 1, 1, 1]","['postagen', 'vazar', 'vazar']","[1, 2, 2]",6,3,9,1
11006,"['apurar', 'depoimento', 'depoimento', 'flavio', 'flavio', 'gabinet', 'investigacao', 'investigacao', 'marinhar']","[1, 2, 2, 2, 2, 1, 2, 2, 1]","[]","[]",9,0,9,1
11007,"['alvorar', 'alvorar', 'apostar', 'celso', 'guaruja', 'integro', 'palacio', 'respectivament']","[2, 2, 1, 1, 1, 1, 1, 1]","[]","[]",8,0,8,1
11011,"['augusto', 'constituicao', 'corpu', 'depoimento', 'depoimento', 'edson', 'fachin', 'fachin', 'habea', 'inquerito', 'inquerito', 'investigacao', 'investigacao', 'justicar', 'mendonca', 'ministrar', 'ministrar', 'ministrar', 'ministrar', 'necessario', 'prever', 'republico', 'supremo', 'suspenso']","[1, 1, 1, 2, 2, 1, 2, 2, 1, 2, 2, 2, 2, 1, 1, 4, 4, 4, 4, 1, 1, 1, 1, 1]","['sequer']","[1]",24,1,25,1
11013,"['adversario', 'alcolumbr', 'consultoria', 'demap', 'demmg', 'especializar', 'legislativo', 'levantamento', 'oposto', 'pacheco', 'pacheco', 'pacheco', 'periodo', 'proposto', 'proposto', 'proposto', 'regrar', 'sigla']","[1, 1, 1, 1, 1, 1, 1, 1, 1, 3, 3, 3, 1, 3, 3, 3, 1, 1]","['legendar']","[1]",18,1,19,1
11014,"['infectar', 'ministrar', 'necessidad', 'respiratorio', 'saudar', 'saudar', 'surtir']","[1, 1, 1, 1, 2, 2, 1]","[]","[]",7,0,7,1
11016,"['compromisso', 'converso', 'crise', 'dificuldad', 'interpretar', 'videoconferencia']","[1, 1, 1, 1, 1, 1]","[]","[]",6,0,6,1
11018,"['plano', 'recurso', 'recurso', 'rejeitar']","[1, 2, 2, 1]","['fraudar']","[1]",4,1,5,1
11021,"['congresso', 'contrato', 'crise', 'elaborar', 'periodo', 'reuniao', 'ricardo', 'situacao', 'sugestao', 'suspensao', 'suspensao', 'temporario']","[1, 1, 1, 1, 1, 1, 1, 1, 1, 2, 2, 1]","[]","[]",12,0,12,1
11022,"['aglomeracao', 'amplo', 'anteriorment', 'anticorpo', 'anticorpo', 'anvisa', 'circulacao', 'demandar', 'deteccao', 'disseminacao', 'escalar', 'estrategia', 'estrategia', 'extensao', 'higienizacao', 'isolar', 'ministrar', 'ministrar', 'ministrar', 'ministrar', 'ministrar', 'molecular', 'montant', 'necessario', 'nelson', 'obtido', 'orientacao', 'panamericana', 'pastar', 'pastar', 'pastar', 'pastar', 'pastar', 'periodo', 'periodo', 'possibilidad', 'prazo', 'presenca', 'prioridad', 'privar', 'privar', 'queiroga', 'queiroga', 'queiroga', 'recordar', 'recurso', 'reuniao', 'sabado', 'saudar', 'saudar', 'saudar', 'saudar', 'saudar', 'saudar', 'saudar', 'saudar', 'saudar', 'saudar', 'saudar', 'saudar', 'saudar', 'saudar', 'subir', 'suprimento', 'teich', 'testagem', 'testagem', 'testagem', 'triagem', 'velocidad', 'vencimento', 'vencimento', 'vigilancia', 'volumar', 'wellington']","[1, 1, 1, 2, 2, 1, 1, 1, 1, 1, 1, 2, 2, 1, 1, 1, 5, 5, 5, 5, 5, 1, 1, 1, 1, 1, 1, 1, 5, 5, 5, 5, 5, 2, 2, 1, 1, 1, 1, 2, 2, 3, 3, 3, 1, 1, 1, 1, 14, 14, 14, 14, 14, 14, 14, 14, 14, 14, 14, 14, 14, 14, 1, 1, 1, 3, 3, 3, 1, 1, 2, 2, 1, 1, 1]","['bandeiro', 'verificar']","[1, 1]",75,2,77,1
11023,"['certeza', 'processo', 'processo']","[1, 2, 2]","[]","[]",3,0,3,1
11025,"['espanha', 'extensao', 'pedido', 'previsao', 'previsto', 'processo', 'voo']","[1, 1, 1, 1, 1, 1, 1]","['cocaina', 'trafico', 'trafico']","[1, 2, 2]",7,3,10,1
11027,"[]","[]","[]","[]",0,0,0,1
11028,"['cenario', 'comorbidad', 'constatar', 'crescimento', 'curvo', 'curvo', 'infectar', 'quedo', 'reabertura', 'recurso', 'situacao', 'totalizar']","[1, 1, 1, 1, 2, 2, 1, 1, 1, 1, 1, 1]","['vazio']","[1]",12,1,13,1
11030,"['adotada', 'biliao', 'crise', 'determinacao', 'dificuldad', 'economia', 'fluxo', 'logistico', 'margem', 'modelo', 'respostar', 'taxar']","[1, 1, 1, 1, 1, 1, 1, 1, 1, 1, 1, 1]","[]","[]",12,0,12,1
11031,"['afetado', 'cenario', 'decorrencia', 'extensao', 'impactar', 'interrupcao', 'modelo', 'reducao', 'rotina', 'saudar', 'saudar', 'transmissao']","[1, 1, 1, 1, 1, 1, 1, 1, 1, 2, 2, 1]","[]","[]",12,0,12,1
11034,"['adulto', 'afetado', 'boletim', 'comparacao', 'epidemiologico', 'fundacao', 'intensivo', 'internacao', 'internacao', 'internacao', 'internacao', 'internacao', 'mudanca']","[1, 1, 1, 1, 1, 1, 1, 5, 5, 5, 5, 5, 1]","[]","[]",13,0,13,1
11038,"['presenca', 'regiao', 'regiao', 'sudest', 'sudest']","[1, 2, 2, 2, 2]","['imagem']","[1]",5,1,6,1
11041,"['aglomeracao', 'arrecadar', 'arrecadar', 'iniciativo', 'jorg', 'recordar', 'transmissao', 'transmissao']","[1, 2, 2, 1, 1, 1, 2, 2]","['vazar', 'visualizacao']","[1, 1]",8,2,10,1
11042,"['autonomia', 'comissao', 'decisao', 'decisao', 'decisao', 'decisao', 'determinacao', 'enfrentamento', 'equipamento', 'especifico', 'especifico', 'federar', 'federar', 'implementar', 'interino', 'ministrar', 'observacao', 'observacao', 'republico', 'saudar', 'supremo']","[1, 1, 4, 4, 4, 4, 1, 1, 1, 2, 2, 2, 2, 1, 1, 1, 2, 2, 1, 1, 1]","['realment']","[1]",21,1,22,1
11044,"['notificar', 'sabado', 'saudar', 'saudar', 'vigilancia']","[1, 1, 2, 2, 1]","[]","[]",5,0,5,1
11047,"['associacao', 'pagamento', 'pagamento', 'reducao', 'reducao', 'reducao', 'temporada', 'temporada', 'vencimento']","[1, 2, 2, 3, 3, 3, 2, 2, 1]","[]","[]",9,0,9,1
11048,"['acompanhamento', 'adotada', 'diariament', 'domingo', 'domingo', 'domingo', 'equipamento', 'esforco', 'iniciativo', 'necessario', 'necessidad', 'parceria', 'pulmonar', 'recurso', 'saudar', 'saudar', 'saudar', 'saudar', 'saudar', 'saudar', 'ventilador']","[1, 1, 1, 3, 3, 3, 1, 1, 1, 1, 1, 1, 1, 1, 6, 6, 6, 6, 6, 6, 1]","[]","[]",21,0,21,1
11049,"['autoridad', 'relativo']","[1, 1]","[]","[]",2,0,2,1
11051,"['aglomeracao', 'converso', 'especialment', 'flavio', 'mandatario', 'observar', 'preced', 'reuniao', 'saudar']","[1, 1, 1, 1, 1, 1, 1, 1, 1]","['imagem']","[1]",9,1,10,1
11053,"['consequencia', 'contrato', 'decisao', 'decisao', 'inquerito', 'investigacao', 'obtido', 'recurso', 'regiao', 'remessar']","[1, 1, 2, 2, 1, 1, 1, 1, 1, 1]","[]","[]",10,0,10,1
11055,"['calamidad', 'calamidad', 'congresso', 'crescimento', 'extensao', 'extraordinario', 'integrant', 'orcamentaria', 'possibilidad', 'pratico', 'primario', 'recurso', 'recurso', 'regrar', 'regrar', 'reuniao', 'reuniao', 'tcu']","[2, 2, 1, 1, 1, 1, 1, 1, 1, 1, 1, 2, 2, 2, 2, 2, 2, 1]","[]","[]",18,0,18,1
11072,"['edson']","[1]","[]","[]",1,0,1,1
11073,"['conflito', 'constituicao', 'interferencia', 'interferencia', 'palacio', 'planalto', 'republico', 'respostar']","[1, 1, 2, 2, 1, 1, 1, 1]","['filmar', 'realment', 'verdadeiro']","[1, 1, 1]",8,3,11,1
11077,"['adotada', 'boletim', 'circulacao', 'consorcio', 'consorcio', 'crescimento', 'curvo', 'justificativo', 'precedent', 'regiao', 'regrar', 'relaxamento', 'saudar']","[1, 1, 1, 2, 2, 1, 1, 1, 1, 1, 1, 1, 1]","[]","[]",13,0,13,1
11080,"['agravar', 'alteracao', 'carla', 'carla', 'consenso', 'consequencia', 'consequencia', 'crescimento', 'crescimento', 'cronica', 'diariament', 'diariament', 'especifico', 'exercicio', 'habito', 'infectar', 'lavagem', 'nogueira', 'observar', 'processo', 'processo', 'quedo', 'quedo', 'quedo', 'quedo', 'quedo', 'quedo', 'quedo', 'quedo', 'quedo', 'reducao', 'reducao', 'saudar']","[1, 1, 2, 2, 1, 2, 2, 2, 2, 1, 2, 2, 1, 1, 1, 1, 1, 1, 1, 2, 2, 9, 9, 9, 9, 9, 9, 9, 9, 9, 2, 2, 1]","['pelar', 'vitaminar', 'vitaminar', 'zincar']","[1, 2, 2, 1]",33,4,37,1
11081,"['advocaciager', 'celso', 'exministro', 'inquerito', 'interferencia', 'justicar', 'levantamento', 'ministrar', 'oficialment', 'republico', 'reuniao', 'supremo']","[1, 1, 1, 1, 1, 1, 1, 1, 1, 1, 1, 1]","[]","[]",12,0,12,1
11082,"['antecipar', 'celebrar', 'jorg', 'transferir']","[1, 1, 1, 1]","[]","[]",4,0,4,1
11085,"['diagnosticar', 'diagnosticar', 'fase', 'fase', 'internar', 'internar', 'internar', 'lesao', 'recuperacao', 'sessao', 'transicao']","[2, 2, 2, 2, 3, 3, 3, 1, 1, 1, 1]","['espalhar', 'estomago', 'estomago', 'estomago']","[1, 3, 3, 3]",11,4,15,1
11087,"['adversario', 'adversario', 'calculo', 'despesa', 'despesa', 'equivalent', 'equivalent', 'justicar', 'obtido', 'tucano']","[2, 2, 1, 2, 2, 2, 2, 1, 1, 1]","[]","[]",10,0,10,1
11090,"['autorizacao', 'autorizacao', 'quatro']","[2, 2, 1]","['instrucao']","[1]",3,1,4,1
11091,"['adhanom', 'afetado', 'afp', 'afp', 'afp', 'afp', 'afp', 'afp', 'afp', 'afp', 'afp', 'afp', 'afp', 'afp', 'afp', 'afp', 'afp', 'afp', 'afp', 'afp', 'afp', 'afp', 'antonio', 'californio', 'celebrar', 'cerimonia', 'checo', 'cirurgico', 'client', 'companhia', 'convencao', 'desafio', 'desembarcar', 'diagnosticar', 'disseminacao', 'disseminacao', 'distrito', 'epicentro', 'epidemiar', 'epidemiar', 'epidemiar', 'epidemiar', 'epidemiar', 'espanha', 'espanha', 'externo', 'funcao', 'guarulho', 'guarulho', 'guarulho', 'hubei', 'infectar', 'infectar', 'infectar', 'infectar', 'instalacao', 'integrant', 'integrant', 'internar', 'isolar', 'isolar', 'kong', 'kong', 'kong', 'kong', 'kong', 'kong', 'liderar', 'mexico', 'mexico', 'movimentacao', 'orientacao', 'palacio', 'passageiro', 'passageiro', 'passageiro', 'passageiro', 'passageiro', 'passageiro', 'passageiro', 'passageiro', 'passageiro', 'passageiro', 'positivar', 'positivar', 'preocupacao', 'preocupacao', 'propagacao', 'provincia', 'provincia', 'quarentenar', 'quarentenar', 'regiao', 'reuter', 'reuter', 'reuter', 'reuter', 'reuter', 'reuter', 'reuter', 'reuter', 'reuter', 'reuter', 'reuter', 'reuter', 'reuter', 'reuter', 'reuter', 'reuter', 'reuter', 'reuter', 'rocha', 'saudar', 'saudar', 'surtir', 'surtir', 'surtir', 'surtir', 'suspeito', 'suspeito', 'suspensao', 'suspensao', 'tedro', 'toquio', 'toquio', 'transferir', 'transferir', 'transmissao', 'transmissao', 'transmissao', 'tripulacao', 'turistico', 'velocidad', 'visitant', 'visitant', 'visitant', 'xinhua', 'xinhua', 'xinhua', 'xinhua', 'xinhua', 'xinhua', 'xinhua', 'xinhua']","[1, 1, 20, 20, 20, 20, 20, 20, 20, 20, 20, 20, 20, 20, 20, 20, 20, 20, 20, 20, 20, 20, 1, 1, 1, 1, 1, 1, 1, 1, 1, 1, 1, 1, 2, 2, 1, 1, 5, 5, 5, 5, 5, 2, 2, 1, 1, 3, 3, 3, 1, 4, 4, 4, 4, 1, 2, 2, 1, 2, 2, 6, 6, 6, 6, 6, 6, 1, 2, 2, 1, 1, 1, 10, 10, 10, 10, 10, 10, 10, 10, 10, 10, 2, 2, 2, 2, 1, 2, 2, 2, 2, 1, 18, 18, 18, 18, 18, 18, 18, 18, 18, 18, 18, 18, 18, 18, 18, 18, 18, 18, 1, 2, 2, 4, 4, 4, 4, 2, 2, 2, 2, 1, 2, 2, 2, 2, 3, 3, 3, 1, 1, 1, 3, 3, 3, 8, 8, 8, 8, 8, 8, 8, 8]","['parir', 'parir', 'parir', 'torrar', 'usuario', 'vazio', 'vazio', 'verificar']","[3, 3, 3, 1, 1, 2, 2, 1]",144,8,152,1
11093,"['assistencia', 'atuacao', 'autoridad', 'biliao', 'contemplar', 'demandar', 'diariament', 'dificultar', 'distrito', 'enfrentamento', 'estimativo', 'insuficient', 'presenca', 'primario', 'recurso', 'recurso', 'saudar', 'saudar', 'saudar', 'saudar', 'saudar', 'saudar', 'saudar', 'situacao', 'vulnerabilidad']","[1, 1, 1, 1, 1, 1, 1, 1, 1, 1, 1, 1, 1, 1, 2, 2, 7, 7, 7, 7, 7, 7, 7, 1, 1]","['espalhar']","[1]",25,1,26,1
11095,"['ambientar', 'converso', 'exjuiz', 'exministro', 'exministro', 'instituto', 'justicar', 'ministrar', 'recurso']","[1, 1, 1, 2, 2, 1, 1, 1, 1]","['versao']","[1]",9,1,10,1
11096,"['afastamento', 'afastamento', 'calendario', 'desgastar', 'impactar', 'incerteza', 'independentement', 'inedito', 'legislativo', 'limitacao', 'nelson', 'possibilidad', 'prazo', 'precandidato', 'tucano', 'vespera']","[2, 2, 1, 1, 1, 1, 1, 1, 1, 1, 1, 1, 1, 1, 1, 1]","['imagem']","[1]",16,1,17,1
11101,"['augusto', 'aurelio', 'decisao', 'fabricio', 'flavio', 'integro', 'investigacao', 'investigacao', 'mello', 'ministrar', 'normalment', 'queiroz', 'rachadinha', 'rejeicao', 'republicanosrj', 'republico', 'supremo']","[1, 1, 1, 1, 1, 1, 2, 2, 1, 1, 1, 1, 1, 1, 1, 1, 1]","['arquivar']","[1]",17,1,18,1
11103,"['enxergar', 'iniciativo', 'jantar', 'jantar', 'jornada', 'quilometro', 'souza']","[1, 1, 2, 2, 1, 1, 1]","['lixar', 'suco']","[1, 1]",7,2,9,1
11104,"['aspecto', 'espanha', 'privar']","[1, 1, 1]","[]","[]",3,0,3,1
11107,"['congresso', 'integrant', 'justificativo', 'legislativo', 'proposto', 'republico']","[1, 1, 1, 1, 1, 1]","[]","[]",6,0,6,1
11108,"['anvisa', 'biliao', 'decisao', 'desenvolvido', 'fundacao', 'medeiro', 'oswaldo', 'prever', 'reafirmar', 'realizacao', 'saudar', 'saudar', 'saudar', 'vigilancia', 'vigilancia']","[1, 1, 1, 1, 1, 1, 1, 1, 1, 1, 3, 3, 3, 2, 2]","[]","[]",15,0,15,1
11110,"[]","[]","['rompimento']","[1]",0,1,1,1
11112,"['balancar', 'sabado', 'saudar']","[1, 1, 1]","[]","[]",3,0,3,1
11113,"['acompanhamento', 'ambientar', 'anteriorment', 'anuncio', 'anvisa', 'anvisa', 'anvisa', 'aprovacao', 'assintomatico', 'assistencia', 'atrasar', 'autoridad', 'destacar', 'diariament', 'domingo', 'hospitalizacao', 'hospitalizacao', 'infectar', 'instituto', 'instituto', 'painel', 'palacio', 'presenca', 'reafirmar', 'ricardo', 'saudar', 'taxar', 'taxar', 'vigilancia']","[1, 1, 1, 1, 3, 3, 3, 1, 1, 1, 1, 1, 1, 1, 1, 2, 2, 1, 2, 2, 1, 1, 1, 1, 1, 1, 2, 2, 1]","['circular']","[1]",29,1,30,1
11115,"['aglomeracao', 'ambientar', 'amplo', 'conjuntar', 'consumidor', 'demandar', 'especializar', 'funcionamento', 'metropolitano', 'metropolitano', 'metropolitano', 'passageiro', 'passageiro', 'prazo', 'regiao', 'regiao', 'respostar']","[1, 1, 1, 1, 1, 1, 1, 1, 3, 3, 3, 2, 2, 1, 2, 2, 1]","['circular']","[1]",17,1,18,1
11117,"['argumentar', 'hipertensao', 'justicar', 'monitoramento', 'mudanca', 'necessario', 'supremo']","[1, 1, 1, 1, 1, 1, 1]","['trafico']","[1]",7,1,8,1
11119,"['atrasar', 'atrasar', 'augusto', 'autoridad', 'decisao', 'enfermagem', 'equipamento', 'funcao', 'necessario', 'pagamento', 'recurso', 'respostar', 'respostar', 'saudar', 'saudar', 'saudar', 'saudar', 'saudar', 'saudar', 'suspenso']","[2, 2, 1, 1, 1, 1, 1, 1, 1, 1, 1, 2, 2, 6, 6, 6, 6, 6, 6, 1]","['basto', 'greve']","[1, 1]",20,2,22,1
11121,"['academiar', 'competicao', 'florido', 'previsto', 'quarentenar', 'ritmar', 'tornear', 'transmissao']","[1, 1, 1, 1, 1, 1, 1, 1]","[]","[]",8,0,8,1
11124,"['acompanhamento', 'ambito', 'apurar', 'comissao', 'contrato', 'contrato', 'contrato', 'destinar', 'enfrentamento', 'externo', 'federar', 'fornecimento', 'inconsistencia', 'instituto', 'pastar', 'suspeito', 'tcu', 'totalizar', 'universitario']","[1, 1, 1, 1, 3, 3, 3, 1, 1, 1, 1, 1, 1, 1, 1, 1, 1, 1, 1]","[]","[]",19,0,19,1
11127,"['afp', 'europeu', 'logistico', 'logistico', 'portavoz', 'semestr', 'semestr', 'volumar']","[1, 1, 2, 2, 1, 2, 2, 1]","[]","[]",8,0,8,1
11129,"['adicionar', 'ausencia', 'reabrir', 'reuniao', 'visitant']","[1, 1, 1, 1, 1]","['checagem', 'verificar']","[1, 1]",5,2,7,1
11134,"['acordo', 'acordo', 'avanca', 'boletim', 'calculo', 'cenario', 'colleg', 'colleg', 'colleg', 'consorcio', 'destaca', 'levantamento', 'levantamento', 'margem', 'mexico', 'milho', 'milho', 'none', 'periodo', 'periodo', 'relacao', 'resultado', 'tambem', 'tendencia', 'transmissao', 'transmissao']","[2, 2, 1, 1, 1, 1, 3, 3, 3, 1, 1, 2, 2, 1, 1, 2, 2, 1, 2, 2, 1, 1, 1, 1, 2, 2]","[]","[]",26,0,26,1
11138,"['competicao', 'espanha', 'fase', 'flexibilizacao', 'inglaterra', 'paralisar', 'temporada', 'temporada', 'tornear', 'viagem']","[1, 1, 1, 1, 1, 1, 2, 2, 1, 1]","[]","[]",10,0,10,1
11139,"['antonio', 'anvisa', 'anvisa', 'anvisa', 'autorizacao', 'enfrentamento', 'reuniao', 'reuniao', 'vigilancia']","[1, 3, 3, 3, 1, 1, 2, 2, 1]","[]","[]",9,0,9,1
11142,"['azevedo', 'azevedo', 'enfrentamento', 'estimular', 'investigacao', 'irregularidad', 'ministrar', 'ministrar', 'necessidad', 'saudar', 'saudar']","[2, 2, 1, 1, 1, 1, 2, 2, 1, 2, 2]","[]","[]",11,0,11,1
11143,"['adotada', 'companhia', 'comprometido', 'consolidar', 'contrato', 'contrato', 'deflagrar', 'esquema', 'esquema', 'estrategia', 'pagamento', 'tendencia']","[1, 1, 1, 1, 2, 2, 1, 2, 2, 1, 1, 1]","[]","[]",12,0,12,1
11147,"['destinar', 'florido', 'fluxo', 'velocidad']","[1, 1, 1, 1]","['imenso']","[1]",4,1,5,1
11148,"['comparacao', 'consolidar', 'consorcio', 'estabilidad', 'levantamento', 'periodo', 'quedo', 'quedo', 'roraima', 'saudar', 'situacao', 'tendencia', 'tendencia', 'variacao']","[1, 1, 1, 1, 1, 1, 2, 2, 1, 1, 1, 2, 2, 1]","[]","[]",14,0,14,1
11150,"['curvo', 'curvo', 'mexico', 'mexico', 'periodo', 'taxar']","[2, 2, 2, 2, 1, 1]","[]","[]",6,0,6,1
11153,"['campino', 'cooperacao', 'desenvolvimento', 'estimular', 'folhar', 'saudar', 'saudar', 'saudar']","[1, 1, 1, 1, 1, 3, 3, 3]","[]","[]",8,0,8,1
11155,"['academiar', 'companhia', 'fabricacao', 'saudar', 'saudar', 'totalizar']","[1, 1, 1, 2, 2, 1]","[]","[]",6,0,6,1
11157,"['comissao', 'desenvolvido', 'europeu', 'europeu', 'europeu', 'europeu', 'ministrar', 'reuniao', 'saudar', 'sessao']","[1, 1, 4, 4, 4, 4, 1, 1, 1, 1]","[]","[]",10,0,10,1
11158,"['academiar', 'antecipar', 'convencao', 'determinacao', 'economia', 'fase', 'fase', 'fase', 'funcionamento', 'planar', 'planar', 'reabrir', 'regiao']","[1, 1, 1, 1, 1, 3, 3, 3, 1, 2, 2, 1, 1]","[]","[]",13,0,13,1
11162,"['aplicacao', 'disseminacao', 'regrar']","[1, 1, 1]","[]","[]",3,0,3,1
11167,"['biliao', 'congresso', 'desenvolvimento', 'despesa', 'destinar', 'domingo', 'economia', 'extraordinario', 'imunizacao', 'integro', 'orcamentaria', 'republico', 'secretariager', 'vetar']","[1, 1, 1, 1, 1, 1, 1, 1, 1, 1, 1, 1, 1, 1]","[]","[]",14,0,14,1
11173,"['apoio', 'proprio', 'sabado']","[1, 1, 1]","['invadir', 'protestar']","[1, 1]",3,2,5,1
11174,"['adotada', 'adulto', 'ambito', 'assistencia', 'atuacao', 'atuam', 'cenario', 'condicao', 'condicao', 'especifico', 'gestant', 'importancia', 'obesidad', 'obesidad', 'obesidad', 'obesidad', 'obesidad', 'obesidad', 'orientacao', 'pratico', 'pratico', 'primario', 'rastreamento', 'reconhecimento', 'risco', 'saudar', 'saudar', 'saudar', 'saudar', 'saudar', 'saudar', 'saudar', 'suportar']","[1, 1, 1, 1, 1, 1, 1, 2, 2, 1, 1, 1, 6, 6, 6, 6, 6, 6, 1, 2, 2, 1, 1, 1, 1, 7, 7, 7, 7, 7, 7, 7, 1]","[]","[]",33,0,33,1
11176,"['acordo', 'aplicacao', 'atuam', 'distrito', 'fundacao', 'instituto', 'materiaprima', 'milho', 'oswaldo', 'parcela', 'recebido', 'remessa', 'sendo', 'vigilancia']","[1, 1, 1, 1, 1, 1, 1, 1, 1, 1, 1, 1, 1, 1]","[]","[]",14,0,14,1
11179,"['apurar', 'augusto', 'calendario', 'competicao', 'competicao', 'conflito', 'conflito', 'destacar', 'dificuldad', 'discussao', 'possibilidad', 'presenca', 'quarentenar', 'realizacao', 'reclamacao', 'reuniao', 'treinamento']","[1, 1, 1, 2, 2, 2, 2, 1, 1, 1, 1, 1, 1, 1, 1, 1, 1]","[]","[]",17,0,17,1
11180,"['alvorar', 'capitar', 'justicar', 'machadar', 'mandatario', 'palacio', 'planalto', 'pslsp', 'republico', 'transmissao', 'transmissao']","[1, 1, 1, 1, 1, 1, 1, 1, 1, 2, 2]","[]","[]",11,0,11,1
11186,"[]","[]","['estranhar']","[1]",0,1,1,1
11187,"['anteriorment', 'anuncio', 'anuncio', 'inquerito', 'reportar', 'secom', 'secom', 'supremo', 'volumar']","[1, 2, 2, 1, 1, 2, 2, 1, 1]","[]","[]",9,0,9,1
11189,"['adulto', 'autoridad', 'autoridad', 'autoridad', 'autoridad', 'conformar', 'desembarcar', 'estrategia', 'feriar', 'infeccioso', 'infectar', 'instalacao', 'kong', 'necessario', 'negativar', 'observacao', 'passageiro', 'passageiro', 'positivar', 'primario', 'provincia', 'provincia', 'quarentenar', 'regiao', 'respiratorio', 'respiratorio', 'respiratorio', 'saudar', 'surto', 'transmissao', 'vespera']","[1, 4, 4, 4, 4, 1, 1, 1, 1, 1, 1, 1, 1, 1, 1, 1, 2, 2, 1, 1, 2, 2, 1, 1, 3, 3, 3, 1, 1, 1, 1]","['garganta', 'garganta', 'nasal']","[2, 2, 1]",31,3,34,1
11190,"['saudar']","[1]","['camiseta']","[1]",1,1,2,1
11192,"['autoridad', 'autoridad', 'batalhar', 'distrito', 'infectar', 'ministrar', 'positivar', 'positivar', 'saudar']","[2, 2, 1, 1, 1, 1, 2, 2, 1]","['venezuelano']","[1]",9,1,10,1
11194,"['quarentenar']","[1]","['dioxido', 'imagem']","[1, 1]",1,2,3,1
11195,"['biliao', 'client', 'condicao', 'individuar', 'juro', 'oferecido', 'pagamento', 'paralisar', 'parceria', 'taxar']","[1, 1, 1, 1, 1, 1, 1, 1, 1, 1]","[]","[]",10,0,10,1
11196,"['anvisa', 'anvisa', 'avancar', 'avancar', 'desenvolvido', 'esperancar', 'estagio', 'fase', 'justicar', 'moderno', 'necessidad', 'opcao', 'plano', 'saudar', 'vigilancia']","[2, 2, 2, 2, 1, 1, 1, 1, 1, 1, 1, 1, 1, 1, 1]","['versao']","[1]",15,1,16,1
11200,"['boletim', 'exministro', 'respiratorio']","[1, 1, 1]","['desment']","[1]",3,1,4,1
11203,"['condicao', 'decisao', 'deteccao', 'diretoria', 'infectar', 'inicialment', 'pereira', 'pratico']","[1, 1, 1, 1, 1, 1, 1, 1]","[]","[]",8,0,8,1
11204,"['desenvolvido', 'domingo']","[1, 1]","[]","[]",2,0,2,1
11206,"['anvisa', 'avancar', 'consorcio', 'desenvolvimento', 'estagio', 'instituto', 'instituto', 'margem', 'preconceito', 'rejeicao', 'rejeicao']","[1, 1, 1, 1, 1, 2, 2, 1, 1, 2, 2]","[]","[]",11,0,11,1
11207,"['aplicacao', 'aplicacao', 'colombio', 'comunitario', 'desafio', 'destacar', 'levantamento', 'mexico', 'saudar', 'sessao', 'situacao']","[2, 2, 1, 1, 1, 1, 1, 1, 1, 1, 1]","[]","[]",11,0,11,1
11211,"['globonew', 'globonew', 'internacao', 'presenciar', 'regiao', 'restritivo', 'situacao']","[2, 2, 1, 1, 1, 1, 1]","[]","[]",7,0,7,1
11212,"['academiar', 'companhia', 'companhia', 'crescimento', 'expansao', 'pratico', 'prever', 'previsao', 'reuniao']","[1, 2, 2, 1, 1, 1, 1, 1, 1]","[]","[]",9,0,9,1
11213,"['decorrent', 'enfrentamento', 'espirito', 'espirito', 'exemplo', 'importancia', 'milho', 'necessario', 'pedido', 'plano', 'prorrogacao', 'prorrogacao', 'prorrogacao', 'prorrogacao', 'prorrogacao', 'proximo', 'recurso']","[1, 1, 2, 2, 1, 1, 1, 1, 1, 1, 5, 5, 5, 5, 5, 1, 1]","[]","[]",17,0,17,1
11215,"['boletim', 'dengu', 'dengu', 'dengu', 'dengu', 'dengu', 'dengu', 'epidemiologico', 'saudar', 'saudar', 'surtir']","[1, 6, 6, 6, 6, 6, 6, 1, 2, 2, 1]","[]","[]",11,0,11,1
11216,"['dialogo', 'interpretar', 'passageiro', 'saudar', 'sessao', 'situacao', 'suportar', 'temporada', 'viagem']","[1, 1, 1, 1, 1, 1, 1, 1, 1]","['casamentar', 'filmar', 'ganhar']","[1, 1, 1]",9,3,12,1
11217,"['anticorpo', 'anticorpo', 'aplicacao', 'comportamento', 'desenvolvido', 'dosar', 'fase', 'instituto', 'instituto', 'palacio', 'palacio', 'palacio', 'parceria', 'preocupacao', 'ricardo']","[2, 2, 1, 1, 1, 1, 1, 2, 2, 3, 3, 3, 1, 1, 1]","[]","[]",15,0,15,1
11219,"['molecular', 'molecular', 'molecular', 'presenca', 'presenca', 'presenciar']","[3, 3, 3, 2, 2, 1]","['compartilhar']","[1]",6,1,7,1
11220,"['colegio', 'curvo', 'epidemiologico', 'quarentenar', 'quarentenar', 'regiao', 'regiao', 'regiao', 'saudar', 'suspenso']","[1, 1, 1, 2, 2, 3, 3, 3, 1, 1]","['greve', 'protestar']","[1, 1]",10,2,12,1
11221,"['decisao', 'dedicar', 'instituto', 'instituto']","[1, 1, 2, 2]","[]","[]",4,0,4,1
11224,"['comparacao', 'demandar', 'demandar', 'distant', 'levantamento', 'negativar', 'piorar', 'quedo', 'quedo', 'recuar', 'reuter', 'variacao']","[1, 2, 2, 1, 1, 1, 1, 2, 2, 1, 1, 1]","['verificar']","[1]",12,1,13,1
11225,"['autoridad', 'autoridad', 'autoridad', 'broadcast', 'deteccao', 'deteccao', 'pastar', 'positivar', 'positivar', 'provincia']","[3, 3, 3, 1, 2, 2, 1, 2, 2, 1]","[]","[]",10,0,10,1
11227,"['arrecadar', 'desafiar', 'jantar']","[1, 1, 1]","['camisa', 'ganhar']","[1, 1]",3,2,5,1
11230,"['ambito', 'anteriorment', 'antonio', 'augusto', 'depoimento', 'integro', 'investigacao', 'mendonca', 'pagamento', 'proferir', 'regiao', 'ribeiro', 'sentenca', 'sentenca', 'varar', 'varar']","[1, 1, 1, 1, 1, 1, 1, 1, 1, 1, 1, 1, 2, 2, 2, 2]","[]","[]",16,0,16,1
11232,"['liderar', 'mexico']","[1, 1]","[]","[]",2,0,2,1
11233,"['avancar', 'estagio', 'estimativo', 'expectativa', 'importancia', 'instituto', 'instituto', 'instituto', 'levantamento', 'manutencao', 'oferecido', 'prioridad', 'quarentenar', 'quarentenar', 'reducao', 'rotina', 'saudar']","[1, 1, 1, 1, 1, 3, 3, 3, 1, 1, 1, 1, 2, 2, 1, 1, 1]","[]","[]",17,0,17,1
11235,"['curvo', 'epidemiologico', 'ministrar', 'ministrar', 'precaucao']","[1, 1, 2, 2, 1]","['implantar']","[1]",5,1,6,1
11239,"['administrativo', 'arthur', 'avancar', 'ccj', 'ccj', 'ccj', 'colegiado', 'colegiado', 'comissao', 'comissao', 'congresso', 'constituicao', 'feriar', 'ideologico', 'justicar', 'lira', 'lira', 'lira', 'lira', 'ppal', 'proposto', 'resistencia']","[1, 1, 1, 3, 3, 3, 2, 2, 2, 2, 1, 1, 1, 1, 1, 4, 4, 4, 4, 1, 1, 1]","[]","[]",22,0,22,1
11243,"['comissao', 'decisao', 'inquerito', 'posicionamento', 'reuniao', 'sessao', 'sobretudo', 'supremo', 'turma']","[1, 1, 1, 1, 1, 1, 1, 1, 1]","['atribuir', 'wylli', 'wylli', 'wylli', 'wylli', 'wylli']","[1, 5, 5, 5, 5, 5]",9,6,15,1
11245,"['barroso', 'barroso', 'fase', 'investigacao', 'ministrar', 'parceiro', 'situacao']","[2, 2, 1, 1, 1, 1, 1]","['atribuir']","[1]",7,1,8,1
11247,"['diagnosticar', 'examinar', 'jornada']","[1, 1, 1]","[]","[]",3,0,3,1
11248,"['antecipar', 'associacao', 'biliao', 'carat', 'corpu', 'crise', 'decisao', 'economia', 'especialment', 'estrategia', 'feriar', 'feriar', 'feriar', 'feriar', 'feriar', 'impactar', 'impactar', 'metropolitano', 'positivar', 'recebido', 'recuperacao', 'regiao', 'turista', 'viagem', 'viagem', 'viagem', 'viajant']","[1, 1, 1, 1, 1, 1, 1, 1, 1, 1, 5, 5, 5, 5, 5, 2, 2, 1, 1, 1, 1, 1, 1, 3, 3, 3, 1]","[]","[]",27,0,27,1
11250,"['ansiedad', 'depressao', 'diagnosticar', 'domingo', 'hospitalizar', 'inglaterra', 'previo', 'reuter', 'taxar']","[1, 1, 1, 1, 1, 1, 1, 1, 1]","['parir']","[1]",9,1,10,1
11251,"['assistencia', 'assistencia', 'diagnostica', 'molecular', 'monitoramento', 'saudar', 'saudar', 'saudar']","[2, 2, 1, 1, 1, 3, 3, 3]","[]","[]",8,0,8,1
11252,"['antecipar', 'antecipar', 'comissao', 'distrito', 'distrito', 'enfrentamento', 'enfrentamento', 'esforco', 'imunizacao', 'operacionalizacao', 'orientacao', 'panamericana', 'previsto', 'prioridad', 'prioritario', 'saudar', 'saudar', 'saudar', 'saudar', 'saudar']","[2, 2, 1, 2, 2, 2, 2, 1, 1, 1, 1, 1, 1, 1, 1, 5, 5, 5, 5, 5]","[]","[]",20,0,20,1
11253,"['infectar', 'integrant', 'investigacao', 'saudar', 'saudar']","[1, 1, 1, 2, 2]","[]","[]",5,0,5,1
11254,"['apurar', 'desvio', 'flavio', 'lavagem', 'republicanosrj', 'suspeito']","[1, 1, 1, 1, 1, 1]","[]","[]",6,0,6,1
11255,"['bbc', 'benjamin', 'benjamin', 'benjamin', 'desenvolvimento', 'dificuldad', 'dificuldad', 'entregu']","[1, 3, 3, 3, 1, 2, 2, 1]","[]","[]",8,0,8,1
11257,"['academico', 'comissao', 'congresso', 'desenvolvimento', 'destinar', 'insuficient', 'montant', 'queixar', 'recurso']","[1, 1, 1, 1, 1, 1, 1, 1, 1]","[]","[]",9,0,9,1
11260,"['imunizacao', 'pfizerbiontech']","[1, 1]","[]","[]",2,0,2,1
11262,"['anvisa', 'anvisa', 'autorizacao', 'concedido', 'definitivo', 'domingo', 'entregu', 'fundacao', 'necessario', 'oswaldo', 'regrar', 'saudar', 'unanimidad', 'vigilancia']","[2, 2, 1, 1, 1, 1, 1, 1, 1, 1, 1, 1, 1, 1]","[]","[]",14,0,14,1
11264,"['alternativo', 'levantamento', 'obtido', 'oliveira', 'oliveira', 'respostar', 'ribeiro', 'situacao']","[1, 1, 1, 2, 2, 1, 1, 1]","['imagem', 'motorista']","[1, 1]",8,2,10,1
11269,"['decisao', 'dosar', 'espanha', 'espanha', 'europeu', 'exigencia', 'expectativa', 'fronteiro', 'primeiroministro', 'prorrogar', 'reabrir', 'reuniao', 'saudar', 'turista', 'viagem']","[1, 1, 2, 2, 1, 1, 1, 1, 1, 1, 1, 1, 1, 1, 1]","[]","[]",15,0,15,1
11270,"['alternativo', 'ambientar', 'ambientar', 'argumentar', 'crise', 'crise', 'equipamento', 'internacao', 'necessario', 'pratico', 'reflexo']","[1, 2, 2, 1, 2, 2, 1, 1, 1, 1, 1]","[]","[]",11,0,11,1
11271,"['contrato', 'forcatarefa', 'logistico', 'oferecido', 'pagamento', 'varar']","[1, 1, 1, 1, 1, 1]","[]","[]",6,0,6,1
11272,"['conformar', 'estimular', 'ministrar', 'pastar', 'prescricao', 'prescricao', 'rejeitar', 'saudar', 'saudar']","[1, 1, 1, 1, 2, 2, 1, 2, 2]","[]","[]",9,0,9,1
11273,"['argumentar', 'atuacao', 'atuacao', 'decisao', 'determinacao', 'determinacao', 'fluminens', 'prioridad', 'reforcar', 'supremo', 'supremo', 'wilson', 'witzel', 'witzel']","[1, 2, 2, 1, 2, 2, 1, 1, 1, 2, 2, 1, 2, 2]","['ganhar']","[1]",14,1,15,1
11274,"[]","[]","[]","[]",0,0,0,1
11276,"['interino', 'ministrar', 'nelson', 'recuperacao', 'saudar', 'teich']","[1, 1, 1, 1, 1, 1]","[]","[]",6,0,6,1
11277,"['cnmp', 'cnmp', 'decisao', 'deltan', 'deltan', 'deltan', 'etapa', 'guaruja', 'processo', 'reclamacao', 'recurso', 'republico', 'supremo', 'tramitacao', 'triplex']","[2, 2, 1, 3, 3, 3, 1, 1, 1, 1, 1, 1, 1, 1, 1]","['arquivar', 'arquivar']","[2, 2]",15,2,17,1
11278,"['deltan', 'exjuiz', 'folhar', 'forcatarefa', 'investigacao', 'irregularidad', 'necessario', 'processo', 'processo', 'processo', 'processo', 'republico', 'respostar']","[1, 1, 1, 1, 1, 1, 1, 4, 4, 4, 4, 1, 1]","['telegram', 'vazar']","[1, 1]",13,2,15,1
11281,"['augusto', 'cronica', 'estatistico', 'jorg']","[1, 1, 1, 1]","[]","[]",4,0,4,1
11283,"['aglomeracao', 'avancar', 'circulacao', 'decisao', 'especifico', 'fronteiro', 'fronteiro', 'implementar', 'minimizar', 'observar', 'reuniao', 'saudar', 'saudar', 'suspenso']","[1, 1, 1, 1, 1, 2, 2, 1, 1, 1, 1, 2, 2, 1]","['ganhar']","[1]",14,1,15,1
11284,"['acompanhamento', 'anuncio', 'balancar', 'saudar', 'saudar', 'subir']","[1, 1, 1, 2, 2, 1]","[]","[]",6,0,6,1
11285,"['acumular', 'consorcio', 'dosar']","[1, 1, 1]","[]","[]",3,0,3,1
11286,"['afetado', 'atrasar', 'domingo', 'entregu', 'espanha', 'europeu', 'periodo', 'periodo', 'periodo', 'sabado', 'saudar', 'superar', 'taxar', 'variacao']","[1, 1, 1, 1, 1, 1, 3, 3, 3, 1, 1, 1, 1, 1]","[]","[]",14,0,14,1
11288,"['equilibrio', 'quedo', 'reflexo']","[1, 1, 1]","[]","[]",3,0,3,1
11290,"['cepa', 'diminuicao', 'infeccioso', 'michael', 'recuar', 'reducao', 'respostar', 'saudar', 'tendencia']","[1, 1, 1, 1, 1, 1, 1, 1, 1]","['supostament']","[1]",9,1,10,1
11291,"['andrea', 'andrea', 'andrea', 'colunista', 'flavio', 'gabinet', 'gabinet', 'gabinet', 'investigacao', 'legislativo', 'movimentacao', 'recurso']","[3, 3, 3, 1, 1, 3, 3, 3, 1, 1, 1, 1]","[]","[]",12,0,12,1
11292,"['anvisa', 'anvisa', 'anvisa', 'conformar', 'desenvolvido', 'obtido', 'prazo', 'preliminar', 'reuniao', 'reuniao', 'revisar', 'vigilancia']","[3, 3, 3, 1, 1, 1, 1, 1, 2, 2, 1, 1]","[]","[]",12,0,12,1
11293,"['biliao', 'biliao', 'congresso', 'economia', 'funcao', 'gued', 'inicialment', 'ministrar', 'pagamento', 'pagamento', 'periodo', 'prever', 'prever', 'proposto', 'transferencia']","[2, 2, 1, 1, 1, 1, 1, 1, 2, 2, 1, 2, 2, 1, 1]","[]","[]",15,0,15,1
11296,"['atendido', 'destacar', 'impactar', 'orientacao', 'prazo', 'prazo', 'preocupacao', 'taxar']","[1, 1, 1, 1, 2, 2, 1, 1]","[]","[]",8,0,8,1
11298,"['desafio', 'espirito', 'goncalv', 'pagamento', 'parcelar', 'periodo', 'previsto', 'quarentenar', 'regrar']","[1, 1, 1, 1, 1, 1, 1, 1, 1]","['ganhar', 'realment']","[1, 1]",9,2,11,1
11299,"['coletivo', 'competicao', 'elaborar', 'etapa', 'fase', 'fase', 'relaxar', 'sessao', 'treinamento', 'treinamento', 'treinamento']","[1, 1, 1, 1, 2, 2, 1, 1, 3, 3, 3]","[]","[]",11,0,11,1
11300,"['bolsonarista', 'cenario']","[1, 1]","[]","[]",2,0,2,1
11302,"['californio', 'florido']","[1, 1]","[]","[]",2,0,2,1
11305,"['augusto', 'cnj', 'inclusao', 'justicar', 'magistrado', 'oficio', 'orientacao', 'pastar', 'preventivo', 'prioridad', 'privar', 'propagacao', 'republico', 'requerimento', 'saudar', 'saudar']","[1, 1, 1, 1, 1, 1, 1, 1, 1, 1, 1, 1, 1, 1, 2, 2]","[]","[]",16,0,16,1
11306,"['dificuldad', 'emprestimo', 'equipamento', 'escassez', 'intensivo', 'intubacao', 'regiao', 'transferir']","[1, 1, 1, 1, 1, 1, 1, 1]","[]","[]",8,0,8,1
11308,"['arrecadar', 'consumidor', 'crise', 'expectativa', 'fase', 'iniciativo', 'iniciativo']","[1, 1, 1, 1, 1, 2, 2]","[]","[]",7,0,7,1
11310,"['araujo', 'araujo', 'facilitar', 'fluminens', 'fluminens', 'henriqu', 'pacheco', 'pacheco', 'posicionamento', 'ritmar']","[2, 2, 1, 2, 2, 1, 2, 2, 1, 1]","['amigar', 'camisa']","[1, 1]",10,2,12,1
11311,"['folhar', 'integro', 'pastar', 'previsao', 'saudar']","[1, 1, 1, 1, 1]","[]","[]",5,0,5,1
11312,"['cenario', 'flexibilizacao', 'flexibilizacao', 'flexibilizar', 'habitant', 'habitant', 'impactar', 'inclusao', 'justicar', 'planar', 'planar', 'planar', 'quarentenar', 'quarentenar', 'reabertura', 'reabrir', 'regiao', 'regrar']","[1, 2, 2, 1, 2, 2, 1, 1, 1, 3, 3, 3, 2, 2, 1, 1, 1, 1]","[]","[]",18,0,18,1
11314,"['alteracao', 'ambientar', 'ambientar', 'desenvolvimento', 'enxergar', 'integro', 'interferencia', 'intervalar', 'observacao', 'proliferacao', 'transmissao']","[1, 2, 2, 1, 1, 1, 1, 1, 1, 1, 1]","['minutar']","[1]",11,1,12,1
11315,"['adotada', 'alerj', 'autoridad', 'contencao', 'demm', 'exministro', 'fabricio', 'flavio', 'gabinet', 'gabinet', 'gabinet', 'henriqu', 'legislativo', 'manutencao', 'queiroz', 'queiroz', 'queiroz', 'recuperacao', 'relaxamento', 'republicanosrj', 'saudar', 'saudar']","[1, 1, 1, 1, 1, 1, 1, 1, 3, 3, 3, 1, 1, 1, 3, 3, 3, 1, 1, 1, 2, 2]","[]","[]",22,0,22,1
11316,"['estrategico', 'flavio', 'jorg', 'jorg', 'jorg', 'kassio', 'ministrar', 'ministrar', 'oliveira', 'oliveira', 'oliveira', 'oliveira', 'republico', 'rocha', 'secretariager', 'secretariager', 'supremo', 'tcu', 'tcu', 'tcu']","[1, 1, 3, 3, 3, 1, 2, 2, 4, 4, 4, 4, 1, 1, 2, 2, 1, 3, 3, 3]","[]","[]",20,0,20,1
11318,"['autonomia', 'autorizacao', 'autorizacao', 'carat', 'correspondent', 'demandar', 'destinar', 'distrito', 'especializar', 'espirito', 'necessario', 'pulmonar', 'pulmonar', 'reforcar', 'saudar', 'saudar', 'suportar', 'suportar', 'suportar', 'suspeito', 'temporario', 'ventilatorio', 'ventilatorio']","[1, 2, 2, 1, 1, 1, 1, 1, 1, 1, 1, 2, 2, 1, 2, 2, 3, 3, 3, 1, 1, 2, 2]","[]","[]",23,0,23,1
11321,"['augusto', 'enquadrar', 'preventivo', 'previsto', 'republico', 'republico', 'saudar']","[1, 1, 1, 1, 2, 2, 1]","[]","[]",7,0,7,1
11323,"['afp', 'hospitalizar', 'regiao', 'sudest', 'vigilancia']","[1, 1, 1, 1, 1]","['vazar', 'vazar']","[2, 2]",5,2,7,1
11325,"['ampliacao', 'biliao', 'comissao', 'companhia', 'primario', 'primario', 'recurso', 'reuter', 'sessao', 'sigla']","[1, 1, 1, 1, 2, 2, 1, 1, 1, 1]","[]","[]",10,0,10,1
11326,"['modelo']","[1]","[]","[]",1,0,1,1
11327,"['assistencia', 'coletivo', 'comissao', 'examinar', 'liderar', 'positivar', 'preliminar', 'situacao', 'situacao']","[1, 1, 1, 1, 1, 1, 1, 2, 2]","[]","[]",9,0,9,1
11328,"['consecutivo', 'consorcio', 'decorrencia', 'domingo', 'notificar', 'recordar', 'roraima', 'sabado', 'superar']","[1, 1, 1, 1, 1, 1, 1, 1, 1]","[]","[]",9,0,9,1
11330,"['aplicacao', 'coordenar', 'distrito', 'domingo', 'dosar', 'esquema', 'estrategia', 'facilitar', 'fase', 'fundacao', 'igualitario', 'instituto', 'intervalar', 'operacionalizacao', 'oswaldo', 'pastar', 'planar', 'prazo', 'publicoalvo', 'remessar', 'sabado', 'saudar', 'saudar', 'saudar', 'vigilancia']","[1, 1, 1, 1, 1, 1, 1, 1, 1, 1, 1, 1, 1, 1, 1, 1, 1, 1, 1, 1, 1, 3, 3, 3, 1]","[]","[]",25,0,25,1
11332,"['afastamento', 'ambientar', 'colegio', 'colegio', 'escalar', 'estrategia', 'impacto', 'inedito', 'projecao', 'projecao', 'sabado']","[1, 1, 2, 2, 1, 1, 1, 1, 2, 2, 1]","['ganhar']","[1]",11,1,12,1
11333,"['autoridad', 'etapa', 'importancia', 'imunizacao', 'preliminar', 'preocupacao', 'publicoalvo', 'risco', 'sarampo', 'sarampo', 'sarampo', 'sarampo', 'saudar', 'saudar']","[1, 1, 1, 1, 1, 1, 1, 1, 4, 4, 4, 4, 2, 2]","[]","[]",14,0,14,1
11337,"['adversario', 'afastamento', 'ambito', 'carat', 'colegiado', 'colegiado', 'colegiado', 'condenacao', 'condenacao', 'conformar', 'decisao', 'decisao', 'decisao', 'decisao', 'decisao', 'decisao', 'decisao', 'decisao', 'decisao', 'decisao', 'depoimento', 'depoimento', 'determinacao', 'distrito', 'edson', 'enquadrar', 'exjuiz', 'exjuiz', 'exjuiz', 'fachin', 'fachin', 'fachin', 'fachin', 'fachin', 'fachin', 'guaruja', 'guaruja', 'impactar', 'instituto', 'julgamento', 'julgamento', 'julgamento', 'jurista', 'justicar', 'justicar', 'justicar', 'justicar', 'justicar', 'justificativo', 'magistrado', 'magistrado', 'manutencao', 'ministrar', 'ministrar', 'ministrar', 'motivacao', 'necessario', 'necessidad', 'periodo', 'plenario', 'plenario', 'plenario', 'plenario', 'processo', 'processo', 'processo', 'processo', 'processo', 'processo', 'proferir', 'proferir', 'recebido', 'recuperacao', 'sentenca', 'substituto', 'supremo', 'suspeicao', 'suspeicao', 'triplex', 'triplex', 'triplex', 'triplex', 'triplex', 'turma']","[1, 1, 1, 1, 3, 3, 3, 2, 2, 1, 10, 10, 10, 10, 10, 10, 10, 10, 10, 10, 2, 2, 1, 1, 1, 1, 3, 3, 3, 6, 6, 6, 6, 6, 6, 2, 2, 1, 1, 3, 3, 3, 1, 5, 5, 5, 5, 5, 1, 2, 2, 1, 3, 3, 3, 1, 1, 1, 1, 4, 4, 4, 4, 6, 6, 6, 6, 6, 6, 2, 2, 1, 1, 1, 1, 1, 2, 2, 5, 5, 5, 5, 5, 1]","['instrucao']","[1]",84,1,85,1
11341,"['armazenamento', 'favorito', 'sendo', 'tambem']","[1, 1, 1, 1]","[]","[]",4,0,4,1
11342,"['absoluto', 'capitar', 'capitar', 'desigu', 'equipamento', 'equipamento', 'manutencao', 'prever', 'privar', 'quadro', 'respirador', 'respirador', 'respirador', 'respirador', 'saudar', 'saudar', 'ventilador', 'ventilador']","[1, 2, 2, 1, 2, 2, 1, 1, 1, 1, 4, 4, 4, 4, 2, 2, 2, 2]","[]","[]",18,0,18,1
11343,"['marilia', 'periodo']","[1, 1]","[]","[]",2,0,2,1
11345,"['autoridad', 'convencao', 'decisao', 'decisao', 'decisao', 'diplomata', 'portavoz', 'portavoz', 'portavoz', 'privar', 'recuar', 'regrar']","[1, 1, 3, 3, 3, 1, 3, 3, 3, 1, 1, 1]","['protestar']","[1]",12,1,13,1
11347,"['ambientar', 'conformar', 'consequencia', 'enfermagem', 'equilibrio', 'opcao', 'pratico', 'preservar', 'psicologo', 'regrar', 'rotina', 'sessao']","[1, 1, 1, 1, 1, 1, 1, 1, 1, 1, 1, 1]","[]","[]",12,0,12,1
11349,"['afetado', 'andrew', 'epicentro', 'epidemiar', 'fase', 'necessidad']","[1, 1, 1, 1, 1, 1]","[]","[]",6,0,6,1
11351,"['aplicacao', 'biliao', 'biliao', 'previsao', 'previsao', 'previsao', 'superar']","[1, 2, 2, 3, 3, 3, 1]","['imagem', 'imagem', 'intitular']","[2, 2, 1]",7,3,10,1
11357,"['destinar', 'dosar', 'dosar', 'esquema', 'esquema', 'esquema', 'esquema', 'federativo', 'instituto', 'materiaprima', 'operacionalizacao', 'pastar', 'planar', 'previsao', 'prioritario', 'saudar']","[1, 2, 2, 4, 4, 4, 4, 1, 1, 1, 1, 1, 1, 1, 1, 1]","[]","[]",16,0,16,1
11359,"['apurar', 'barroso', 'comissao', 'determinacao', 'dificuldad', 'funcionamento', 'governista', 'inquerito', 'instaurar', 'integrant', 'ministrar', 'pratico', 'presenciar', 'supremo', 'suspenso', 'videoconferencia']","[1, 1, 1, 1, 1, 1, 1, 1, 1, 1, 1, 1, 1, 1, 1, 1]","[]","[]",16,0,16,1
11361,"['anticorpo', 'anticorpo', 'anticorpo', 'anticorpo', 'anticorpo', 'anticorpo', 'assintomatico', 'californio', 'cirurgico', 'infectar', 'investigacao', 'liderar', 'oferecido', 'precisao', 'reforcar', 'respostar', 'respostar']","[6, 6, 6, 6, 6, 6, 1, 1, 1, 1, 1, 1, 1, 1, 1, 2, 2]","[]","[]",17,0,17,1
11362,"['coordenar', 'materiaprima', 'molecular', 'molecular', 'parceria', 'realizacao', 'reducao', 'volumar']","[1, 1, 2, 2, 1, 1, 1, 1]","[]","[]",8,0,8,1
11363,"['anteriorment', 'decisao', 'discussao', 'internar', 'journal', 'presidir', 'reabrir', 'reuter']","[1, 1, 1, 1, 1, 1, 1, 1]","[]","[]",8,0,8,1
11367,"['anvisa', 'companhia', 'desenvolvido', 'parceria', 'vigilancia']","[1, 1, 1, 1, 1]","[]","[]",5,0,5,1
11368,"['aglomeracao']","[1]","[]","[]",1,0,1,1
11371,"['alvorar', 'biliao', 'congresso', 'conjunto', 'converso', 'decisao', 'economia', 'gued', 'ministrar', 'palacio', 'palacio', 'planalto', 'saudar', 'servidor', 'sessao', 'vetar', 'vetar', 'vetar', 'vetar', 'vetar']","[1, 1, 1, 1, 1, 1, 1, 1, 1, 2, 2, 1, 1, 1, 1, 5, 5, 5, 5, 5]","[]","[]",20,0,20,1
11374,"['academico', 'academico', 'comportamento', 'tendencia']","[2, 2, 1, 1]","['circular']","[1]",4,1,5,1
11376,"['atendido', 'atendido', 'campino', 'client', 'client', 'determinacao', 'dificuldad', 'domicilio', 'individuar', 'opcao', 'quarentenar', 'quedo', 'quedo', 'salao', 'salao']","[2, 2, 1, 2, 2, 1, 1, 1, 1, 1, 1, 2, 2, 2, 2]","['desligar']","[1]",15,1,16,1
11377,"['colegiado', 'legislativo', 'reclamacao', 'sessao']","[1, 1, 1, 1]","['filmar']","[1]",4,1,5,1
11378,"['abordagem', 'ampliacao', 'domingo', 'domingo', 'eventualment', 'expansao', 'palacio', 'planalto', 'planalto', 'regrar', 'regrar', 'saudar', 'saudar']","[1, 1, 2, 2, 1, 1, 1, 2, 2, 2, 2, 2, 2]","[]","[]",13,0,13,1
11380,"['ambito', 'conservacao', 'infectar', 'recurso', 'respirador', 'saudar', 'saudar', 'saudar', 'saudar', 'tributario']","[1, 1, 1, 1, 1, 4, 4, 4, 4, 1]","[]","[]",10,0,10,1
11381,"['anvisa', 'ministrar', 'ministrar', 'necessario', 'pastar', 'reuniao', 'saudar', 'saudar', 'vigilancia']","[1, 2, 2, 1, 1, 1, 2, 2, 1]","[]","[]",9,0,9,1
11382,"['estrategia', 'etapa', 'imunizacao', 'preliminar', 'publicoalvo', 'rotina', 'rotina', 'sarampo', 'sarampo', 'sarampo', 'sarampo', 'saudar', 'saudar', 'saudar', 'saudar', 'totalizar']","[1, 1, 1, 1, 1, 2, 2, 4, 4, 4, 4, 4, 4, 4, 4, 1]","[]","[]",16,0,16,1
11383,"['comparacao', 'estatistico', 'exministro', 'gabbardo', 'gabbardo', 'gabbardo', 'henriqu', 'previsao', 'previsao', 'sabado', 'saudar', 'saudar', 'saudar', 'superar']","[1, 1, 1, 3, 3, 3, 1, 2, 2, 1, 3, 3, 3, 1]","['circular']","[1]",14,1,15,1
11384,"['afp', 'agravamento', 'agravamento', 'funcao', 'hospitalizar', 'internar', 'resistencia', 'saudar', 'transferencia', 'transferir', 'transferir']","[1, 2, 2, 1, 1, 1, 1, 1, 1, 2, 2]","[]","[]",11,0,11,1
11385,"['autoridad', 'infectar', 'proporcao', 'quarentenar', 'respiratorio', 'saudar', 'saudar', 'surto']","[1, 1, 1, 1, 1, 2, 2, 1]","[]","[]",8,0,8,1
11386,"['celebrar']","[1]","[]","[]",1,0,1,1
11390,"['afp', 'afp', 'augusto', 'colegio', 'comissao', 'habitant', 'regiao', 'regiao', 'saudar']","[2, 2, 1, 1, 1, 1, 2, 2, 1]","[]","[]",9,0,9,1
11391,"['afetado', 'client', 'conformar', 'consolidar', 'europeu', 'impactar', 'impulsionar', 'preliminar', 'quedo', 'quedo', 'respectivament', 'semestr', 'semestr', 'semestr', 'suspenso', 'trimestr', 'volumar', 'volumar', 'volumar']","[1, 1, 1, 1, 1, 1, 1, 1, 2, 2, 1, 3, 3, 3, 1, 1, 3, 3, 3]","[]","[]",19,0,19,1
11392,"['anvisa', 'autonomia', 'esquema', 'fundacao', 'intervalar', 'intervalar', 'intervalar', 'oswaldo', 'saudar', 'saudar', 'vigilancia']","[1, 1, 1, 1, 3, 3, 3, 1, 2, 2, 1]","[]","[]",11,0,11,1
11395,"['afetado', 'alergia', 'californio', 'californio', 'esforco', 'florido', 'florido', 'infeccioso', 'infeccioso', 'instituto', 'reabertura', 'situacao', 'subir', 'surtir', 'surtir', 'surtir', 'surto', 'temor']","[1, 1, 2, 2, 1, 2, 2, 2, 2, 1, 1, 1, 1, 3, 3, 3, 1, 1]","[]","[]",18,0,18,1
11396,"['aglomeracao', 'avancar', 'cenario', 'coletivo', 'funcionamento', 'intensivo', 'limitacao', 'realizacao', 'restritivo', 'saudar', 'suspensao']","[1, 1, 1, 1, 1, 1, 1, 1, 1, 1, 1]","[]","[]",11,0,11,1
11397,"['boletim', 'dificultar', 'epidemiologico', 'indicador', 'lesao', 'periodo', 'periodo', 'reducao', 'reducao', 'respectivament', 'saudar', 'saudar', 'saudar', 'saudar']","[1, 1, 1, 1, 1, 2, 2, 2, 2, 1, 4, 4, 4, 4]","['acidentar']","[1]",14,1,15,1
11398,"['almeida', 'calculo', 'cenario', 'comissao', 'constituicao', 'desenvolvimento', 'despesa', 'destinar', 'emendar', 'fundeb', 'fundeb', 'manutencao', 'montant', 'orcamentaria', 'parcelar', 'prever', 'prever', 'previsao', 'proposto', 'proposto', 'proposto', 'reforcar', 'tesourar', 'tramitar']","[1, 1, 1, 1, 1, 1, 1, 1, 1, 2, 2, 1, 1, 1, 1, 2, 2, 1, 3, 3, 3, 1, 1, 1]","[]","[]",24,0,24,1
11399,"[]","[]","[]","[]",0,0,0,1
11402,"['acumular', 'cepa', 'cepa', 'comportamento', 'contagioso', 'desembarcar', 'diagnosticar', 'infeccioso', 'inglaterra', 'inicialment', 'instituto', 'mutacao', 'mutacao', 'mutacao', 'saudar', 'variacao', 'vigilancia']","[1, 2, 2, 1, 1, 1, 1, 1, 1, 1, 1, 3, 3, 3, 1, 1, 1]","['espalhar', 'minutar', 'versao']","[1, 1, 1]",17,3,20,1
11404,"['anuncio', 'necessario', 'recurso']","[1, 1, 1]","[]","[]",3,0,3,1
11406,"['assintomatico', 'condicao', 'diagnosticar', 'funcao', 'hospitalizacao', 'hospitalizar', 'infectar', 'internacao', 'portavoz', 'positivar', 'possibilidad', 'saudar']","[1, 1, 1, 1, 1, 1, 1, 1, 1, 1, 1, 1]","[]","[]",12,0,12,1
11408,"['adulto', 'autonomia', 'autorizacao', 'campino', 'carat', 'conformar', 'demandar', 'distrito', 'enfrentamento', 'infraestrutura', 'necessario', 'pastar', 'reforcar', 'saudar', 'saudar', 'temporario']","[1, 1, 1, 1, 1, 1, 1, 1, 1, 1, 1, 1, 1, 2, 2, 1]","[]","[]",16,0,16,1
11409,"['almeida', 'edson', 'nogueira', 'oliveira', 'rejeitar']","[1, 1, 1, 1, 1]","['compartilhar']","[1]",5,1,6,1
11410,"['autonomia', 'mandatario', 'nogueira', 'nogueira', 'nogueira', 'wellington']","[1, 1, 3, 3, 3, 1]","['rompimento']","[1]",6,1,7,1
11414,"['adulto', 'cepa', 'cepa', 'cepa', 'colaboracao', 'escalar', 'necessario', 'necessario', 'painel', 'preliminar', 'regiao', 'saudar', 'suprimento']","[1, 3, 3, 3, 1, 1, 2, 2, 1, 1, 1, 1, 1]","[]","[]",13,0,13,1
11415,"['bolsonarista', 'crise', 'domingo', 'edson', 'edson', 'enfrentamento', 'instalacao', 'republico', 'supremo']","[1, 1, 1, 2, 2, 1, 1, 1, 1]","[]","[]",9,0,9,1
11417,"['atrasar', 'dificuldad', 'domingo', 'gabbardo', 'importacao', 'importacao', 'materiaprima', 'saudar']","[1, 1, 1, 1, 2, 2, 1, 1]","[]","[]",8,0,8,1
11418,"['anvisa', 'aprovacao', 'impactar', 'impactar', 'infectar', 'instituto', 'necessario', 'parcelar', 'positivar', 'saudar']","[1, 1, 2, 2, 1, 1, 1, 1, 1, 1]","[]","[]",10,0,10,1
11420,"['domingo', 'economia', 'especifico', 'pfizerbiontech', 'recuperacao', 'sabado', 'saudar']","[1, 1, 1, 1, 1, 1, 1]","[]","[]",7,0,7,1
11424,"['alteracao', 'claudio', 'julgamento', 'julgamento', 'justicar', 'processo', 'proposto']","[1, 1, 2, 2, 1, 1, 1]","['imagem']","[1]",7,1,8,1
11428,"['adotada', 'argumentar', 'calheiro', 'comissao', 'crise', 'determinacao', 'estrategia', 'funcao', 'gabinet', 'ideologico', 'integro', 'interlocutor', 'mdbal', 'palacio', 'palacio', 'parceiro', 'periodo', 'planalto', 'planalto', 'pratico', 'randolf', 'republicanosrj', 'supremo']","[1, 1, 1, 1, 1, 1, 1, 1, 1, 1, 1, 1, 1, 2, 2, 1, 1, 2, 2, 1, 1, 1, 1]","['narrativo']","[1]",23,1,24,1
11429,"['bandeirant', 'estimular', 'imunizacao', 'imunizacao', 'institut', 'instituto', 'reflexo', 'rejeitar']","[1, 1, 2, 2, 1, 1, 1, 1]","[]","[]",8,0,8,1
11430,"['cometido', 'preservar', 'preservar', 'saudar', 'saudar', 'saudar']","[1, 2, 2, 3, 3, 3]","['biblia']","[1]",6,1,7,1
11433,"['diplomata', 'diplomata', 'tramitacao']","[2, 2, 1]","[]","[]",3,0,3,1
11434,"['aprovacao', 'coordenar', 'decisao', 'dosar', 'europeu', 'europeu', 'europeu', 'implementacao', 'observacao', 'oficialment']","[1, 1, 1, 1, 3, 3, 3, 1, 1, 1]","[]","[]",10,0,10,1
11435,"['adulto', 'autorizacao', 'comissao', 'europeu', 'europeu', 'intervalar', 'moderno', 'orientacao', 'sigla']","[1, 1, 1, 2, 2, 1, 1, 1, 1]","[]","[]",9,0,9,1
11438,"['assistencia', 'conformar', 'desembarcar', 'dificuldad', 'enfrentamento', 'entregu', 'equipamento', 'equipamento', 'equipamento', 'estrategico', 'infectar', 'pulmonar', 'pulmonar', 'pulmonar', 'reforcar', 'respiratorio', 'saudar', 'saudar', 'saudar', 'saudar', 'saudar', 'saudar', 'suportar', 'transmissao', 'velocidad', 'ventilador', 'ventilador', 'ventilador', 'ventilador', 'ventilador', 'ventilador', 'ventilatorio']","[1, 1, 1, 1, 1, 1, 3, 3, 3, 1, 1, 3, 3, 3, 1, 1, 6, 6, 6, 6, 6, 6, 1, 1, 1, 6, 6, 6, 6, 6, 6, 1]","['ganhar']","[1]",32,1,33,1
11439,"['alergia', 'autoridad', 'avancar', 'escalar', 'esforco', 'estagio', 'infeccioso', 'infectar', 'instituto', 'instituto', 'moderno', 'necessario', 'preliminar', 'reuter', 'reuter', 'saudar']","[1, 1, 1, 1, 1, 1, 1, 1, 2, 2, 1, 1, 1, 2, 2, 1]","[]","[]",16,0,16,1
11440,"['comissao', 'competicao', 'competicao', 'competicao', 'confederacao', 'inicialment', 'oliveira', 'presidir', 'proposto', 'renata', 'reuniao', 'revogar', 'surtir', 'temporada', 'temporada', 'videoconferencia']","[1, 3, 3, 3, 1, 1, 1, 1, 1, 1, 1, 1, 1, 2, 2, 1]","[]","[]",16,0,16,1
11441,"['antonio', 'anvisa', 'anvisa', 'aprovacao', 'autorizacao', 'carat', 'definitivo', 'extraordinario', 'regrar', 'resolucao', 'reuniao', 'reuter', 'temporario', 'vigilancia']","[1, 2, 2, 1, 1, 1, 1, 1, 1, 1, 1, 1, 1, 1]","[]","[]",14,0,14,1
11443,"['acompanhamento', 'conformar', 'desempenhar', 'distant', 'elaborar', 'habitant', 'habitant', 'henriqu', 'infectar', 'levantamento', 'liderar', 'liderar', 'proporcao', 'respiratorio', 'saudar', 'saudar', 'taxar', 'taxar']","[1, 1, 1, 1, 1, 2, 2, 1, 1, 1, 2, 2, 1, 1, 2, 2, 2, 2]","[]","[]",18,0,18,1
11444,"['afp', 'contencao', 'depressao', 'diagnosticar', 'diminuicao', 'enfatizar', 'preocupacao', 'recuperacao', 'surtir']","[1, 1, 1, 1, 1, 1, 1, 1, 1]","[]","[]",9,0,9,1
11445,"['acordo', 'especifico', 'preliminar', 'preliminar', 'recuperacao', 'respirador', 'resultado', 'resultado', 'risco', 'risco', 'serao']","[1, 1, 2, 2, 1, 1, 2, 2, 2, 2, 1]","['amplament']","[1]",11,1,12,1
11446,"['anvisa', 'decisao', 'revogar', 'suspensao']","[1, 1, 1, 1]","[]","[]",4,0,4,1
11448,"['ampliacao', 'assistencia', 'enfrentamento', 'etapa', 'importancia', 'primario', 'primario', 'primario', 'reforcar', 'reforcar', 'reforcar', 'regiao', 'saudar', 'saudar', 'saudar', 'saudar', 'saudar', 'saudar', 'transferir']","[1, 1, 1, 1, 1, 3, 3, 3, 3, 3, 3, 1, 6, 6, 6, 6, 6, 6, 1]","['inscricao']","[1]",19,1,20,1
11449,"['espanha', 'intensivo', 'internacao', 'regiao', 'saudar', 'superar', 'tendencia', 'totalizar']","[1, 1, 1, 1, 1, 1, 1, 1]","[]","[]",8,0,8,1
11450,"['crise', 'equipamento', 'oliveira', 'saudar', 'saudar', 'taxar', 'ventilador', 'ventilador', 'ventilador']","[1, 1, 1, 2, 2, 1, 3, 3, 3]","[]","[]",9,0,9,1
11451,"['informaco']","[1]","[]","[]",1,0,1,1
11452,"['alcolumbr', 'conformar', 'constituicao', 'demap', 'demrj', 'destinar', 'plano', 'republico', 'supremo']","[1, 1, 1, 1, 1, 1, 1, 1, 1]","[]","[]",9,0,9,1
11453,"['alcolumbr', 'alcolumbr', 'autoridad', 'concessionario', 'demap', 'domingo', 'domingo', 'fornecimento', 'investigacao', 'rigoroso', 'sabado']","[2, 2, 1, 1, 1, 2, 2, 1, 1, 1, 1]","['incendio', 'incendio']","[2, 2]",11,2,13,1
11454,"['privar', 'propagacao', 'saudar']","[1, 1, 1]","['bandeiro', 'cartaz', 'protestar', 'protestar', 'protestar']","[1, 1, 3, 3, 3]",3,5,8,1
11455,"['destinar', 'elaborar', 'esperancar', 'justicar', 'justicar', 'justicar', 'parcelar', 'regiao']","[1, 1, 1, 3, 3, 3, 1, 1]","['despejar', 'reivindicar']","[1, 1]",8,2,10,1
11456,"['fronteiro', 'fronteiro', 'habitant', 'isolar', 'mandatario', 'situacao', 'tripulacao']","[2, 2, 1, 1, 1, 1, 1]","[]","[]",7,0,7,1
11460,"['campino', 'colombio', 'desenvolvimento', 'independentement', 'journal', 'mudanca', 'saudar', 'taxar']","[1, 1, 1, 1, 1, 1, 1, 1]","['ideologia']","[1]",8,1,9,1
11462,"['ambientar', 'ampliacao', 'arthur', 'impactar', 'instituto', 'lira', 'minoria', 'ppal', 'prever', 'proliferacao', 'saudar', 'significativo']","[1, 1, 1, 1, 1, 1, 1, 1, 1, 1, 1, 1]","['barragem', 'basto']","[1, 1]",12,2,14,1
11465,"['curvo', 'domingo', 'edson', 'feriar', 'feriar', 'impactar', 'impactar', 'modelo', 'normalment', 'periodo', 'sabado', 'sabado', 'saudar', 'significativo', 'taxar']","[1, 1, 1, 2, 2, 2, 2, 1, 1, 1, 2, 2, 1, 1, 1]","[]","[]",15,0,15,1
11467,"['decisao', 'decisao', 'decisao', 'decisao', 'espirito', 'posicionamento', 'preocupacao', 'situacao', 'situacao', 'tambem', 'videoconferencia']","[4, 4, 4, 4, 1, 1, 1, 2, 2, 1, 1]","[]","[]",11,0,11,1
11468,"['administrativo', 'conformar', 'decisao', 'decisao', 'decisao', 'entendimento', 'irregularidad', 'justicar', 'prazo', 'prazo', 'prazo', 'prever', 'processo', 'recurso', 'regiao', 'servidor', 'supremo', 'tramitar']","[1, 1, 3, 3, 3, 1, 1, 1, 3, 3, 3, 1, 1, 1, 1, 1, 1, 1]","[]","[]",18,0,18,1
11470,"['afp', 'autoridad', 'autoridad', 'autoridad', 'contabilizar', 'rejeitar', 'superar']","[1, 3, 3, 3, 1, 1, 1]","[]","[]",7,0,7,1
11471,"['afetado', 'comparacao', 'crescimento', 'crise', 'destacar', 'economia', 'equivalent', 'pib', 'vulnerabilidad', 'vulneravel', 'vulneravel', 'vulneravel']","[1, 1, 1, 1, 1, 1, 1, 1, 1, 3, 3, 3]","[]","[]",12,0,12,1
11472,"['aglomeracao', 'armazenamento', 'capitar', 'circulacao', 'contribuicao', 'crise', 'definitivo', 'especifico', 'estrategia', 'implementar', 'isolar', 'ministrar', 'ministrar', 'ministrar', 'necessidad', 'negativar', 'positivar', 'prever', 'prever', 'quarentenar', 'quarentenar', 'queiroga', 'queiroga', 'queiroga', 'queiroga', 'reducao', 'saudar', 'testagem', 'testagem']","[1, 1, 1, 1, 1, 1, 1, 1, 1, 1, 1, 3, 3, 3, 1, 1, 1, 2, 2, 2, 2, 4, 4, 4, 4, 1, 1, 2, 2]","[]","[]",29,0,29,1
11473,"['decisao', 'decisao', 'exministro', 'fase', 'integro', 'justicar', 'rejeitar', 'supremo', 'turma', 'varar', 'varar']","[2, 2, 1, 1, 1, 1, 1, 1, 1, 2, 2]","[]","[]",11,0,11,1
11475,"['distrito', 'integrant', 'integrant', 'investigacao', 'investigacao', 'posturar', 'recurso', 'sabado']","[1, 2, 2, 2, 2, 1, 1, 1]","['captar', 'espalhar', 'protestar']","[1, 1, 1]",8,3,11,1
11476,"['consorcio', 'correspondent', 'domingo', 'levantamento', 'milho']","[1, 1, 1, 1, 1]","[]","[]",5,0,5,1
11477,"['anticorpo', 'preliminar', 'rigoroso']","[1, 1, 1]","[]","[]",3,0,3,1
11480,"['concedido', 'converso', 'especialment', 'habitant', 'habitant', 'necessidad', 'positivar', 'propagacao', 'regiao', 'saudar', 'taxar', 'testagem', 'testagem']","[1, 1, 1, 2, 2, 1, 1, 1, 1, 1, 1, 2, 2]","['sacar']","[1]",13,1,14,1
11482,"['interpretar', 'interpretar', 'interpretar', 'ministrar', 'ministrar', 'orientacao', 'orientacao', 'orientacao', 'reafirmar', 'ribeiro', 'spaulo']","[3, 3, 3, 2, 2, 3, 3, 3, 1, 1, 1]","['atribuir']","[1]",11,1,12,1
11487,"['carla', 'sendo', 'sido', 'sido', 'tambem', 'zambelli']","[1, 1, 2, 2, 1, 1]","[]","[]",6,0,6,1
11489,"['periodo', 'propagacao', 'quarentenar', 'saudar', 'saudar', 'saudar']","[1, 1, 1, 3, 3, 3]","['espalhar', 'ilustrar', 'legendar']","[1, 1, 1]",6,3,9,1
11495,"['constituicao', 'decisao', 'diariament', 'funcionamento', 'machadar', 'magistrado', 'magistrado', 'presenciar', 'prever', 'reabertura', 'saudar', 'varar']","[1, 1, 1, 1, 1, 2, 2, 1, 1, 1, 1, 1]","[]","[]",12,0,12,1
11497,"['azevedo', 'biliao', 'congresso', 'despesa', 'despesa', 'destinar', 'economia', 'gued', 'ministrar', 'ministrar', 'pastar', 'prever', 'proposto', 'recurso', 'recurso', 'regrar']","[1, 1, 1, 2, 2, 1, 1, 1, 2, 2, 1, 1, 1, 2, 2, 1]","[]","[]",16,0,16,1
11499,"['alvaro', 'integrant', 'internar', 'internar', 'saudar', 'saudar']","[1, 1, 2, 2, 2, 2]","[]","[]",6,0,6,1
11501,"['afp', 'autoridad', 'desembarcar', 'passageiro', 'passageiro', 'portavoz', 'portavoz', 'previo', 'saudar', 'saudar', 'situacao', 'viagem']","[1, 1, 1, 2, 2, 2, 2, 1, 2, 2, 1, 1]","[]","[]",12,0,12,1
11502,"['exprefeito', 'guarulho', 'instituto', 'margem', 'resultado']","[1, 1, 1, 1, 1]","[]","[]",5,0,5,1
11503,"['abordagem', 'alerj', 'alerj', 'alerj', 'esquema', 'fabricio', 'flavio', 'flavio', 'gabinet', 'gabinet', 'investigacao', 'investigacao', 'investigacao', 'investigacao', 'legislativo', 'mendonca', 'mprj', 'mprj', 'nomeacao', 'queiroz', 'queiroz', 'queiroz', 'queiroz', 'rachadinha', 'republicanosrj']","[1, 3, 3, 3, 1, 1, 2, 2, 2, 2, 4, 4, 4, 4, 1, 1, 2, 2, 1, 4, 4, 4, 4, 1, 1]","['expulsar', 'supostament']","[1, 1]",25,2,27,1
11504,"['comportament', 'destinar', 'recurso', 'republico', 'superar']","[1, 1, 1, 1, 1]","[]","[]",5,0,5,1
11505,"['congresso', 'inquerito', 'integro', 'investigacao', 'ministrar', 'prazo', 'prorrogar', 'supremo']","[1, 1, 1, 1, 1, 1, 1, 1]","[]","[]",8,0,8,1
11506,"['biliao', 'biliao', 'decisao', 'fase', 'julgamento', 'julgamento', 'julgamento', 'ministrar', 'processo', 'recurso', 'supremo', 'tramitar', 'tramitar']","[2, 2, 1, 1, 3, 3, 3, 1, 1, 1, 1, 2, 2]","['sortear']","[1]",13,1,14,1
11507,"['domingo', 'feriar', 'interrupcao', 'saudar', 'saudar']","[1, 1, 1, 2, 2]","[]","[]",5,0,5,1
11511,"['client', 'especializar', 'levantamento']","[1, 1, 1]","['humanar', 'humanar']","[2, 2]",3,2,5,1
11512,"['conformar', 'crise', 'destacar', 'enfrentamento', 'infectar', 'levantamento', 'levantamento', 'mexico', 'mexico', 'quedo']","[1, 1, 1, 1, 1, 2, 2, 2, 2, 1]","[]","[]",10,0,10,1
11513,"['adhanom', 'ampliacao', 'converso', 'crise', 'desempenhar', 'fornecimento', 'materiaprima', 'ministrar', 'queiroga', 'respostar', 'saudar', 'saudar', 'saudar', 'surtir', 'tedro']","[1, 1, 1, 1, 1, 1, 1, 1, 1, 1, 3, 3, 3, 1, 1]","[]","[]",15,0,15,1
11515,"['domingo', 'parceria', 'parceria']","[1, 2, 2]","[]","[]",3,0,3,1
11519,"['arthur', 'demrj', 'gabinet', 'lira', 'lira', 'palacio', 'planalto', 'planalto', 'republicanosrj', 'transferir']","[1, 1, 1, 2, 2, 1, 2, 2, 1, 1]","[]","[]",10,0,10,1
11520,"['arthur', 'ccj', 'ccj', 'chefiar', 'colegiado', 'comissao', 'congresso', 'constituicao', 'discussao', 'distrito', 'justicar', 'lira', 'lira', 'planalto', 'presidir', 'reclamacao', 'resistencia', 'reuniao', 'sessao', 'sessao', 'supremo', 'surtir']","[1, 2, 2, 1, 1, 1, 1, 1, 1, 1, 1, 2, 2, 1, 1, 1, 1, 1, 2, 2, 1, 1]","['atirar']","[1]",22,1,23,1
11521,"['folhar', 'folhar', 'parceria', 'previsto', 'prtb', 'sabatino', 'sabatino', 'spaulo']","[2, 2, 1, 1, 1, 2, 2, 1]","[]","[]",8,0,8,1
11522,"['ambientar', 'congresso', 'coordenar', 'especifico', 'oficialment', 'privar']","[1, 1, 1, 1, 1, 1]","[]","[]",6,0,6,1
11523,"['calheiro']","[1]","[]","[]",1,0,1,1
11524,"['diagnosticar', 'equivalent', 'inglaterra', 'internar', 'saudar', 'suspeito']","[1, 1, 1, 1, 1, 1]","[]","[]",6,0,6,1
11525,"['balancar', 'sabado', 'saudar']","[1, 1, 1]","[]","[]",3,0,3,1
11530,"['bruno', 'gabi', 'jorg']","[1, 1, 1]","[]","[]",3,0,3,1
11536,"['adversario', 'decisao', 'decisao', 'decisao', 'integro', 'julgamento', 'recurso', 'ricardo', 'ricardo', 'tatto', 'tatto']","[1, 3, 3, 3, 1, 1, 1, 2, 2, 2, 2]","['usuario']","[1]",11,1,12,1
11537,"['alvorar', 'apreensao', 'bolsonarista', 'colegiado', 'decisao', 'decisao', 'gabinet', 'legislativo', 'ministrar', 'ministrar', 'ramagem', 'recordar', 'supremo']","[1, 1, 1, 1, 2, 2, 1, 1, 2, 2, 1, 1, 1]","['parir']","[1]",13,1,14,1
11539,"['academia', 'autoridad', 'domingo', 'estagio', 'etapa', 'fase', 'fase', 'fase', 'instituto', 'necessario', 'sendo', 'sendo']","[1, 1, 1, 1, 1, 3, 3, 3, 1, 1, 2, 2]","[]","[]",12,0,12,1
11540,"['afetado', 'associacao', 'cirurgico', 'cirurgico', 'constatar', 'instalacao', 'levantamento', 'levantamento', 'prever', 'privar', 'quedo', 'quedo', 'recuar', 'recurso', 'reducao', 'reducao', 'regiao', 'rocha', 'saudar', 'saudar', 'saudar', 'suspensao']","[1, 1, 2, 2, 1, 1, 2, 2, 1, 1, 2, 2, 1, 1, 2, 2, 1, 1, 3, 3, 3, 1]","[]","[]",22,0,22,1
11541,"['bbc', 'certeza', 'portavoz', 'tambem']","[1, 1, 1, 1]","[]","[]",4,0,4,1
11542,"['articulacao']","[1]","['pelar', 'usuario']","[1, 1]",1,2,3,1
11543,"['corpu', 'decisao', 'folhar', 'habea', 'humberto', 'inquerito', 'integrant', 'integro', 'justicar', 'martim', 'oficio', 'republico', 'supremo', 'suspensao', 'turma']","[1, 1, 1, 1, 1, 1, 1, 1, 1, 1, 1, 1, 1, 1, 1]","[]","[]",15,0,15,1
11549,"['consorcio', 'levantamento', 'pastar', 'sabado', 'sabado', 'sabado', 'saudar', 'saudar', 'superar']","[1, 1, 1, 3, 3, 3, 2, 2, 1]","[]","[]",9,0,9,1
11551,"['bandeirant', 'colaborar', 'decorrencia', 'epidemiologico', 'epidemiologico', 'gorinchteyn', 'gorinchteyn', 'internar', 'necessidad', 'palacio', 'reforcar', 'regrar', 'saudar']","[1, 1, 1, 2, 2, 2, 2, 1, 1, 1, 1, 1, 1]","['amigar']","[1]",13,1,14,1
11558,"['autoridad', 'autoridad', 'boletim', 'deslocamento', 'deslocamento', 'deslocamento', 'epidemiologico', 'feriar', 'infectar', 'intensivo', 'internar', 'necessario', 'propagacao', 'prorrogacao', 'regiao', 'regrar', 'republico', 'saudar', 'transmissao', 'velocidad']","[2, 2, 1, 3, 3, 3, 1, 1, 1, 1, 1, 1, 1, 1, 1, 1, 1, 1, 1, 1]","['realment']","[1]",20,1,21,1
11560,"['adicionar', 'colombio', 'colombio', 'colombio', 'colombio', 'contabilizar', 'decorrencia', 'duqu', 'importacao', 'instituto', 'ministrar', 'planar', 'possibilidad', 'recordar', 'saudar', 'sputnik', 'vigilancia']","[1, 4, 4, 4, 4, 1, 1, 1, 1, 1, 1, 1, 1, 1, 1, 1, 1]","[]","[]",17,0,17,1
11562,"['administrativo', 'arrecadar', 'despesa', 'recurso']","[1, 1, 1, 1]","[]","[]",4,0,4,1
11566,"['autoridad', 'disseminacao', 'domingo', 'fundamentar', 'internar', 'precedent', 'rejeitar', 'sigla']","[1, 1, 1, 1, 1, 1, 1, 1]","['agredir', 'ganhar']","[1, 1]",8,2,10,1
11568,"['acordo', 'distrito', 'exercicio', 'inicialment', 'integrant', 'nelson', 'observacao', 'proprio', 'ricardo', 'risco', 'submetido']","[1, 1, 1, 1, 1, 1, 1, 1, 1, 1, 1]","[]","[]",11,0,11,1
11569,"['dosar', 'iniciativo', 'organizador', 'previsto', 'respostar', 'saudar']","[1, 1, 1, 1, 1, 1]","[]","[]",6,0,6,1
11570,"['plano', 'reuniao', 'transmissao']","[1, 1, 1]","[]","[]",3,0,3,1
11571,"['isolar']","[1]","[]","[]",1,0,1,1
11572,"['araujo', 'sido']","[1, 1]","[]","[]",2,0,2,1
11574,"['autoridad', 'autoridad', 'autoridad', 'corpu', 'decisao', 'deltan', 'habea', 'julgamento', 'processo', 'recurso', 'supremo', 'supremo', 'supremo', 'suspeicao', 'suspeicao', 'turma', 'turma', 'varar']","[3, 3, 3, 1, 1, 1, 1, 1, 1, 1, 3, 3, 3, 2, 2, 2, 2, 1]","[]","[]",18,0,18,1
11575,"['cerimonia', 'hospitalizar', 'regiao', 'situacao', 'suspeito']","[1, 1, 1, 1, 1]","[]","[]",5,0,5,1
11576,"['dinamarca', 'estrategia', 'submetido']","[1, 1, 1]","['atirar']","[1]",3,1,4,1
11578,"['alerj', 'ambito', 'aplicacao', 'apreensao', 'claudio', 'claudio', 'constituicao', 'decisao', 'desvio', 'enfrentamento', 'exercicio', 'investigacao', 'justicar', 'justicar', 'legislativo', 'mello', 'quadro', 'recurso', 'wilson', 'witzel']","[1, 1, 1, 1, 2, 2, 1, 1, 1, 1, 1, 1, 2, 2, 1, 1, 1, 1, 1, 1]","[]","[]",20,0,20,1
11579,"['acordo', 'autoridad', 'converso', 'cooperacao', 'cooperacao', 'decisao', 'decisao', 'especialment', 'forcatarefa', 'justicar', 'justicar', 'lewandowski', 'lewandowski', 'martim', 'ministrar', 'pagamento', 'pastar', 'periodo', 'prever', 'relativo', 'ricardo', 'supremo']","[1, 1, 1, 2, 2, 2, 2, 1, 1, 2, 2, 2, 2, 1, 1, 1, 1, 1, 1, 1, 1, 1]","[]","[]",22,0,22,1
11580,"['decisao', 'decisao', 'espanha', 'fase', 'previsto', 'respectivament', 'situacao', 'suspensao', 'tornear']","[2, 2, 1, 1, 1, 1, 1, 1, 1]","[]","[]",9,0,9,1
11584,"['adicionar', 'folhar', 'impactar', 'integro', 'limitacao', 'passageiro', 'portavoz', 'viagem']","[1, 1, 1, 1, 1, 1, 1, 1]","[]","[]",8,0,8,1
11586,"['arthur', 'chefiar', 'demrj', 'favorito', 'ideologico', 'lira', 'lira', 'lira', 'palacio', 'planalto', 'preocupacao', 'reuniao', 'rossi']","[1, 1, 1, 1, 1, 3, 3, 3, 1, 1, 1, 1, 1]","[]","[]",13,0,13,1
11588,"['acordo', 'arthur', 'constituicao', 'emenda', 'lira', 'plenario', 'possibilidad', 'ppal', 'prever', 'proposta', 'proposta']","[1, 1, 1, 1, 1, 1, 1, 1, 1, 2, 2]","[]","[]",11,0,11,1
11589,"['alcolumbr', 'alcolumbr', 'bancada', 'bancada', 'broadcast', 'conformar', 'congresso', 'decisao', 'demap', 'destinar', 'flavio', 'gabinet', 'gabinet', 'gabinet', 'gabinet', 'integrant', 'pratico', 'regrar', 'servidor', 'servidor', 'sigla', 'suportar']","[2, 2, 2, 2, 1, 1, 1, 1, 1, 1, 1, 4, 4, 4, 4, 1, 1, 1, 2, 2, 1, 1]","['despejar', 'legendar', 'legendar', 'legendar']","[1, 3, 3, 3]",22,4,26,1
11591,"['argumentar', 'ausencia', 'intensivo', 'internar', 'justicar', 'levantamento', 'levantamento', 'quilometro', 'respostar', 'transferencia', 'transferencia', 'transferencia', 'transferir']","[1, 1, 1, 1, 1, 2, 2, 1, 1, 3, 3, 3, 1]","['sequer']","[1]",13,1,14,1
11592,"['adhanom', 'afp', 'afp', 'afp', 'afp', 'afp', 'afp', 'afp', 'afp', 'afp', 'afp', 'afp', 'afp', 'afp', 'afp', 'afp', 'afp', 'afp', 'afp', 'afp', 'afp', 'antonio', 'anuncio', 'californio', 'celebrar', 'cerimonia', 'checo', 'cirurgico', 'client', 'companhia', 'convencao', 'convencao', 'desembarcar', 'diagnosticar', 'disseminacao', 'disseminacao', 'distrito', 'epicentro', 'epidemiar', 'epidemiar', 'epidemiar', 'epidemiar', 'epidemiar', 'espanha', 'espanha', 'externo', 'funcao', 'funcao', 'genoma', 'guarulho', 'guarulho', 'guarulho', 'hubei', 'infectar', 'infectar', 'infectar', 'infectar', 'instalacao', 'instituto', 'instituto', 'integrant', 'integrant', 'internar', 'isolar', 'isolar', 'kong', 'kong', 'kong', 'kong', 'kong', 'kong', 'liderar', 'mexico', 'mexico', 'movimentacao', 'necessario', 'orientacao', 'palacio', 'passageiro', 'passageiro', 'passageiro', 'passageiro', 'passageiro', 'passageiro', 'passageiro', 'passageiro', 'passageiro', 'passageiro', 'positivar', 'positivar', 'prazo', 'preocupacao', 'preocupacao', 'presenca', 'propagacao', 'provincia', 'provincia', 'quarentenar', 'quarentenar', 'regiao', 'reuter', 'reuter', 'reuter', 'reuter', 'reuter', 'reuter', 'reuter', 'reuter', 'reuter', 'reuter', 'reuter', 'reuter', 'reuter', 'reuter', 'reuter', 'reuter', 'reuter', 'reuter', 'rocha', 'saudar', 'saudar', 'saudar', 'surtir', 'surtir', 'surtir', 'surtir', 'suspeito', 'suspeito', 'suspeito', 'suspeito', 'tedro', 'toquio', 'toquio', 'transferir', 'transferir', 'transmissao', 'transmissao', 'transmissao', 'tripulacao', 'turistico', 'velocidad', 'visitant', 'visitant', 'visitant', 'xinhua', 'xinhua', 'xinhua', 'xinhua', 'xinhua', 'xinhua', 'xinhua', 'xinhua']","[1, 20, 20, 20, 20, 20, 20, 20, 20, 20, 20, 20, 20, 20, 20, 20, 20, 20, 20, 20, 20, 1, 1, 1, 1, 1, 1, 1, 1, 1, 2, 2, 1, 1, 2, 2, 1, 1, 5, 5, 5, 5, 5, 2, 2, 1, 2, 2, 1, 3, 3, 3, 1, 4, 4, 4, 4, 1, 2, 2, 2, 2, 1, 2, 2, 6, 6, 6, 6, 6, 6, 1, 2, 2, 1, 1, 1, 1, 10, 10, 10, 10, 10, 10, 10, 10, 10, 10, 2, 2, 1, 2, 2, 1, 1, 2, 2, 2, 2, 1, 18, 18, 18, 18, 18, 18, 18, 18, 18, 18, 18, 18, 18, 18, 18, 18, 18, 18, 1, 3, 3, 3, 4, 4, 4, 4, 4, 4, 4, 4, 1, 2, 2, 2, 2, 3, 3, 3, 1, 1, 1, 3, 3, 3, 8, 8, 8, 8, 8, 8, 8, 8]","['parir', 'parir', 'parir', 'torrar', 'usuario', 'vazio', 'vazio', 'vazio', 'verificar']","[3, 3, 3, 1, 1, 3, 3, 3, 1]",152,9,161,1
11594,"['desenvolvido', 'destinar', 'destinar', 'domingo', 'inicialment', 'ritmar', 'saudar']","[1, 2, 2, 1, 1, 1, 1]","[]","[]",7,0,7,1
11595,"['ambientar', 'gorinchteyn', 'situacao']","[1, 1, 1]","[]","[]",3,0,3,1
11596,"['biliao', 'biliao', 'dificuldad', 'escassez', 'esquema', 'recurso', 'saudar']","[2, 2, 1, 1, 1, 1, 1]","[]","[]",7,0,7,1
11597,"['associacao', 'condicao', 'condicao', 'congresso', 'domingo', 'economia', 'folhar', 'gued', 'integro', 'ministrar', 'mudanca', 'planar', 'prever', 'prever', 'proposto', 'taxar', 'tributario', 'tributario', 'tributario', 'videoconferencia']","[1, 2, 2, 1, 1, 1, 1, 1, 1, 1, 1, 1, 2, 2, 1, 1, 3, 3, 3, 1]","[]","[]",20,0,20,1
11598,"['araujo', 'decisao', 'decisao', 'ernesto', 'reforcar', 'respostar']","[1, 2, 2, 1, 1, 1]","[]","[]",6,0,6,1
11600,"['atuam', 'autoridad', 'desigualdad', 'hipertensao', 'obesidad', 'planar', 'saudar', 'saudar', 'taxar', 'taxar', 'tendencia']","[1, 1, 1, 1, 1, 1, 2, 2, 2, 2, 1]","['motorista']","[1]",11,1,12,1
11602,"['alcolumbr', 'bancada', 'bastidor', 'decisao', 'demap', 'demmg', 'expectativa', 'pacheco', 'pacheco', 'pacheco', 'pacheco', 'suportar']","[1, 1, 1, 1, 1, 1, 1, 4, 4, 4, 4, 1]","[]","[]",12,0,12,1
11603,"['aglomeracao', 'celebrar', 'feriar', 'feriar', 'feriar', 'mandatario']","[1, 1, 3, 3, 3, 1]","[]","[]",6,0,6,1
11605,"['afetado', 'afp', 'balancar', 'espanha', 'espanha', 'europeu']","[1, 1, 1, 2, 2, 1]","[]","[]",6,0,6,1
11606,"['autoridad', 'compromisso', 'condicao', 'crescimento', 'despesa', 'enfatizar', 'juro', 'manutencao', 'monetario', 'monetario', 'oficialment', 'orientacao', 'orientacao', 'orientacao', 'regrar', 'reuter', 'subir', 'variacao']","[1, 1, 1, 1, 1, 1, 1, 1, 2, 2, 1, 3, 3, 3, 1, 1, 1, 1]","[]","[]",18,0,18,1
11607,"['atuacao', 'autorizacao', 'domingo', 'itamarati', 'passageiro', 'passageiro', 'periodo', 'piorar', 'piorar', 'positivar', 'reclamacao', 'rejeitar', 'respostar']","[1, 1, 1, 1, 2, 2, 1, 2, 2, 1, 1, 1, 1]","[]","[]",13,0,13,1
11609,"['alvorar', 'atrasar', 'converso', 'crise', 'desafiar', 'justificativo', 'mergulhar', 'palacio', 'respostar']","[1, 1, 1, 1, 1, 1, 1, 1, 1]","[]","[]",9,0,9,1
11614,"['autoridad', 'destacar', 'examinar', 'isolar', 'precaucao', 'propagacao', 'quarentenar', 'saudar', 'temor']","[1, 1, 1, 1, 1, 1, 1, 1, 1]","[]","[]",9,0,9,1
11616,"['consorcio', 'domingo', 'esquema', 'feriar', 'feriar', 'infectar', 'infectar', 'intervalar', 'levantamento', 'plantao', 'quedo', 'saudar']","[1, 1, 1, 2, 2, 2, 2, 1, 1, 1, 1, 1]","[]","[]",12,0,12,1
11618,"['alteracao', 'aplicacao', 'autoridad', 'cepa', 'comportamento', 'desenvolvimento', 'deteccao', 'efetividad', 'epidemiar', 'espanha', 'europeu', 'impactar', 'implementar', 'infeccioso', 'michael', 'monitoramento', 'mutacao', 'mutacao', 'mutacao', 'mutacao', 'mutacao', 'mutacao', 'mutacao', 'positivar', 'presenca', 'proliferacao', 'proliferacao', 'propagacao', 'respostar', 'saudar', 'saudar', 'sigla', 'situacao', 'taxar', 'transmissao', 'vigilancia', 'voo']","[1, 1, 1, 1, 1, 1, 1, 1, 1, 1, 1, 1, 1, 1, 1, 1, 7, 7, 7, 7, 7, 7, 7, 1, 1, 2, 2, 1, 1, 2, 2, 1, 1, 1, 1, 1, 1]","['espalhar', 'ganhar', 'humanar', 'invadir', 'realment', 'sobrar', 'sortir']","[1, 1, 1, 1, 1, 1, 1]",37,7,44,1
11622,"['acompanhamento', 'acordo']","[1, 1]","[]","[]",2,0,2,1
11623,"['decorrencia', 'desenvolvido', 'domingo', 'habitant', 'prioridad', 'saudar', 'saudar']","[1, 1, 1, 1, 1, 2, 2]","['espalhar']","[1]",7,1,8,1
11624,"['colaborar', 'investigacao', 'positivar']","[1, 1, 1]","['fraudar', 'fraudar']","[2, 2]",3,2,5,1
11627,"['desafiar', 'desafiar', 'estimular']","[2, 2, 1]","['compartilhar', 'imagem', 'parir', 'usuario']","[1, 1, 1, 1]",3,4,7,1
11628,"['convencao', 'lancamento', 'presenca', 'saudar', 'saudar']","[1, 1, 1, 2, 2]","['humanar', 'inscricao']","[1, 1]",5,2,7,1
11629,"['aplicacao', 'disseminacao', 'extensao', 'infectar', 'infectar', 'necessidad', 'prazo', 'prazo', 'presenca', 'rastreamento', 'triagem']","[1, 1, 1, 2, 2, 1, 2, 2, 1, 1, 1]","[]","[]",11,0,11,1
11633,"['associacao', 'decisao', 'levantamento', 'periodo', 'piorar', 'previsao', 'processo', 'reabertura', 'reabrir', 'reportar', 'situacao']","[1, 1, 1, 1, 1, 1, 1, 1, 1, 1, 1]","[]","[]",11,0,11,1
11634,"['domingo', 'gabbardo', 'hospitalizar', 'infectar', 'inglaterra', 'saudar', 'saudar', 'saudar', 'secretarioexecutivo', 'suspeito', 'totalizar', 'transmissao', 'transmissao', 'viagem']","[1, 1, 1, 1, 1, 3, 3, 3, 1, 1, 1, 2, 2, 1]","[]","[]",14,0,14,1
11635,"['bolsonarista', 'internar', 'internar', 'oswaldo', 'saudar']","[1, 2, 2, 1, 1]","[]","[]",5,0,5,1
11636,"['coletivo', 'coletivo', 'corpu', 'corpu', 'decisao', 'decisao', 'fabricio', 'flavio', 'habea', 'habea', 'justicar', 'ministrar', 'necessidad', 'plantao', 'queiroz', 'queiroz', 'recurso', 'risco', 'situacao']","[2, 2, 2, 2, 2, 2, 1, 1, 2, 2, 1, 1, 1, 1, 2, 2, 1, 1, 1]","[]","[]",19,0,19,1
11637,"['anticorpo', 'anticorpo', 'anticorpo', 'assintomatico', 'comportamento', 'henriqu', 'imunizacao', 'infectar', 'intenso', 'letalidad', 'ministrar', 'presenca', 'presenca', 'regiao', 'ritmar', 'saudar', 'saudar', 'submetido', 'taxar', 'velocidad', 'velocidad']","[3, 3, 3, 1, 1, 1, 1, 1, 1, 1, 1, 2, 2, 1, 1, 2, 2, 1, 1, 2, 2]","['espalhar', 'ganhar']","[1, 1]",21,2,23,1
11641,"['ansiedad', 'boletim', 'crise', 'saudar', 'surtir']","[1, 1, 1, 1, 1]","[]","[]",5,0,5,1
11642,"['celso', 'folhar', 'parceria', 'spaulo']","[1, 1, 1, 1]","[]","[]",4,0,4,1
11644,"['academiar', 'anvisa', 'anvisa', 'anvisa', 'anvisa', 'anvisa', 'autorizacao', 'autorizacao', 'carat', 'comprometido', 'decisao', 'desenvolvido', 'dosar', 'mexico', 'necessario', 'obtido', 'parceria', 'parceria', 'prazo', 'regulamentar', 'reuniao', 'saudar', 'temporario', 'triagem', 'vigilancia']","[1, 5, 5, 5, 5, 5, 2, 2, 1, 1, 1, 1, 1, 1, 1, 1, 2, 2, 1, 1, 1, 1, 1, 1, 1]","['bandeiro', 'humanar', 'verificar']","[1, 1, 1]",25,3,28,1
11648,"['carla', 'colunista', 'colunista', 'economia', 'gued', 'gued', 'ministrar', 'parceria', 'privar', 'revogar', 'saudar', 'saudar']","[1, 2, 2, 1, 2, 2, 1, 1, 1, 1, 2, 2]","['minutar']","[1]",12,1,13,1
11649,"['alteracao', 'destinar', 'distrito', 'dosar', 'esquema', 'fase', 'fluxo', 'igualitario', 'instituto', 'necessario', 'operacionalizacao', 'pastar', 'periodo', 'planar', 'previsao', 'publicoalvo', 'saudar', 'saudar']","[1, 1, 1, 1, 1, 1, 1, 1, 1, 1, 1, 1, 1, 1, 1, 1, 2, 2]","[]","[]",18,0,18,1
11653,"['autoridad', 'autorizacao', 'boletim', 'depoimento', 'internar', 'submetido']","[1, 1, 1, 1, 1, 1]","[]","[]",6,0,6,1
11655,"['discussao', 'exministro', 'exministro', 'henriqu', 'interrupcao', 'ministrar', 'nelson', 'pastar', 'saudar', 'saudar', 'situacao', 'teich', 'teich']","[1, 2, 2, 1, 1, 1, 1, 1, 2, 2, 1, 2, 2]","['atribuir']","[1]",13,1,14,1
11658,"['dificuldad', 'infectar', 'mutacao', 'orientacao', 'pastar', 'saudar']","[1, 1, 1, 1, 1, 1]","['espalhar']","[1]",6,1,7,1
11659,"['atuacao', 'exercicio', 'internar', 'sabado']","[1, 1, 1, 1]","[]","[]",4,0,4,1
11660,"['congresso', 'decisao', 'desenvolvimento', 'folhar', 'folhar', 'inovacao', 'instituto', 'integro', 'orcamentaria', 'orcamentaria', 'prever', 'subordinar']","[1, 1, 1, 2, 2, 1, 1, 1, 2, 2, 1, 1]","['humanar']","[1]",12,1,13,1
11668,"['concedido', 'consequencia', 'decisao', 'decisao', 'decisao', 'emprestimo', 'justicar', 'justicar', 'mello', 'necessario', 'necessario', 'normalment', 'parcelar', 'periodo', 'periodo', 'prazo', 'prever', 'recurso', 'recurso', 'reforcar', 'reuter', 'saudar', 'suspensao', 'varar']","[1, 1, 3, 3, 3, 1, 2, 2, 1, 2, 2, 1, 1, 2, 2, 1, 1, 2, 2, 1, 1, 1, 1, 1]","[]","[]",24,0,24,1
11669,"['boletim', 'claudio', 'colaboracao', 'colaborar', 'domingo', 'epidemiologico', 'exercicio', 'feriar', 'feriar', 'fluminens', 'funcionamento', 'intenso', 'jorg', 'periodo', 'propagacao']","[1, 1, 1, 1, 1, 1, 1, 2, 2, 1, 1, 1, 1, 1, 1]","[]","[]",15,0,15,1
11674,"['cirurgico', 'expectativa', 'prazo', 'proposto', 'pulmonar', 'saudar', 'saudar', 'saudar', 'suspeito', 'suspeito', 'ventilador']","[1, 1, 1, 1, 1, 3, 3, 3, 2, 2, 1]","[]","[]",11,0,11,1
11675,"['afastamento', 'exprefeito', 'exprefeito', 'justicar', 'saudar', 'suspeito', 'wilson', 'witzel', 'witzel']","[1, 2, 2, 1, 1, 1, 1, 2, 2]","['fraudar']","[1]",9,1,10,1
11679,"['arrecadar', 'discussao', 'discussao', 'epidemiar', 'parceria', 'recurso', 'saudar']","[1, 2, 2, 1, 1, 1, 1]","[]","[]",7,0,7,1
11680,"['assistencia', 'autorizacao', 'contrato', 'desvio', 'fase', 'flavio', 'flavio', 'fundacao', 'recurso', 'varar']","[1, 1, 1, 1, 1, 2, 2, 1, 1, 1]","[]","[]",10,0,10,1
11683,"['claudio', 'estagio', 'henriqu', 'impactar', 'iniciativo', 'instituto', 'privar', 'saudar', 'saudar', 'saudar', 'saudar']","[1, 1, 1, 1, 1, 1, 1, 4, 4, 4, 4]","[]","[]",11,0,11,1
11684,"['abordagem', 'alternativo', 'ambientar', 'comportament', 'converso', 'cronica', 'dedicar', 'enfatizar', 'enxergar', 'equilibrio', 'estatistico', 'importancia', 'necessidad', 'reuniao', 'saudar', 'saudar', 'saudar', 'saudar', 'saudar', 'situacao']","[1, 1, 1, 1, 1, 1, 1, 1, 1, 1, 1, 1, 1, 1, 5, 5, 5, 5, 5, 1]","['escutar', 'humanar']","[1, 1]",20,2,22,1
11688,"['dosar', 'dosar', 'intervalar', 'ministrar', 'reuter', 'sabado', 'saudar', 'vulneravel']","[2, 2, 1, 1, 1, 1, 1, 1]","[]","[]",8,0,8,1
11689,"['agravar', 'ansiedad', 'aspecto', 'especialment', 'esquema', 'instituto', 'mello', 'rotina', 'situacao']","[1, 1, 1, 1, 1, 1, 1, 1, 1]","[]","[]",9,0,9,1
11690,"[]","[]","[]","[]",0,0,0,1
11695,"['aprovacao', 'avancar', 'desenvolvido', 'estagio', 'reuter', 'reuter', 'santiago']","[1, 1, 1, 1, 2, 2, 1]","[]","[]",7,0,7,1
11696,"['anuncio', 'autoridad', 'desenvolvido', 'desenvolvido', 'fase', 'impactar', 'instituto', 'reuniao', 'saudar']","[1, 1, 2, 2, 1, 1, 1, 1, 1]","[]","[]",9,0,9,1
11697,"['autoridad', 'equipamento', 'importacao', 'mantido']","[1, 1, 1, 1]","['nobel']","[1]",4,1,5,1
11698,"['cenario', 'comunitario', 'crise', 'dificuldad', 'equipamento', 'equipamento', 'equipamento', 'escassez', 'henriqu', 'ministrar', 'ministrar', 'ministrar', 'reforcar', 'relaxar', 'saudar', 'saudar']","[1, 1, 1, 1, 3, 3, 3, 1, 1, 3, 3, 3, 1, 1, 2, 2]","['parir', 'parir']","[2, 2]",16,2,18,1
11699,"['acordo', 'araujo', 'augusto', 'colaboracao', 'decisao', 'delacao', 'edson', 'exgovernador', 'exgovernador', 'fachin', 'fachin', 'gabinet', 'revogar', 'supremo', 'tambem']","[1, 1, 1, 1, 1, 1, 1, 2, 2, 2, 2, 1, 1, 1, 1]","[]","[]",15,0,15,1
11700,"['acordo', 'acordo', 'ambientar', 'carat', 'cooperacao', 'enfatizar', 'espanha', 'espanha', 'estrategico', 'estrategico', 'europeu', 'europeu', 'europeu', 'itamarati', 'perspectivo', 'preservar', 'prever', 'prioritario', 'prioritario', 'sustentabilidad', 'sustentabilidad']","[2, 2, 1, 1, 1, 1, 2, 2, 2, 2, 3, 3, 3, 1, 1, 1, 1, 2, 2, 2, 2]","[]","[]",21,0,21,1
11701,"['respostar', 'respostar', 'situacao']","[2, 2, 1]","['verificar']","[1]",3,1,4,1
11706,"['europeu', 'infectar', 'journal', 'minimizar', 'periodo', 'positivar', 'positivar', 'positivar', 'positivar', 'positivar', 'positivar', 'regiao']","[1, 1, 1, 1, 1, 6, 6, 6, 6, 6, 6, 1]","[]","[]",12,0,12,1
11707,"['adotada', 'crise', 'desenvolvimento', 'destinar', 'lorenzoni', 'ministrar', 'ministrar', 'onyx', 'onyx', 'velocidad']","[1, 1, 1, 1, 1, 2, 2, 2, 2, 1]","[]","[]",10,0,10,1
11710,"['compromisso', 'crise', 'crise', 'esperancar', 'exgovernador', 'moderno', 'parceria']","[1, 2, 2, 1, 1, 1, 1]","['gleisi']","[1]",7,1,8,1
11712,"['comparacao', 'decorrencia', 'hospitalizar', 'intensivo', 'quedo', 'saudar', 'saudar', 'saudar', 'tendencia', 'vespera']","[1, 1, 1, 1, 1, 3, 3, 3, 1, 1]","[]","[]",10,0,10,1
11713,"['calheiro', 'comissao', 'consorcio', 'enfrentamento', 'federar', 'governista', 'governista', 'integro', 'investigacao', 'mdbal', 'mdbal', 'nogueira', 'oficio', 'recurso', 'relativo', 'remessar', 'republico', 'requerimento', 'respirador', 'respostar', 'respostar']","[1, 1, 1, 1, 1, 2, 2, 1, 1, 2, 2, 1, 1, 1, 1, 1, 1, 1, 1, 2, 2]","['espalhar']","[1]",21,1,22,1
11717,"['anvisa', 'anvisa', 'aprovacao', 'congresso', 'exportacao', 'exportacao', 'pratico', 'sputnik', 'sputnik', 'vigilancia']","[2, 2, 1, 1, 2, 2, 1, 2, 2, 1]","[]","[]",10,0,10,1
11721,"['integro', 'regiao', 'respostar', 'secom', 'secom']","[1, 1, 1, 2, 2]","[]","[]",5,0,5,1
11722,"['colegio', 'empatar', 'expressar', 'instituto', 'margem', 'minimizar', 'mudanca', 'prever', 'significativo']","[1, 1, 1, 1, 1, 1, 1, 1, 1]","['acidentar', 'manipular']","[1, 1]",9,2,11,1
11723,"['condicao', 'congresso', 'descumprir', 'dosar', 'integro', 'mantido', 'pastar', 'regrar', 'regrar', 'risco', 'saudar', 'saudar', 'saudar']","[1, 1, 1, 1, 1, 1, 1, 2, 2, 1, 3, 3, 3]","['cbn', 'cbn']","[2, 2]",13,2,15,1
11724,"['administrativo', 'periodo', 'surtir', 'visitant', 'visitant']","[1, 1, 1, 2, 2]","['parir', 'torrar', 'torrar', 'torrar', 'torrar']","[1, 4, 4, 4, 4]",5,5,10,1
11727,"['academiar', 'alternativo', 'associacao', 'biliao', 'campino', 'comissao', 'confederacao', 'converso', 'espirito', 'exprefeito', 'flavio', 'necessidad', 'preventivo', 'proposto', 'saudar', 'saudar', 'wellington', 'wellington']","[1, 1, 1, 1, 1, 1, 1, 1, 1, 1, 1, 1, 1, 1, 2, 2, 2, 2]","[]","[]",18,0,18,1
11728,"['biliao', 'imunizacao', 'logistico', 'logistico', 'prorrogacao', 'provisorio']","[1, 1, 2, 2, 1, 1]","[]","[]",6,0,6,1
11729,"['adulto', 'adulto', 'associacao', 'contagioso', 'contagioso', 'epidemiar', 'epidemiar', 'incerteza', 'infectar', 'metropolitano', 'periodo', 'propagacao', 'regiao', 'regiao', 'saudar']","[2, 2, 1, 2, 2, 2, 2, 1, 1, 1, 1, 1, 2, 2, 1]","['parir']","[1]",15,1,16,1
11731,"['empatar', 'margem']","[1, 1]","['intitular']","[1]",2,1,3,1
11735,"['adulto', 'diminuicao', 'folhar', 'funcionamento', 'margem', 'regiao', 'spaulo']","[1, 1, 1, 1, 1, 1, 1]","[]","[]",7,0,7,1
11736,"['ambito', 'argumentar', 'decisao', 'decisao', 'domingo', 'flavio', 'flavio', 'flavio', 'investigacao', 'justicar', 'justicar', 'privilegiar', 'proferir', 'rachadinha', 'reconhecimento', 'republicanosrj', 'republico', 'republico', 'turma', 'varar']","[1, 1, 2, 2, 1, 3, 3, 3, 1, 2, 2, 1, 1, 1, 1, 1, 2, 2, 1, 1]","[]","[]",20,0,20,1
11737,"['comissao', 'comissao', 'economia', 'espanha', 'esquema', 'esquema', 'europeu', 'iniciativo', 'jornada']","[2, 2, 1, 1, 2, 2, 1, 1, 1]","['ganhar']","[1]",9,1,10,1
11738,"['comissao', 'fase', 'individuar', 'instalacao', 'integrant', 'treinamento', 'treino', 'treino']","[1, 1, 1, 1, 1, 1, 2, 2]","['ganhar']","[1]",8,1,9,1
11739,"['calculo', 'distrito', 'distrito', 'sabado', 'saudar']","[1, 2, 2, 1, 1]","[]","[]",5,0,5,1
11740,"['anvisa', 'anvisa', 'anvisa', 'autoridad', 'cirurgico', 'comunitario', 'desembarcar', 'desembarcar', 'desembarcar', 'domingo', 'domingo', 'equipamento', 'fluminens', 'humanitario', 'humanitario', 'passageiro', 'passageiro', 'passageiro', 'passageiro', 'passageiro', 'passageiro', 'passageiro', 'precaucao', 'saudar', 'suspeito', 'transmissao', 'tripulacao', 'turista', 'turista', 'turista', 'viagem', 'viagem', 'vigilancia', 'voo']","[3, 3, 3, 1, 1, 1, 3, 3, 3, 2, 2, 1, 1, 2, 2, 7, 7, 7, 7, 7, 7, 7, 1, 1, 1, 1, 1, 3, 3, 3, 2, 2, 1, 1]","[]","[]",34,0,34,1
11741,"['comissao', 'comissao', 'compromisso', 'convencao', 'decisao', 'exercicio', 'liderar', 'manutencao', 'sigla', 'vespera']","[2, 2, 1, 1, 1, 1, 1, 1, 1, 1]","[]","[]",10,0,10,1
11742,"['crescimento', 'economia', 'hospitalizacao', 'infectar', 'infectar', 'ministrar', 'prever', 'saudar', 'velocidad']","[1, 1, 1, 2, 2, 1, 1, 1, 1]","[]","[]",9,0,9,1
11745,"['afastamento', 'domingo', 'precandidato', 'transmissao']","[1, 1, 1, 1]","['viralizado']","[1]",4,1,5,1
11748,"['instituto', 'intensivo', 'necessidad', 'pereira', 'reforcar']","[1, 1, 1, 1, 1]","[]","[]",5,0,5,1
11749,"['adotada', 'anteontem', 'atrasar', 'autoridad', 'compilar', 'conformar', 'conformar', 'enxergar', 'fundamentar', 'implementar', 'justicar', 'negativar', 'reflexo', 'reflexo', 'regrar', 'reportar', 'surtir', 'taxar']","[1, 1, 1, 1, 1, 2, 2, 1, 1, 1, 1, 1, 2, 2, 1, 1, 1, 1]","['circular']","[1]",18,1,19,1
11754,"['aprovacao', 'aprovacao', 'pfizerbiontech', 'pfizerbiontech']","[2, 2, 2, 2]","[]","[]",4,0,4,1
11758,"['afastamento', 'apreensao', 'exministro', 'justicar', 'justicar', 'ministrar', 'wilson', 'witzel', 'witzel', 'witzel']","[1, 1, 1, 2, 2, 1, 1, 3, 3, 3]","['gravacao']","[1]",10,1,11,1
11759,"['afp', 'proximo', 'sputnik', 'treinamento', 'treinamento']","[1, 1, 1, 2, 2]","[]","[]",5,0,5,1
11760,"['consorcio', 'equivalent', 'informaco', 'levantamento', 'milho', 'periodo']","[1, 1, 1, 1, 1, 1]","[]","[]",6,0,6,1
11761,"['anteontem', 'desenvolvido', 'desenvolvimento', 'fase', 'saudar', 'toquio']","[1, 1, 1, 1, 1, 1]","[]","[]",6,0,6,1
11762,"['ambientar', 'ambientar', 'balancar', 'complicacao', 'equilibrio', 'individuar', 'obesidad', 'obesidad', 'obesidad', 'positivar', 'saudar', 'situacao', 'taxar']","[2, 2, 1, 1, 1, 1, 3, 3, 3, 1, 1, 1, 1]","[]","[]",13,0,13,1
11763,"['facilitar', 'positivar', 'positivar', 'positivar']","[1, 3, 3, 3]","['falsar', 'falsar', 'falsar']","[3, 3, 3]",4,3,7,1
11764,"['instituto']","[1]","[]","[]",1,0,1,1
11766,"['afetado', 'curvo', 'portavoz', 'saudar']","[1, 1, 1, 1]","['circular']","[1]",4,1,5,1
11767,"['anuncio', 'compromisso', 'diariament', 'implementar', 'levantamento', 'pratico', 'preocupacao', 'privar', 'recurso', 'regrar', 'regrar', 'respirador', 'rotina', 'sancao']","[1, 1, 1, 1, 1, 1, 1, 1, 1, 2, 2, 1, 1, 1]","['ganhar']","[1]",14,1,15,1
11769,"['economia', 'europeu', 'isolar', 'justicar', 'mudanca', 'parceiro', 'prioridad']","[1, 1, 1, 1, 1, 1, 1]","[]","[]",7,0,7,1
11772,"['compilar', 'curvo', 'domingo', 'estatistico', 'levantamento', 'quedo', 'reforcar', 'reuter', 'saudar', 'saudar', 'subir', 'tendencia', 'tendencia']","[1, 1, 1, 1, 1, 1, 1, 1, 2, 2, 1, 2, 2]","[]","[]",13,0,13,1
11773,"['afp', 'coreia', 'coreia', 'fronteiro', 'isolar']","[1, 2, 2, 1, 1]","['desfilar']","[1]",5,1,6,1
11775,"['condicao', 'condicao', 'condicao', 'decisao', 'especializar', 'internar', 'justicar']","[3, 3, 3, 1, 1, 1, 1]","['menino', 'perdao']","[1, 1]",7,2,9,1
11777,"['apreensao', 'biliao', 'equivalent', 'esquema', 'esquema', 'fase', 'forcatarefa', 'investigacao', 'volumar']","[1, 1, 1, 2, 2, 1, 1, 1, 1]","[]","[]",9,0,9,1
11778,"['avancar', 'crescimento', 'desenvolvimento', 'especializar', 'facilitar', 'facilitar', 'funcao', 'fundamentar', 'instituto']","[1, 1, 1, 1, 2, 2, 1, 1, 1]","[]","[]",9,0,9,1
11781,"['biliao', 'biliao', 'biliao', 'biliao', 'cenario', 'comparacao', 'conjuntar', 'economia', 'economia', 'espanha', 'europeu', 'impactar', 'privar', 'quarentenar', 'viagem', 'viagem', 'viajant', 'visitant', 'visitant']","[4, 4, 4, 4, 1, 1, 1, 2, 2, 1, 1, 1, 1, 1, 2, 2, 1, 2, 2]","[]","[]",19,0,19,1
11782,"['aliviar', 'avancar', 'compilar', 'especifico', 'hospitalizacao', 'infectar', 'necessario', 'respostar', 'saudar', 'saudar']","[1, 1, 1, 1, 1, 1, 1, 1, 2, 2]","[]","[]",10,0,10,1
11784,"['afastamento', 'afetado', 'amplo', 'apreensao', 'arthur', 'bastidor', 'colegiado', 'colegiado', 'condenacao', 'condenacao', 'condenacao', 'congresso', 'constituicao', 'decisao', 'decisao', 'destinar', 'elaborar', 'emendar', 'impactar', 'justicar', 'justicar', 'lira', 'mudanca', 'mudanca', 'ppal', 'proposto', 'proposto', 'pslrj', 'regrar', 'regrar', 'significativo', 'silveiro', 'temporario']","[1, 1, 1, 1, 1, 1, 2, 2, 3, 3, 3, 1, 1, 2, 2, 1, 1, 1, 1, 2, 2, 1, 2, 2, 1, 2, 2, 1, 2, 2, 1, 1, 1]","['estuprar', 'rosario']","[1, 1]",33,2,35,1
11786,"['arthur', 'ausencia', 'demrj', 'destacar', 'emprestimo', 'esquema', 'esquema', 'estrategico', 'folhar', 'justicar', 'legislativo', 'liderar', 'lira', 'lira', 'lira', 'lira', 'movimentacao', 'obtido', 'pagamento', 'palacio', 'planalto', 'rachadinha', 'republico']","[1, 1, 1, 1, 1, 2, 2, 1, 1, 1, 1, 1, 4, 4, 4, 4, 1, 1, 1, 1, 1, 1, 1]","[]","[]",23,0,23,1
11789,"['recordar']","[1]","['secreto']","[1]",1,1,2,1
11790,"['celebrar', 'lancamento', 'quarentenar', 'quarentenar']","[1, 1, 2, 2]","['escutar', 'ganhar']","[1, 1]",4,2,6,1
11791,"['anteontem', 'descumprimento', 'descumprir', 'inquerito', 'investigacao', 'positivar', 'quarentenar', 'quarentenar', 'saudar']","[1, 1, 1, 1, 1, 1, 2, 2, 1]","['circular', 'inocentar', 'safar']","[1, 1, 1]",9,3,12,1
11792,"['anuncio', 'celso', 'cenario', 'convencao', 'lancamento', 'posicionamento', 'precandidato', 'previsto', 'reuniao', 'transmissao']","[1, 1, 1, 1, 1, 1, 1, 1, 1, 1]","[]","[]",10,0,10,1
11794,"['academico', 'alteracao', 'chefiar', 'especifico', 'impacto', 'lancamento', 'pastar', 'prever', 'prever', 'servidor', 'servidor', 'servidor']","[1, 1, 1, 1, 1, 1, 1, 2, 2, 3, 3, 3]","[]","[]",12,0,12,1
11796,"['assistencia', 'conformar', 'destacar', 'importancia', 'mudanca', 'planar', 'planar', 'proposto', 'republico', 'substituicao']","[1, 1, 1, 1, 1, 2, 2, 1, 1, 1]","['cadastramento']","[1]",10,1,11,1
11798,"['arrecadacao', 'biliao', 'biliao', 'biliao', 'crise', 'despesa', 'despesa', 'juro', 'primario', 'quedo', 'recordar', 'significativo', 'superar', 'tesourar', 'tesourar']","[1, 3, 3, 3, 1, 2, 2, 1, 1, 1, 1, 1, 1, 2, 2]","[]","[]",15,0,15,1
11799,"['celso', 'vulneravel']","[1, 1]","[]","[]",2,0,2,1
11801,"['adicionar', 'alteracao', 'armazenamento', 'armazenamento', 'contabilizar', 'mudanca', 'planar', 'resolucao', 'ritmar']","[1, 1, 2, 2, 1, 1, 1, 1, 1]","['imagem', 'usuario', 'usuario', 'usuario', 'verificacao']","[1, 3, 3, 3, 1]",9,5,14,1
11802,"['afetado']","[1]","[]","[]",1,0,1,1
11803,"['afetado', 'epidemiar', 'privar', 'propagacao', 'quarentenar', 'quarentenar', 'regiao', 'submetido']","[1, 1, 1, 1, 2, 2, 1, 1]","['espalhar']","[1]",8,1,9,1
11807,"['barroso', 'barroso', 'irregularidad', 'julgamento', 'processo', 'reuter', 'sendo', 'sociai']","[2, 2, 1, 1, 1, 1, 1, 1]","[]","[]",8,0,8,1
11810,"['adversario', 'condicao', 'equipamento', 'investigacao', 'justicar', 'justicar', 'mendonca', 'mendonca', 'ministrar', 'ministrar', 'souza']","[1, 1, 1, 1, 2, 2, 2, 2, 2, 2, 1]","['disseminar']","[1]",11,1,12,1
11814,"['barroso', 'barroso', 'ministrar', 'vespera']","[2, 2, 1, 1]","[]","[]",4,0,4,1
11815,"['elaborar', 'epidemiologico', 'fundacao', 'infectar', 'instituto', 'planar', 'proposto', 'reabertura', 'relaxamento', 'relaxamento', 'salao', 'saudar']","[1, 1, 1, 1, 1, 1, 1, 1, 2, 2, 1, 1]","[]","[]",12,0,12,1
11816,"['acordo', 'autoridad', 'cenario', 'destac', 'disseminacao', 'estrategia', 'fase', 'medida', 'oliveira', 'profissionai', 'regiao', 'risco', 'situacao', 'transmissao', 'videoconferencia', 'vigilancia']","[1, 1, 1, 1, 1, 1, 1, 1, 1, 1, 1, 1, 1, 1, 1, 1]","[]","[]",16,0,16,1
11817,"['andrea', 'domingo', 'esperancar']","[1, 1, 1]","['catedr', 'catedr', 'cristao', 'realment', 'vazio']","[2, 2, 1, 1, 1]",3,5,8,1
11818,"['associacao', 'associacao', 'justicar', 'magistrado', 'prazo', 'projecao', 'varar']","[2, 2, 1, 1, 1, 1, 1]","['fraudar']","[1]",7,1,8,1
11819,"['antonio', 'efetividad', 'necessario', 'observacao', 'realizacao', 'respostar']","[1, 1, 1, 1, 1, 1]","[]","[]",6,0,6,1
11820,"['aprovacao', 'argumentar', 'atuacao', 'avancar', 'bolsonarista', 'bolsonarista', 'carla', 'ccj', 'ccj', 'ccj', 'comissao', 'comportamento', 'constituicao', 'constituicao', 'contemplar', 'decisao', 'decisao', 'demrj', 'funcao', 'fundamentar', 'governista', 'governista', 'ideologico', 'importancia', 'integrant', 'interferencia', 'interferencia', 'julgamento', 'justicar', 'justificativo', 'legislativo', 'legislativo', 'legislativo', 'manutencao', 'manutencao', 'margem', 'minoria', 'necessario', 'necessidad', 'necessidad', 'proposto', 'pslrj', 'pslsp', 'regulamentar', 'republico', 'sessao', 'supremo', 'supremo', 'supremo', 'supremo', 'suspensao', 'zambelli']","[1, 1, 1, 1, 2, 2, 1, 3, 3, 3, 1, 1, 2, 2, 1, 2, 2, 1, 1, 1, 2, 2, 1, 1, 1, 2, 2, 1, 1, 1, 3, 3, 3, 2, 2, 1, 1, 1, 2, 2, 1, 1, 1, 1, 1, 1, 4, 4, 4, 4, 1, 1]","[]","[]",52,0,52,1
11822,"['academiar', 'exercicio', 'habito', 'habito', 'habito', 'periodo', 'rotina', 'rotina', 'treino']","[1, 1, 3, 3, 3, 1, 2, 2, 1]","[]","[]",9,0,9,1
11823,"['avancar', 'habitant', 'habitant', 'isolar', 'isolar', 'necessario', 'necessidad', 'preventivo', 'rigoroso', 'surtir']","[1, 2, 2, 2, 2, 1, 1, 1, 1, 1]","[]","[]",10,0,10,1
11824,"['assintomatico', 'assintomatico', 'coordenar', 'respostar', 'respostar', 'respostar', 'saudar', 'transmissao', 'transmissao']","[2, 2, 1, 3, 3, 3, 1, 2, 2]","['realment']","[1]",9,1,10,1
11825,"['autoridad', 'comissao', 'comissao', 'congresso', 'congresso', 'justicar', 'reclamacao']","[1, 2, 2, 2, 2, 1, 1]","[]","[]",7,0,7,1
11826,"['exministro', 'levantamento']","[1, 1]","['checagem', 'circular', 'disseminar', 'verificacao']","[1, 1, 1, 1]",2,4,6,1
11828,"['afp', 'afp', 'afp', 'autoridad', 'autoridad', 'correspondent', 'correspondent', 'epicentro', 'epidemia', 'examinar', 'fluxo', 'hubei', 'medida', 'milho', 'none', 'none', 'none', 'pedido', 'periodo', 'propagacao', 'provincia', 'regiao', 'relacao', 'relativo', 'trafego', 'ultimo']","[3, 3, 3, 2, 2, 2, 2, 1, 1, 1, 1, 1, 1, 1, 3, 3, 3, 1, 1, 1, 1, 1, 1, 1, 1, 1]","[]","[]",26,0,26,1
11829,"['ausencia', 'coletivo', 'coletivo', 'desafiar', 'funcao', 'iniciativo', 'integrant']","[1, 2, 2, 1, 1, 1, 1]","['bispar', 'catolico', 'padrar', 'parir', 'parir']","[1, 1, 1, 2, 2]",7,5,12,1
11834,"['balancar', 'condicao', 'domingo', 'espanha', 'espanha', 'espanha', 'primeiroministro', 'recordar', 'recordar', 'regiao', 'saudar', 'totalizar']","[1, 1, 1, 3, 3, 3, 1, 2, 2, 1, 1, 1]","[]","[]",12,0,12,1
11838,"['consecutivo', 'consorcio', 'obtido', 'periodo', 'quedo', 'saudar', 'variacao']","[1, 1, 1, 1, 1, 1, 1]","[]","[]",7,0,7,1
11839,"['bbc', 'bbc', 'mexico', 'mexico', 'situacao']","[2, 2, 2, 2, 1]","[]","[]",5,0,5,1
11841,"['adulto', 'espanha', 'especializar', 'europeu', 'europeu', 'infectar', 'liderar', 'proporcao', 'saudar']","[1, 1, 1, 2, 2, 1, 1, 1, 1]","[]","[]",9,0,9,1
11843,"['afetado', 'biliao', 'biliao', 'biliao', 'biliao', 'congresso', 'congresso', 'crise', 'crise', 'destinar', 'destinar', 'economia', 'emprestimo', 'epidemiar', 'impactar', 'particularment', 'planar', 'planar', 'planar', 'planar', 'propagacao', 'quedo', 'saudar', 'sessao']","[1, 4, 4, 4, 4, 2, 2, 2, 2, 2, 2, 1, 1, 1, 1, 1, 4, 4, 4, 4, 1, 1, 1, 1]","['realment']","[1]",24,1,25,1
11844,"['araujo', 'araujo', 'carla', 'carla', 'carla', 'celso', 'celso', 'colunista', 'congresso', 'decisao', 'depoimento', 'depoimento', 'determinacao', 'exministro', 'inquerito', 'interlocutor', 'justicar', 'mello', 'mello', 'ministrar', 'ministrar', 'ministrar', 'mudanca', 'precedent', 'sabatino', 'substituto', 'supremo']","[2, 2, 3, 3, 3, 2, 2, 1, 1, 1, 2, 2, 1, 1, 1, 1, 1, 2, 2, 3, 3, 3, 1, 1, 1, 1, 1]","['ganhar', 'minutar']","[1, 1]",27,2,29,1
11846,"['aliviar', 'assistencia', 'conformar', 'diagnosticar', 'especifico', 'infectar', 'internacao', 'orientacao', 'periodo', 'plano', 'plano', 'previsao', 'resolucao', 'saudar', 'saudar', 'saudar', 'saudar', 'saudar']","[1, 1, 1, 1, 1, 1, 1, 1, 1, 2, 2, 1, 1, 5, 5, 5, 5, 5]","[]","[]",18,0,18,1
11847,"['aglomeracao', 'comunitario', 'decisao', 'liderar', 'positivar', 'precaucao', 'precaucao', 'precaucao', 'salao', 'vespera']","[1, 1, 1, 1, 1, 3, 3, 3, 1, 1]","[]","[]",10,0,10,1
11848,"['ambito', 'associacao', 'distrit', 'estimular', 'inovacao', 'ministrar', 'ministrar', 'prazo', 'proposto', 'recurso']","[1, 1, 1, 1, 1, 2, 2, 1, 1, 1]","[]","[]",10,0,10,1
11862,"['colaboracao', 'compilar', 'domingo', 'europeu', 'inedito', 'lancamento', 'necessario', 'observacao', 'painel', 'quilometro', 'velocidad']","[1, 1, 1, 1, 1, 1, 1, 1, 1, 1, 1]","['capturar', 'imagem']","[1, 1]",11,2,13,1
11863,"['aglomeracao', 'descumprir', 'disseminacao', 'realizacao']","[1, 1, 1, 1]","[]","[]",4,0,4,1
11866,"['alteracao', 'comparacao', 'contabilizar', 'economia', 'economia', 'gued', 'levantamento', 'ministrar', 'mudanca', 'temporario', 'videoconferencia']","[1, 1, 1, 2, 2, 1, 1, 1, 1, 1, 1]","[]","[]",11,0,11,1
11867,"['adotada', 'congresso', 'decisao', 'destacar', 'federar', 'fux', 'implementar', 'magistrado', 'manutencao', 'necessidad', 'prazo', 'realizacao', 'realizacao', 'supremo', 'videoconferencia', 'videoconferencia']","[1, 1, 1, 1, 1, 1, 1, 1, 1, 1, 1, 2, 2, 1, 2, 2]","['soltar']","[1]",16,1,17,1
11871,"['resultado', 'resultado']","[2, 2]","[]","[]",2,0,2,1
11872,"['crise', 'jorg', 'ministrar', 'necessario', 'precedent', 'saudar', 'wilson']","[1, 1, 1, 1, 1, 1, 1]","['instrucao']","[1]",7,1,8,1
11874,"['agravar', 'associacao', 'celebrar', 'flavio', 'flavio', 'proporcao', 'semestr', 'situacao', 'universitario']","[1, 1, 1, 2, 2, 1, 1, 1, 1]","['boatar', 'incendio', 'incendio']","[1, 2, 2]",9,3,12,1
11878,"['andrea', 'anuncio', 'arrecadar', 'arrecadar', 'esforco', 'iniciativo', 'iniciativo', 'parceria', 'saudar', 'transmissao']","[1, 1, 2, 2, 1, 2, 2, 1, 1, 1]","[]","[]",10,0,10,1
11879,"['importancia', 'integrant', 'integro', 'interpretar', 'pacheco', 'republico', 'republico']","[1, 1, 1, 1, 1, 2, 2]","[]","[]",7,0,7,1
11880,"['escalar', 'levantamento', 'notificar', 'proporcao', 'superar']","[1, 1, 1, 1, 1]","[]","[]",5,0,5,1
11883,"['argumentar', 'congresso', 'constituicao', 'decisao', 'edson', 'fachin', 'humberto', 'julgamento', 'legislativo', 'ministrar', 'planar', 'plano', 'privar', 'processo', 'reclamacao', 'republico', 'republico', 'respostar', 'supremo', 'suspenso']","[1, 1, 1, 1, 1, 1, 1, 1, 1, 1, 1, 1, 1, 1, 1, 2, 2, 1, 1, 1]","[]","[]",20,0,20,1
11884,"['disseminacao', 'facilitar', 'fluminens', 'funcionamento', 'medida']","[1, 1, 1, 1, 1]","[]","[]",5,0,5,1
11886,"['condicao', 'decisao', 'epidemiar', 'estrategia', 'estrategia', 'intenso', 'normalidad', 'quarentenar', 'quarentenar', 'quarentenar', 'quarentenar', 'quarentenar', 'quedo', 'saudar', 'suspenso', 'transicao', 'transicao', 'transmissao', 'vigilancia']","[1, 1, 1, 2, 2, 1, 1, 5, 5, 5, 5, 5, 1, 1, 1, 2, 2, 1, 1]","[]","[]",19,0,19,1
11887,"['constituicao', 'crise', 'especifico', 'integro', 'plenario', 'prever', 'regulamentar', 'reuniao', 'saudar']","[1, 1, 1, 1, 1, 1, 1, 1, 1]","[]","[]",9,0,9,1
11888,"['positivar', 'saudar']","[1, 1]","[]","[]",2,0,2,1
11889,"['expressivo']","[1]","[]","[]",1,0,1,1
11890,"['consequencia', 'observar', 'proporcao', 'proporcao', 'saudar', 'tendencia', 'tendencia', 'transmissao']","[1, 1, 2, 2, 1, 2, 2, 1]","[]","[]",8,0,8,1
11892,"['afp', 'flexibilizacao', 'portavoz', 'presenca', 'presenca', 'regiao', 'saudar']","[1, 1, 1, 2, 2, 1, 1]","[]","[]",7,0,7,1
11899,"['adotada', 'avancar', 'consorcio', 'dificuldad', 'dosar', 'enfrentamento', 'ministrar', 'ministrar', 'prioritario', 'queiroga', 'queiroga', 'queiroga', 'reforcar', 'respostar', 'saudar', 'situacao', 'sobretudo', 'superar']","[1, 1, 1, 1, 1, 1, 2, 2, 1, 3, 3, 3, 1, 1, 1, 1, 1, 1]","['parir', 'parir', 'pelar', 'pelar', 'quantum']","[2, 2, 2, 2, 1]",18,5,23,1
11901,"['afp', 'excecao', 'primeiroministro', 'regrar', 'surtir']","[1, 1, 1, 1, 1]","['parir']","[1]",5,1,6,1
0,"['federar', 'particularment']","[1, 1]","['atirar', 'clicar', 'trafico']","[1, 1, 1]",2,3,5,0
4,"['concedido', 'mandatario']","[1, 1]","['compartilhar', 'fraudar']","[1, 1]",2,2,4,0
5,"['presenca']","[1]","['espancar', 'espancar', 'invadir', 'invadir', 'parir', 'parir']","[2, 2, 2, 2, 2, 2]",1,6,7,0
7,"[]","[]","['botao', 'cadastramento', 'clicar', 'compartilhar', 'compartilhar', 'compartilhar', 'compartilhar']","[1, 1, 1, 4, 4, 4, 4]",0,7,7,0
9,"['anticorpo', 'anticorpo', 'anticorpo', 'dosar', 'dosar', 'dosar', 'dosar', 'dosar', 'dosar', 'infectar', 'infectar', 'necessario', 'vulneravel']","[3, 3, 3, 6, 6, 6, 6, 6, 6, 2, 2, 1, 1]","[]","[]",13,0,13,0
11,"['consequencia', 'consequencia', 'dificuldad', 'espirito', 'instaurar', 'mudanca', 'planar', 'planar', 'possibilidad', 'situacao', 'situacao', 'supremo']","[2, 2, 1, 1, 1, 1, 2, 2, 1, 2, 2, 1]","['compartilhar', 'cristao', 'instrucao', 'verdadeiro']","[1, 1, 1, 1]",12,4,16,0
16,"['parceria']","[1]","[]","[]",1,0,1,0
17,"[]","[]","[]","[]",0,0,0,0
19,"[]","[]","[]","[]",0,0,0,0
20,"['europeu', 'europeu', 'europeu', 'resistencia', 'viajant']","[3, 3, 3, 1, 1]","['circular', 'compartilhar', 'imagem']","[1, 1, 1]",5,3,8,0
21,"[]","[]","['acidentar', 'acidentar', 'acidentar']","[3, 3, 3]",0,3,3,0
22,"[]","[]","['visualizacao']","[1]",0,1,1,0
23,"[]","[]","['manobrar']","[1]",0,1,1,0
24,"[]","[]","['acidentar', 'acidentar', 'missil', 'narrativo']","[2, 2, 1, 1]",0,4,4,0
25,"['bandeirant', 'rocha', 'rocha', 'rocha']","[1, 3, 3, 3]","['escutar']","[1]",4,1,5,0
30,"['ricardo', 'servidor']","[1, 1]","[]","[]",2,0,2,0
33,"[]","[]","['enganoso', 'parir']","[1, 1]",0,2,2,0
35,"['periodo', 'piorar', 'quarentenar', 'resistencia']","[1, 1, 1, 1]","[]","[]",4,0,4,0
39,"['depoimento', 'privar']","[1, 1]","['checar']","[1]",2,1,3,0
40,"['depoimento']","[1]","['checar']","[1]",1,1,2,0
41,"['depoimento']","[1]","['checar']","[1]",1,1,2,0
42,"['depoimento', 'mexico']","[1, 1]","['checar']","[1]",2,1,3,0
43,"['anuncio', 'depoimento', 'europeu']","[1, 1, 1]","['checar']","[1]",3,1,4,0
44,"['coletivo', 'julgamento', 'sentenca']","[1, 1, 1]","['versao', 'versao']","[2, 2]",3,2,5,0
45,"['equipamento', 'infectar', 'investigacao', 'investigacao', 'mprj']","[1, 1, 2, 2, 1]","['verificar']","[1]",5,1,6,0
55,"['pagamento', 'pagamento', 'parcelar', 'parcelar']","[2, 2, 2, 2]","['versao']","[1]",4,1,5,0
56,"[]","[]","['carrefour']","[1]",0,1,1,0
58,"['ambientar', 'pulmonar', 'saudar', 'saudar', 'subir']","[1, 1, 2, 2, 1]","['circular']","[1]",5,1,6,0
59,"['anticorpo', 'associacao', 'comissao', 'dosar', 'infectar', 'infectar', 'saudar', 'transmissao']","[1, 1, 1, 1, 2, 2, 1, 1]","['circular']","[1]",8,1,9,0
60,"[]","[]","['filmar', 'quinzena', 'vezar']","[1, 1, 1]",0,3,3,0
62,"['entregu']","[1]","['checar']","[1]",1,1,2,0
63,"['administrativo', 'improbidad']","[1, 1]","['checar']","[1]",2,1,3,0
64,"['periodo']","[1]","['checar', 'ganhar', 'sobrar']","[1, 1, 1]",1,3,4,0
65,"['negativar', 'positivar', 'positivar', 'positivar', 'positivar']","[1, 4, 4, 4, 4]","['circular', 'falsar', 'gravacao', 'ilustrar', 'imagem', 'telegram', 'usuario']","[1, 1, 1, 1, 1, 1, 1]",5,7,12,0
66,"['efetividad']","[1]","[]","[]",1,0,1,0
67,"['concessionario', 'concessionario', 'contabilizar', 'possibilidad', 'previsto', 'previsto', 'republico', 'republico']","[2, 2, 1, 1, 2, 2, 2, 2]","['clicar', 'clicar', 'compartilhar', 'fraudar', 'imagem', 'manipular', 'manipular']","[2, 2, 1, 1, 1, 2, 2]",8,7,15,0
74,"['anticorpo', 'saudar']","[1, 1]","[]","[]",2,0,2,0
77,"['preocupacao']","[1]","[]","[]",1,0,1,0
78,"['avancar', 'converso', 'esquema']","[1, 1, 1]","['circular', 'falsar', 'imagem', 'imagem', 'imagem', 'invadir', 'parir', 'sequer', 'usuario']","[1, 1, 3, 3, 3, 1, 1, 1, 1]",3,9,12,0
81,"['desenvolvimento', 'instalacao', 'parceria', 'provisorio']","[1, 1, 1, 1]","['rompimento']","[1]",4,1,5,0
82,"[]","[]","['vezar', 'visualizar']","[1, 1]",0,2,2,0
85,"['periodo', 'saudar']","[1, 1]","[]","[]",2,0,2,0
86,"['conformar', 'externo']","[1, 1]","['compartilhar', 'enganar', 'fotografia', 'imagem', 'imagem', 'reverso', 'verificar']","[1, 1, 1, 2, 2, 1, 1]",2,7,9,0
87,"['comparacao', 'taxar', 'taxar']","[1, 2, 2]","[]","[]",3,0,3,0
88,"['associacao', 'azevedo', 'consequencia', 'folhar', 'integrant', 'ministrar', 'ministrar', 'ricardo']","[1, 1, 1, 1, 1, 2, 2, 1]","['assaltar', 'chorar', 'chorar', 'enganar', 'estuprar', 'faccao', 'faccao', 'faccao', 'imagem', 'imagem', 'imagem', 'inocentar', 'vazar']","[1, 2, 2, 1, 1, 3, 3, 3, 3, 3, 3, 1, 1]",8,13,21,0
91,"['recurso', 'supremo']","[1, 1]","[]","[]",2,0,2,0
93,"['cenario', 'observar']","[1, 1]","['filmar']","[1]",2,1,3,0
94,"['entregu', 'regrar']","[1, 1]","['clicar', 'clicar', 'compartilhar', 'compartilhar', 'compartilhar', 'ganhar', 'ganhar', 'ganhar', 'ganhar', 'instrucao', 'parabem', 'parabem', 'reivindicar', 'sapato', 'sapato', 'sapato', 'sapato', 'sapato', 'sapato', 'sortear', 'verificar']","[2, 2, 3, 3, 3, 4, 4, 4, 4, 1, 2, 2, 1, 6, 6, 6, 6, 6, 6, 1, 1]",2,21,23,0
95,"['congresso', 'mudanca', 'sessao']","[1, 1, 1]","['assinalar', 'circular', 'circular', 'fraudar', 'invadir', 'postagen', 'postagen', 'replicar']","[1, 2, 2, 1, 1, 2, 2, 1]",3,8,11,0
96,"['dedicar', 'processo', 'realizacao', 'regrar', 'regrar', 'transmissao']","[1, 1, 1, 2, 2, 1]","['circular', 'circular']","[2, 2]",6,2,8,0
97,"[]","[]","['manipular']","[1]",0,1,1,0
99,"['ambientar', 'coletivo', 'proposto', 'reforcar', 'situacao', 'situacao', 'suspenso', 'vulnerabilidad']","[1, 1, 1, 1, 2, 2, 1, 1]","['copiar', 'vazio']","[1, 1]",8,2,10,0
101,"['apurar']","[1]","['camisa', 'imagem']","[1, 1]",1,2,3,0
102,"['calamidad', 'calamidad', 'calamidad', 'saudar', 'situacao']","[3, 3, 3, 1, 1]","['circular', 'sacar', 'sacar', 'sacar']","[1, 3, 3, 3]",5,4,9,0
103,"[]","[]","['atribuir', 'desmaiar', 'desmaiar', 'desmaiar', 'menino', 'menino', 'menino']","[1, 3, 3, 3, 3, 3, 3]",0,7,7,0
104,"['depoimento']","[1]","['agredir', 'carrefour', 'circular', 'circular', 'espancar', 'espancar', 'espancar', 'estuprar', 'falsar', 'ilustrar', 'imagem']","[1, 1, 2, 2, 3, 3, 3, 1, 1, 1, 1]",1,11,12,0
106,"['privar']","[1]","['copiar', 'imagem']","[1, 1]",1,2,3,0
107,"['coordenar', 'panamericana', 'saudar']","[1, 1, 1]","['circular']","[1]",3,1,4,0
109,"['cometido', 'exgovernador', 'folhar', 'parceria', 'sabatino', 'spaulo']","[1, 1, 1, 1, 1, 1]","['checar', 'lupa']","[1, 1]",6,2,8,0
111,"[]","[]","[]","[]",0,0,0,0
112,"['competicao']","[1]","['amigar', 'curioso', 'ganhar', 'ganhar', 'ganhar', 'ganhar', 'patrocinador']","[1, 1, 4, 4, 4, 4, 1]",1,7,8,0
113,"['esperancar', 'esperancar', 'esperancar', 'esperancar', 'superar', 'superar']","[4, 4, 4, 4, 2, 2]","['compartilhar', 'menino']","[1, 1]",6,2,8,0
114,"['investigacao']","[1]","['checagem', 'compartilhar', 'imagem', 'reverso', 'verificar']","[1, 1, 1, 1, 1]",1,5,6,0
115,"['conformar']","[1]","['botao', 'clicar']","[1, 1]",1,2,3,0
116,"['observar', 'regulamentar', 'saudar']","[1, 1, 1]","[]","[]",3,0,3,0
119,"['importancia', 'inedito', 'possibilidad']","[1, 1, 1]","['vazio']","[1]",3,1,4,0
122,"['imitacao', 'perspectivo', 'sabado']","[1, 1, 1]","['acidentar', 'adorar', 'adorar', 'crech', 'indignacao', 'indignacao', 'manipulacao', 'protestar', 'vc', 'vc', 'vc']","[1, 2, 2, 1, 2, 2, 1, 1, 3, 3, 3]",3,11,14,0
123,"['celebrar', 'lancamento', 'lancamento']","[1, 2, 2]","['instrucao']","[1]",3,1,4,0
125,"['conjuntar', 'diminuicao', 'hospitalizacao']","[1, 1, 1]","['misturar']","[1]",3,1,4,0
129,"[]","[]","['grupar', 'minutar', 'quinzena', 'sobrar']","[1, 1, 1, 1]",0,4,4,0
131,"[]","[]","['acidentar', 'circular', 'circular', 'falsar', 'incendio', 'incendio']","[1, 2, 2, 1, 2, 2]",0,6,6,0
133,"['consumidor', 'consumidor', 'consumidor', 'consumidor', 'consumidor', 'espirito', 'manutencao', 'manutencao', 'manutencao', 'manutencao', 'manutencao', 'regiao', 'sabado', 'sabado', 'sabado', 'sabado', 'sabado']","[5, 5, 5, 5, 5, 1, 5, 5, 5, 5, 5, 1, 5, 5, 5, 5, 5]","['desligar', 'desligar', 'desligar', 'desligar', 'desligar']","[5, 5, 5, 5, 5]",17,5,22,0
134,"['ambientar', 'desenvolvido']","[1, 1]","['capturar', 'filmar', 'ilustrar', 'imagem', 'manipular', 'replicar', 'usuario', 'vc']","[1, 1, 1, 1, 1, 1, 1, 1]",2,8,10,0
135,"[]","[]","['clicar']","[1]",0,1,1,0
139,"['previsao', 'quarentenar', 'surtir']","[1, 1, 1]","[]","[]",3,0,3,0
146,"['conformar', 'flavio', 'toquio']","[1, 1, 1]","['pelar', 'postagen']","[1, 1]",3,2,5,0
147,"['depoimento']","[1]","['circular', 'padrar', 'padrar', 'padrar', 'padrar']","[1, 4, 4, 4, 4]",1,5,6,0
150,"['positivar', 'positivar', 'positivar']","[3, 3, 3]","['compartilhar', 'imagem', 'misturar']","[1, 1, 1]",3,3,6,0
151,"['lesao', 'pagamento', 'pagamento']","[1, 2, 2]","['acidentar', 'cnh', 'compartilhar']","[1, 1, 1]",3,3,6,0
153,"[]","[]","['compartilhar']","[1]",0,1,1,0
157,"['ambientar', 'ambientar', 'desenvolvimento', 'desenvolvimento', 'desmatamento', 'desmatamento', 'divergencia', 'iniciativo', 'irregularidad', 'ministrar', 'ministrar', 'ministrar', 'monitoramento', 'parceria', 'parceria', 'pastar', 'prever', 'recurso', 'recurso', 'regiao', 'regulamentar', 'ricardo', 'sall', 'sall', 'sall']","[2, 2, 2, 2, 2, 2, 1, 1, 1, 3, 3, 3, 1, 2, 2, 1, 1, 2, 2, 1, 1, 1, 3, 3, 3]","['compartilhar', 'compartilhar', 'imagem', 'patrocinador']","[2, 2, 1, 1]",25,4,29,0
159,"[]","[]","['camisa', 'circular']","[1, 1]",0,2,2,0
160,"['administrativo']","[1]","['barragem', 'barragem', 'barragem', 'rompimento', 'rompimento', 'rompimento']","[3, 3, 3, 3, 3, 3]",1,6,7,0
162,"[]","[]","['circular', 'circular', 'mesario', 'realment', 'secreto']","[2, 2, 1, 1, 1]",0,5,5,0
163,"['bolsonarista', 'necessario', 'pacheco', 'pacheco', 'suspeito']","[1, 1, 2, 2, 1]","['clicar', 'ganhar', 'instrucao', 'manipulacao', 'manipulacao', 'manipulacao', 'parir', 'parir', 'parir', 'versao', 'versao']","[1, 1, 1, 3, 3, 3, 3, 3, 3, 2, 2]",5,11,16,0
165,"['justicar', 'preservar', 'regiao']","[1, 1, 1]","[]","[]",3,0,3,0
166,"['diariament', 'justicar', 'justicar']","[1, 2, 2]","[]","[]",3,0,3,0
168,"['contrato', 'estrategia', 'imunizacao', 'saudar']","[1, 1, 1, 1]","[]","[]",4,0,4,0
171,"['necessario', 'necessidad', 'necessidad']","[1, 2, 2]","['bandeiro', 'humanar']","[1, 1]",3,2,5,0
175,"['federar']","[1]","['circular', 'legendar', 'mafia']","[1, 1, 1]",1,3,4,0
176,"['wilson', 'witzel', 'witzel', 'witzel']","[1, 3, 3, 3]","['bandeiro', 'circular', 'imagem', 'legendar', 'visualizacao']","[1, 1, 1, 1, 1]",4,5,9,0
177,"['ambientar', 'associacao', 'comparacao', 'instituto', 'ministrar', 'monitoramento', 'periodo', 'preservar', 'prtb', 'regiao', 'ricardo', 'sall']","[1, 1, 1, 1, 1, 1, 1, 1, 1, 1, 1, 1]","['compartilhar', 'usuario']","[1, 1]",12,2,14,0
179,"['consolidar', 'desenvolvimento', 'domingo', 'federar', 'importancia', 'inclusao', 'reconhecimento', 'servidor']","[1, 1, 1, 1, 1, 1, 1, 1]","['boatar', 'circular', 'desmentir', 'ganhar']","[1, 1, 1, 1]",8,4,12,0
182,"['quarentenar', 'turista', 'turista']","[1, 2, 2]","['vazio']","[1]",3,1,4,0
185,"['adulto', 'boletim', 'conformar', 'contagioso', 'especialment', 'necessario', 'respiratorio', 'respiratorio', 'saudar']","[1, 1, 1, 1, 1, 1, 2, 2, 1]","['descricao', 'garganta', 'garganta', 'garganta', 'garganta', 'garganta', 'invadir', 'vitaminar']","[1, 5, 5, 5, 5, 5, 1, 1]",9,8,17,0
189,"[]","[]","[]","[]",0,0,0,0
190,"['associacao', 'crise', 'regiao']","[1, 1, 1]","['circular', 'imagem', 'imagem', 'manipular', 'protestar']","[1, 2, 2, 1, 1]",3,5,8,0
192,"['particularment', 'particularment', 'quedo']","[2, 2, 1]","['catedr', 'catedr', 'catedr', 'catedr', 'imagem', 'incendio', 'incendio', 'parir']","[4, 4, 4, 4, 1, 2, 2, 1]",3,8,11,0
195,"[]","[]","[]","[]",0,0,0,0
197,"[]","[]","['humanar', 'parir', 'postagen']","[1, 1, 1]",0,3,3,0
198,"['antonio', 'azevedo', 'carat', 'chefiar', 'conflito', 'conjuntar', 'constituicao', 'decisao', 'edson', 'ministrar', 'periodo', 'republico', 'republico', 'republico', 'treinamento', 'treinamento']","[1, 1, 1, 1, 1, 1, 1, 1, 1, 1, 1, 3, 3, 3, 2, 2]","[]","[]",16,0,16,0
199,"['anticorpo', 'anticorpo', 'anticorpo', 'anticorpo', 'assintomatico', 'assintomatico', 'assintomatico', 'transmissao']","[4, 4, 4, 4, 3, 3, 3, 1]","['cbn', 'circular']","[1, 1]",8,2,10,0
200,"[]","[]","['fraudar']","[1]",0,1,1,0
203,"['regiao']","[1]","['arvor', 'arvor', 'arvor']","[3, 3, 3]",1,3,4,0
206,"['rastreamento', 'tambem']","[1, 1]","['drone', 'pelar']","[1, 1]",2,2,4,0
208,"['distant', 'reportar']","[1, 1]","['agredir', 'agredir', 'camisa', 'circular', 'circular', 'imagem', 'reverso']","[2, 2, 1, 2, 2, 1, 1]",2,7,9,0
209,"[]","[]","['replicar']","[1]",0,1,1,0
215,"[]","[]","['cobaia', 'fingir']","[1, 1]",0,2,2,0
217,"[]","[]","[]","[]",0,0,0,0
220,"['campino']","[1]","['ganhar']","[1]",1,1,2,0
221,"[]","[]","['arvor', 'arvor', 'arvor', 'realment', 'realment']","[3, 3, 3, 2, 2]",0,5,5,0
222,"['adotada', 'afastamento', 'anuncio', 'chefiar', 'coordenar', 'henriqu', 'propagacao', 'quarentenar', 'saudar', 'saudar']","[1, 1, 1, 1, 1, 1, 1, 1, 2, 2]","[]","[]",10,0,10,0
224,"[]","[]","['circular', 'legendar']","[1, 1]",0,2,2,0
225,"['avancar', 'constatar', 'decisao', 'reportar']","[1, 1, 1, 1]","['circular', 'compartilhar', 'usuario']","[1, 1, 1]",4,3,7,0
226,"[]","[]","['espalhar', 'versao', 'visualizacao']","[1, 1, 1]",0,3,3,0
228,"['europeu']","[1]","['caixao', 'caixao', 'circular', 'fotografo', 'imagem', 'imagem', 'legendar']","[2, 2, 1, 1, 2, 2, 1]",1,7,8,0
229,"['especializar']","[1]","['arvor', 'compartilhar', 'ganhar']","[1, 1, 1]",1,3,4,0
230,"['decisao', 'transferir']","[1, 1]","[]","[]",2,0,2,0
236,"[]","[]","['disseminar', 'pelar']","[1, 1]",0,2,2,0
237,"['vetar', 'vetar', 'vetar', 'vetar']","[4, 4, 4, 4]","['filmar']","[1]",4,1,5,0
238,"['deteccao', 'epidemiologico', 'saudar', 'vigilancia']","[1, 1, 1, 1]","['cbn', 'circular', 'nasal']","[1, 1, 1]",4,3,7,0
239,"[]","[]","['lazaro', 'parir']","[1, 1]",0,2,2,0
241,"['equipamento', 'funcionamento', 'letalidad', 'planar', 'preconceito', 'preocupacao', 'previo', 'privar', 'relaxar', 'saudar', 'situacao', 'taxar', 'witzel']","[1, 1, 1, 1, 1, 1, 1, 1, 1, 1, 1, 1, 1]","['dorio', 'dorio', 'narrativo']","[2, 2, 1]",13,3,16,0
243,"['alteracao', 'gestant', 'mutacao']","[1, 1, 1]","[]","[]",3,0,3,0
244,"['crescimento', 'instituto', 'patamar', 'periodo', 'preliminar', 'preliminar', 'semestr']","[1, 1, 1, 1, 2, 2, 1]","['atribuir', 'circular', 'verificar', 'verificar']","[1, 1, 2, 2]",7,4,11,0
246,"['equipamento', 'fronteiro']","[1, 1]","['compartilhar', 'implantar']","[1, 1]",2,2,4,0
249,"['barroso', 'barroso', 'exonerar']","[2, 2, 1]","[]","[]",3,0,3,0
250,"[]","[]","['desmaiar', 'desmaiar', 'desmaiar']","[3, 3, 3]",0,3,3,0
255,"[]","[]","['legendar', 'usuario']","[1, 1]",0,2,2,0
257,"['aprovacao', 'desempenhar', 'instituto', 'instituto', 'levantamento', 'reforcar', 'significativo']","[1, 1, 2, 2, 1, 1, 1]","['checagem', 'ilustrar', 'misturar', 'narrativo', 'visualizacao']","[1, 1, 1, 1, 1]",7,5,12,0
265,"['circulacao', 'universitario']","[1, 1]","['amplament', 'autopsia', 'boatar', 'boatar', 'checar', 'circular', 'versao']","[1, 1, 2, 2, 1, 1, 1]",2,7,9,0
266,"['folhar', 'ideologico']","[1, 1]","['arquivar', 'arquivar', 'ganhar', 'ganhar', 'ganhar', 'parir', 'parir', 'trafico', 'trafico', 'trafico', 'trafico', 'trafico', 'trafico', 'vc']","[2, 2, 3, 3, 3, 2, 2, 6, 6, 6, 6, 6, 6, 1]",2,14,16,0
270,"['flavio']","[1]","[]","[]",1,0,1,0
272,"['conjunto', 'contrato', 'justicar', 'lavagem']","[1, 1, 1, 1]","['circular', 'imagem', 'secreto']","[1, 1, 1]",4,3,7,0
274,"['justicar', 'supremo']","[1, 1]","['soltura']","[1]",2,1,3,0
275,"['revisar']","[1]","['amplament', 'cedula', 'cedula', 'cedula', 'circular', 'fraudar', 'fraudar', 'ilustrar', 'imagem', 'imagem', 'mesario', 'preencher', 'preencher', 'preencher', 'preencher', 'usuario', 'vazio', 'vazio']","[1, 3, 3, 3, 1, 2, 2, 1, 2, 2, 1, 4, 4, 4, 4, 1, 2, 2]",1,18,19,0
278,"['hospitalizar']","[1]","[]","[]",1,0,1,0
279,"['dosar', 'intervalar', 'reforcar']","[1, 1, 1]","['amplament', 'circular', 'imagem', 'legendar']","[1, 1, 1, 1]",3,4,7,0
280,"[]","[]","[]","[]",0,0,0,0
283,"['ministrar', 'nelson', 'saudar', 'saudar', 'teich', 'teich']","[1, 1, 2, 2, 2, 2]","[]","[]",6,0,6,0
284,"['conformar', 'conformar', 'congresso', 'exercicio', 'pratico', 'republico', 'republico', 'suportar']","[2, 2, 1, 1, 1, 2, 2, 1]","['compartilhar', 'sacar']","[1, 1]",8,2,10,0
285,"['respostar']","[1]","['clicar', 'clicar', 'compartilhar', 'compartilhar', 'ganhar', 'ganhar', 'ganhar', 'huawei', 'huawei', 'huawei', 'huawei', 'instrucao', 'macho', 'macho', 'minutar', 'parabem', 'reivindicar', 'selecionar', 'sortir', 'sortir', 'usuario', 'usuario', 'vazio']","[2, 2, 2, 2, 3, 3, 3, 4, 4, 4, 4, 1, 2, 2, 1, 1, 1, 1, 2, 2, 2, 2, 1]",1,23,24,0
291,"['assistencia', 'regiao']","[1, 1]","['cadastramento', 'inscricao', 'inscricao', 'preencher']","[1, 2, 2, 1]",2,4,6,0
294,"[]","[]","['compartilhar']","[1]",0,1,1,0
297,"[]","[]","['fotografia', 'imagem']","[1, 1]",0,2,2,0
299,"['acompanhamento', 'levantamento']","[1, 1]","['circular']","[1]",2,1,3,0
300,"['afp', 'constatar']","[1, 1]","['atribuir', 'checar', 'fotografo', 'imagem', 'postagen', 'reverso', 'viralizada']","[1, 1, 1, 1, 1, 1, 1]",2,7,9,0
302,"['republico']","[1]","['espalhar', 'imagem']","[1, 1]",1,2,3,0
308,"['folhar']","[1]","[]","[]",1,0,1,0
310,"['apurar', 'justicar', 'justicar']","[1, 2, 2]","['indignacao', 'inocentar', 'menino', 'menino', 'menino']","[1, 1, 3, 3, 3]",3,5,8,0
313,"[]","[]","['efarsa', 'realment']","[1, 1]",0,2,2,0
315,"['mexico']","[1]","['facada']","[1]",1,1,2,0
316,"['anvisa', 'aprovacao']","[1, 1]","['cobaia', 'realment', 'vc']","[1, 1, 1]",2,3,5,0
319,"['antonio']","[1]","['fraudar', 'fraudar', 'fraudar', 'gravacao', 'legendar', 'minutar', 'supostament', 'visualizar']","[3, 3, 3, 1, 1, 1, 1, 1]",1,8,9,0
323,"['afp', 'anvisa', 'anvisa', 'anvisa', 'autoridad', 'oficio', 'oficio', 'respostar', 'respostar']","[1, 3, 3, 3, 1, 2, 2, 2, 2]","['circular', 'pelar', 'pelar', 'pelar', 'pelar', 'sobrar']","[1, 4, 4, 4, 4, 1]",9,6,15,0
327,"[]","[]","['inocentar', 'inocentar', 'menino', 'menino', 'menino']","[2, 2, 3, 3, 3]",0,5,5,0
331,"['afp', 'atrair', 'atrair']","[1, 2, 2]","['amplament', 'checar', 'circular', 'circular', 'gravacao', 'supostament', 'telegram', 'verificacao']","[1, 1, 2, 2, 1, 1, 1, 1]",3,8,11,0
333,"[]","[]","[]","[]",0,0,0,0
335,"['corpu']","[1]","['parir']","[1]",1,1,2,0
336,"['saudar', 'transferencia']","[1, 1]","['verdadeiro']","[1]",2,1,3,0
337,"['dificuldad', 'internar', 'saudar', 'saudar']","[1, 1, 2, 2]","['ganhar', 'ganhar', 'ganhar', 'humanar']","[3, 3, 3, 1]",4,4,8,0
338,"[]","[]","[]","[]",0,0,0,0
339,"[]","[]","['cedula', 'cedula', 'despejar', 'gravacao', 'idioma', 'imagem', 'legendar', 'visualizar']","[2, 2, 1, 1, 1, 1, 1, 1]",0,8,8,0
340,"[]","[]","['imagem', 'soldar']","[1, 1]",0,2,2,0
341,"['nelson', 'saudar', 'teich']","[1, 1, 1]","['arquivar', 'dorio']","[1, 1]",3,2,5,0
342,"[]","[]","['invadir', 'usuario', 'usuario']","[1, 2, 2]",0,3,3,0
344,"['saudar']","[1]","[]","[]",1,0,1,0
345,"['presenciar', 'saudar', 'situacao', 'situacao']","[1, 1, 2, 2]","['boicotar']","[1]",4,1,5,0
346,"['alteracao', 'condenacao', 'deltan', 'fachin', 'mantido', 'ministrar', 'mudanca', 'republico', 'transferir']","[1, 1, 1, 1, 1, 1, 1, 1, 1]","['amigar', 'assaltar']","[1, 1]",9,2,11,0
347,"[]","[]","['escutar', 'escutar']","[2, 2]",0,2,2,0
348,"['justicar', 'ministrar', 'passageiro']","[1, 1, 1]","['vagabundar']","[1]",3,1,4,0
350,"['pagamento', 'saudar', 'saudar', 'taxar', 'treinamento', 'treinamento', 'treinamento', 'treinamento']","[1, 2, 2, 1, 4, 4, 4, 4]","['boatar', 'circular', 'circular', 'compartilhar']","[1, 2, 2, 1]",8,4,12,0
351,"[]","[]","[]","[]",0,0,0,0
353,"[]","[]","['espalhar']","[1]",0,1,1,0
355,"[]","[]","['pelar', 'soltura']","[1, 1]",0,2,2,0
357,"['epidemiar']","[1]","['espalhar', 'espalhar']","[2, 2]",1,2,3,0
359,"[]","[]","['compartilhar', 'enfim']","[1, 1]",0,2,2,0
360,"[]","[]","['fingir', 'fingir', 'fraudar', 'puro']","[2, 2, 1, 1]",0,4,4,0
361,"['circulacao', 'epidemiar', 'etapa', 'infectar', 'infectar', 'infectar', 'ministrar', 'periodo', 'respiratorio', 'saudar', 'taxar', 'taxar', 'taxar', 'temporada', 'temporada']","[1, 1, 1, 3, 3, 3, 1, 1, 1, 1, 3, 3, 3, 2, 2]","['disseminar', 'enfim', 'implantar', 'legendar', 'legendar', 'minutar', 'minutar', 'soltar']","[1, 1, 1, 2, 2, 2, 2, 1]",15,8,23,0
362,"[]","[]","['revoltar', 'versao', 'versao', 'versao']","[1, 3, 3, 3]",0,4,4,0
363,"[]","[]","['circular', 'imagem', 'imagem', 'viralizado']","[1, 2, 2, 1]",0,4,4,0
368,"['aglomeracao', 'flexibilizacao', 'quarentenar']","[1, 1, 1]","['arquivar', 'ilustrar']","[1, 1]",3,2,5,0
369,"['circulacao', 'previsao', 'previsao']","[1, 2, 2]","['circular', 'imagem', 'imagem']","[1, 2, 2]",3,3,6,0
370,"['desenvolvimento', 'destinar', 'gued', 'recurso', 'saneamento', 'saudar']","[1, 1, 1, 1, 1, 1]","[]","[]",6,0,6,0
372,"['consenso', 'regiao']","[1, 1]","[]","[]",2,0,2,0
373,"[]","[]","['espalhar']","[1]",0,1,1,0
375,"['domingo', 'domingo']","[2, 2]","['circular', 'mencao']","[1, 1]",2,2,4,0
376,"['impactar']","[1]","['parir']","[1]",1,1,2,0
377,"['balancar', 'escalar', 'palacio', 'reuniao', 'reuniao', 'reuniao', 'reuniao']","[1, 1, 1, 4, 4, 4, 4]","['atribuir', 'bandeiro', 'compartilhar', 'compartilhar', 'compartilhar', 'gravacao', 'postagen', 'usuario']","[1, 1, 3, 3, 3, 1, 1, 1]",7,8,15,0
378,"['bruno']","[1]","['lembres', 'verdadeiro']","[1, 1]",1,2,3,0
379,"['justicar']","[1]","[]","[]",1,0,1,0
380,"['anvisa', 'estagio']","[1, 1]","[]","[]",2,0,2,0
382,"['ampliacao', 'constatar', 'domingo', 'espanha', 'investigacao']","[1, 1, 1, 1, 1]","['estranhar', 'estranhar', 'estranhar', 'estranhar', 'filmar', 'imagem', 'imagem', 'imagem']","[4, 4, 4, 4, 1, 3, 3, 3]",5,8,13,0
384,"[]","[]","['wagner', 'wagner']","[2, 2]",0,2,2,0
387,"[]","[]","['circular']","[1]",0,1,1,0
389,"['domingo']","[1]","[]","[]",1,0,1,0
390,"[]","[]","[]","[]",0,0,0,0
394,"['despesa', 'destinar', 'humanitario']","[1, 1, 1]","['incendio', 'menino']","[1, 1]",3,2,5,0
395,"['anuncio', 'investigacao']","[1, 1]","['pelar', 'wylli']","[1, 1]",2,2,4,0
399,"['adulto', 'dedicar']","[1, 1]","[]","[]",2,0,2,0
400,"['ministrar', 'sentenca', 'supremo', 'supremo']","[1, 1, 2, 2]","['versao']","[1]",4,1,5,0
401,"['instalacao', 'semestr']","[1, 1]","['carrefour', 'compartilhar', 'sequer', 'verdadeiro']","[1, 1, 1, 1]",2,4,6,0
403,"['tambem']","[1]","['enganar']","[1]",1,1,2,0
405,"['crise']","[1]","['macho', 'maldiz', 'nordestino']","[1, 1, 1]",1,3,4,0
407,"['domingo']","[1]","['misturar']","[1]",1,1,2,0
410,"['aplicacao', 'aplicacao', 'aplicacao', 'californio', 'exgovernador', 'saudar']","[3, 3, 3, 1, 1, 1]","['acidentar', 'circular', 'imagem', 'legendar', 'legendar']","[1, 1, 1, 2, 2]",6,5,11,0
412,"['espirito', 'presenca']","[1, 1]","['circular', 'legendar']","[1, 1]",2,2,4,0
414,"['discussao', 'equilibrio']","[1, 1]","['adorar', 'sortir']","[1, 1]",2,2,4,0
415,"['europeu']","[1]","[]","[]",1,0,1,0
416,"['conformar', 'domingo', 'sabado']","[1, 1, 1]","['gleisi', 'gleisi', 'gleisi']","[3, 3, 3]",3,3,6,0
417,"['ministrar', 'supremo']","[1, 1]","['compartilhar', 'expulsar']","[1, 1]",2,2,4,0
419,"['justicar']","[1]","[]","[]",1,0,1,0
420,"[]","[]","[]","[]",0,0,0,0
421,"['fluminens']","[1]","['agredir', 'espalhar']","[1, 1]",1,2,3,0
423,"['humanitario']","[1]","[]","[]",1,0,1,0
424,"['respostar']","[1]","['agredir', 'circular', 'legendar']","[1, 1, 1]",1,3,4,0
426,"[]","[]","['pelar']","[1]",0,1,1,0
428,"['ambientar', 'conformar', 'instituto', 'justicar', 'ministrar']","[1, 1, 1, 1, 1]","['atribuir', 'atribuir', 'compartilhar', 'compartilhar', 'enganoso', 'vazar', 'verificacao', 'verificar']","[2, 2, 2, 2, 1, 1, 1, 1]",5,8,13,0
429,"[]","[]","['circular']","[1]",0,1,1,0
431,"['acompanhamento', 'dosar', 'fase']","[1, 1, 1]","['compartilhar']","[1]",3,1,4,0
435,"['domingo', 'quedo']","[1, 1]","['circular', 'imagem', 'imagem', 'legendar', 'reverso', 'sacar']","[1, 2, 2, 1, 1, 1]",2,6,8,0
436,"['exministro']","[1]","[]","[]",1,0,1,0
438,"['cerimonia']","[1]","['caixao', 'caixao', 'caixao', 'caixao', 'caixao', 'cbn', 'circular', 'circular', 'compartilhar', 'fotografo', 'ganhar', 'imagem', 'imagem', 'imagem', 'imagem', 'vazio']","[5, 5, 5, 5, 5, 1, 2, 2, 1, 1, 1, 4, 4, 4, 4, 1]",1,16,17,0
443,"[]","[]","['telejorn']","[1]",0,1,1,0
445,"['concessionario', 'estagio', 'modelo', 'mudanca']","[1, 1, 1, 1]","['boatar', 'logotipo', 'logotipo']","[1, 2, 2]",4,3,7,0
446,"['transferencia']","[1]","[]","[]",1,0,1,0
447,"['instaurar', 'instaurar', 'integrant', 'supremo', 'supremo', 'turma']","[2, 2, 1, 2, 2, 1]","['amigar', 'basto', 'ilustrar', 'soltura']","[1, 1, 1, 1]",6,4,10,0
452,"[]","[]","['adelio', 'adelio', 'adelio', 'adelio', 'bispar', 'bispar', 'lixar']","[4, 4, 4, 4, 2, 2, 1]",0,7,7,0
455,"['arrecadar', 'atrasar', 'regiao', 'suportar']","[1, 1, 1, 1]","['cnh', 'compartilhar', 'parir', 'parir', 'parir', 'parir']","[1, 1, 4, 4, 4, 4]",4,6,10,0
457,"['afetado', 'previsao']","[1, 1]","[]","[]",2,0,2,0
458,"['domingo']","[1]","['suco', 'vitaminar', 'vitaminar']","[1, 2, 2]",1,3,4,0
459,"['anvisa', 'destacar', 'especifico', 'saudar', 'vigilancia']","[1, 1, 1, 1, 1]","['circular', 'vitaminar']","[1, 1]",5,2,7,0
463,"['autoridad']","[1]","['compartilhar', 'maldiz', 'parabem', 'parabem', 'parabem', 'revoltar']","[1, 1, 3, 3, 3, 1]",1,6,7,0
464,"[]","[]","[]","[]",0,0,0,0
465,"['augusto', 'condenacao', 'decisao', 'internar', 'justicar', 'justicar', 'justicar', 'revogar', 'saudar', 'situacao', 'supremo']","[1, 1, 1, 1, 3, 3, 3, 1, 1, 1, 1]","['boatar', 'checar', 'circular', 'estuprar', 'soltar']","[1, 1, 1, 1, 1]",11,5,16,0
469,"['etapa', 'iniciativo']","[1, 1]","['imagem', 'legendar']","[1, 1]",2,2,4,0
471,"[]","[]","['amplament', 'checar', 'compartilhar', 'compartilhar', 'usuario', 'verdadeiro', 'viralizada']","[1, 1, 2, 2, 1, 1, 1]",0,7,7,0
472,"['biliao', 'fluxo', 'positivar', 'positivar']","[1, 1, 2, 2]","['enganar', 'fraudar', 'fraudar']","[1, 2, 2]",4,3,7,0
473,"['justicar']","[1]","['vc', 'vc', 'vc']","[3, 3, 3]",1,3,4,0
474,"[]","[]","[]","[]",0,0,0,0
478,"['ambientar', 'enfatizar', 'eventualment', 'habito', 'minimizar', 'moderno', 'reflexo']","[1, 1, 1, 1, 1, 1, 1]","['compartilhar', 'desligar', 'desligar', 'lembres', 'lembres', 'usuario']","[1, 2, 2, 2, 2, 1]",7,6,13,0
479,"[]","[]","[]","[]",0,0,0,0
482,"['cilindro', 'cilindro']","[2, 2]","['amigar', 'lixar', 'vc']","[1, 1, 1]",2,3,5,0
483,"['converso', 'gripezinha', 'minimizar']","[1, 1, 1]","[]","[]",3,0,3,0
484,"['exercicio', 'exercicio', 'hipertensao', 'instituto', 'orientacao', 'subir']","[2, 2, 1, 1, 1, 1]","['circular', 'descricao', 'minutar']","[1, 1, 1]",6,3,9,0
486,"[]","[]","[]","[]",0,0,0,0
489,"['congresso']","[1]","['greve', 'greve', 'versao']","[2, 2, 1]",1,3,4,0
493,"['transmissao']","[1]","['circular', 'dorio', 'gravacao', 'idioma', 'legendar', 'quantum', 'versao', 'visualizar']","[1, 1, 1, 1, 1, 1, 1, 1]",1,8,9,0
497,"['mudanca']","[1]","['compartilhar', 'imagem']","[1, 1]",1,2,3,0
498,"['consequencia']","[1]","['puro']","[1]",1,1,2,0
499,"['alteracao', 'moderno']","[1, 1]","['cbn', 'compartilhar']","[1, 1]",2,2,4,0
500,"['metropolitano', 'passageiro']","[1, 1]","['crer', 'cuspir', 'cuspir', 'parir', 'parir']","[1, 2, 2, 2, 2]",2,5,7,0
501,"['anvisa', 'anvisa', 'anvisa', 'anvisa', 'calculo', 'domingo', 'estatistico', 'infectar', 'infectar', 'unanimidad', 'vigilancia']","[4, 4, 4, 4, 1, 1, 1, 2, 2, 1, 1]","['circular']","[1]",11,1,12,0
504,"['pagamento']","[1]","['compartilhar', 'imagem', 'quinzena']","[1, 1, 1]",1,3,4,0
508,"['ambito', 'condenacao', 'decisao', 'edson', 'fachin', 'ministrar', 'ministrar', 'supremo', 'varar']","[1, 1, 1, 1, 1, 2, 2, 1, 1]","['enganir', 'parir', 'parir', 'pelar', 'pelar']","[1, 2, 2, 2, 2]",9,5,14,0
509,"['bolsonarista', 'quilometro', 'turma']","[1, 1, 1]","['circular', 'imagem', 'pelar', 'pelar', 'pelar', 'wagner']","[1, 1, 3, 3, 3, 1]",3,6,9,0
513,"['destinar', 'economia', 'gued', 'gued', 'ministrar', 'ministrar', 'necessidad', 'recurso', 'saudar']","[1, 1, 2, 2, 2, 2, 1, 1, 1]","['indignar', 'realment', 'vagabundar']","[1, 1, 1]",9,3,12,0
515,"['exministro', 'itamarati']","[1, 1]","[]","[]",2,0,2,0
520,"['espanha', 'implementar', 'institut', 'levantamento', 'prever']","[1, 1, 1, 1, 1]","['cedula', 'circular', 'realment']","[1, 1, 1]",5,3,8,0
522,"[]","[]","['parabem', 'realment']","[1, 1]",0,2,2,0
523,"['desenvolvido']","[1]","['circular', 'imagem']","[1, 1]",1,2,3,0
526,"[]","[]","[]","[]",0,0,0,0
531,"[]","[]","[]","[]",0,0,0,0
533,"[]","[]","['atribuir', 'espalhar', 'imagem']","[1, 1, 1]",0,3,3,0
534,"[]","[]","['missil']","[1]",0,1,1,0
535,"['antonio', 'anvisa', 'anvisa', 'anvisa', 'diretoria', 'diretoria', 'saudar', 'vigilancia']","[1, 3, 3, 3, 2, 2, 1, 1]","['circular', 'compartilhar', 'versao']","[1, 1, 1]",8,3,11,0
536,"[]","[]","['imagem', 'parir']","[1, 1]",0,2,2,0
537,"['apurar', 'apurar', 'decisao', 'investigacao', 'investigacao', 'justicar', 'oliveira', 'oliveira', 'transferencia']","[2, 2, 1, 2, 2, 1, 2, 2, 1]","['adelio', 'adelio', 'adelio', 'adelio', 'bispar', 'bispar', 'bispar', 'renunciar', 'wylli', 'wylli', 'wylli', 'wylli', 'wylli']","[4, 4, 4, 4, 3, 3, 3, 1, 5, 5, 5, 5, 5]",9,13,22,0
540,"[]","[]","['cadastramento', 'safar']","[1, 1]",0,2,2,0
541,"['jn', 'positivar', 'positivar', 'positivar', 'renata']","[1, 3, 3, 3, 1]","[]","[]",5,0,5,0
543,"['vigilancia']","[1]","['compartilhar', 'privacidad', 'privacidad']","[1, 2, 2]",1,3,4,0
546,"['escalar', 'guarulho', 'passageiro', 'passageiro', 'passageiro', 'passageiro', 'passageiro', 'passageiro']","[1, 1, 6, 6, 6, 6, 6, 6]","[]","[]",8,0,8,0
549,"[]","[]","['atirar', 'caixao', 'caixao', 'espalhar', 'grupar', 'parir', 'quinzena']","[1, 2, 2, 1, 1, 1, 1]",0,7,7,0
550,"[]","[]","['chorar']","[1]",0,1,1,0
551,"['comorbidad', 'goncalo', 'metropolitano', 'regiao', 'saudar']","[1, 1, 1, 1, 1]","['circular']","[1]",5,1,6,0
554,"['saudar', 'saudar']","[2, 2]","['circular']","[1]",2,1,3,0
555,"['florido']","[1]","['circular', 'escutar']","[1, 1]",1,2,3,0
556,"['anvisa', 'autoridad']","[1, 1]","[]","[]",2,0,2,0
557,"[]","[]","['amplament', 'compartilhar']","[1, 1]",0,2,2,0
558,"['acumular', 'espanha', 'presenca', 'respostar']","[1, 1, 1, 1]","['circular', 'clicar', 'desmentir', 'imagem', 'imagem', 'imagem', 'legendar', 'lixar', 'usuario', 'usuario']","[1, 1, 1, 3, 3, 3, 1, 1, 2, 2]",4,10,14,0
559,"['funcao']","[1]","['chorar', 'legend', 'legend', 'verificar']","[1, 2, 2, 1]",1,4,5,0
560,"['saudar']","[1]","['circular', 'legendar', 'parir', 'protestar', 'protestar']","[1, 1, 1, 2, 2]",1,5,6,0
561,"['aglomeracao', 'autoridad', 'condicao', 'condicao', 'dificuldad', 'distant', 'europeu', 'situacao', 'situacao', 'situacao', 'situacao', 'turista']","[1, 1, 2, 2, 1, 1, 1, 4, 4, 4, 4, 1]","['desmaiar', 'desmaiar', 'espalhar', 'pego', 'verdadeiro']","[2, 2, 1, 1, 1]",12,5,17,0
562,"[]","[]","['fraudar', 'quinzena']","[1, 1]",0,2,2,0
564,"['comissao']","[1]","['grupar', 'humanar', 'idioma', 'parir', 'sobrar']","[1, 1, 1, 1, 1]",1,5,6,0
565,"[]","[]","['postagen']","[1]",0,1,1,0
566,"['agravar', 'argumentar', 'compromisso', 'crise', 'crise', 'federar', 'pagamento', 'transferir', 'transferir']","[1, 1, 1, 2, 2, 1, 1, 2, 2]","['faccao', 'faccao', 'faccao', 'faccao', 'faccao', 'torturar']","[5, 5, 5, 5, 5, 1]",9,6,15,0
567,"['broadcast', 'conformar', 'mudanca', 'recurso']","[1, 1, 1, 1]","['fingir', 'sacar', 'sacar', 'sacar', 'sacar', 'sacar', 'sacar', 'sacar', 'vc']","[1, 7, 7, 7, 7, 7, 7, 7, 1]",4,9,13,0
568,"['competicao']","[1]","['circular', 'fotografia', 'imagem', 'imagem', 'imagem', 'obama', 'obama', 'obama', 'obama']","[1, 1, 3, 3, 3, 4, 4, 4, 4]",1,9,10,0
572,"['anuncio', 'guarulho', 'machadar', 'proposto', 'regrar', 'wellington', 'wellington', 'wellington']","[1, 1, 1, 1, 1, 3, 3, 3]","[]","[]",8,0,8,0
574,"['avancar', 'flavio', 'liderar', 'reducao']","[1, 1, 1, 1]","['vc']","[1]",4,1,5,0
575,"[]","[]","['assaltar', 'compartilhar', 'incendio', 'postagen', 'soldar', 'versao']","[1, 1, 1, 1, 1, 1]",0,6,6,0
577,"['altern']","[1]","['imagem', 'parir']","[1, 1]",1,2,3,0
578,"['domingo']","[1]","['bandeiro', 'bandeiro', 'captar', 'compartilhar', 'estampar', 'fotografo', 'imagem', 'imagem', 'legendar', 'manipular', 'safar']","[2, 2, 1, 1, 1, 1, 2, 2, 1, 1, 1]",1,11,12,0
580,"[]","[]","['circular', 'compartilhar']","[1, 1]",0,2,2,0
581,"['domingo']","[1]","['inscricao']","[1]",1,1,2,0
582,"['pagamento', 'pagamento']","[2, 2]","[]","[]",2,0,2,0
583,"[]","[]","[]","[]",0,0,0,0
584,"[]","[]","['compartilhar', 'compartilhar', 'filmar', 'minutar']","[2, 2, 1, 1]",0,4,4,0
585,"['decisao', 'justicar', 'magistrado', 'ministrar', 'ministrar', 'subir', 'supremo', 'supremo']","[1, 1, 1, 2, 2, 1, 2, 2]","['amplament', 'camisa', 'imagem', 'legendar', 'soltar']","[1, 1, 1, 1, 1]",8,5,13,0
586,"['decisao']","[1]","['soltar']","[1]",1,1,2,0
589,"[]","[]","['parir', 'parir', 'sortir']","[2, 2, 1]",0,3,3,0
590,"[]","[]","[]","[]",0,0,0,0
591,"['antonio', 'antonio']","[2, 2]","['ganhar', 'ganhar', 'supostament']","[2, 2, 1]",2,3,5,0
595,"['palacio', 'regiao']","[1, 1]","['fotografo', 'fotografo']","[2, 2]",2,2,4,0
596,"['surtir']","[1]","['disseminar', 'intitular', 'narrativo']","[1, 1, 1]",1,3,4,0
597,"[]","[]","['capturar', 'imagem', 'parir', 'segundar', 'visualizar']","[1, 1, 1, 1, 1]",0,5,5,0
600,"['araujo', 'reabrir']","[1, 1]","['checar']","[1]",2,1,3,0
601,"['araujo', 'periodo', 'periodo']","[1, 2, 2]","['checar']","[1]",3,1,4,0
602,"['araujo']","[1]","['checar']","[1]",1,1,2,0
603,"['araujo']","[1]","['checar']","[1]",1,1,2,0
604,"['araujo']","[1]","['checar']","[1]",1,1,2,0
605,"['araujo']","[1]","['checar']","[1]",1,1,2,0
606,"['araujo']","[1]","['checar', 'ideologia', 'parir', 'parir']","[1, 1, 2, 2]",1,4,5,0
607,"['araujo']","[1]","['checar']","[1]",1,1,2,0
608,"['araujo']","[1]","['checar']","[1]",1,1,2,0
609,"['araujo', 'saudar']","[1, 1]","['checar', 'quantum']","[1, 1]",2,2,4,0
610,"[]","[]","[]","[]",0,0,0,0
611,"['folhar']","[1]","[]","[]",1,0,1,0
615,"['higienizacao', 'infectar', 'isolar', 'reuniao']","[1, 1, 1, 1]","['vc']","[1]",4,1,5,0
619,"[]","[]","['nasal', 'nasal', 'pelar']","[2, 2, 1]",0,3,3,0
622,"[]","[]","[]","[]",0,0,0,0
628,"['apurar', 'congresso', 'diariament', 'iniciativo', 'observar', 'privar']","[1, 1, 1, 1, 1, 1]","['parir', 'sapato', 'sapato', 'sapato', 'sapato', 'sapato', 'sapato']","[1, 6, 6, 6, 6, 6, 6]",6,7,13,0
634,"['congresso', 'federar', 'investigacao']","[1, 1, 1]","['invadir', 'vazar']","[1, 1]",3,2,5,0
636,"['publicitario']","[1]","['compartilhar', 'ganhar', 'revoltar', 'revoltar']","[1, 1, 2, 2]",1,4,5,0
637,"['recordar', 'recordar', 'recordar']","[3, 3, 3]","[]","[]",3,0,3,0
641,"['acompanhamento', 'decisao', 'ministrar', 'supremo', 'supremo']","[1, 1, 1, 2, 2]","['expulsar']","[1]",5,1,6,0
642,"['atrasar', 'cardiologista', 'circulacao', 'claudio', 'destacar', 'ritmar', 'volumar']","[1, 1, 1, 1, 1, 1, 1]","['circular', 'ganhar', 'minutar']","[1, 1, 1]",7,3,10,0
644,"['desenvolvido', 'fundacao', 'fundacao', 'fundacao', 'fundacao', 'materiaprima', 'oswaldo', 'parceria', 'prever']","[1, 4, 4, 4, 4, 1, 1, 1, 1]","['circular']","[1]",9,1,10,0
646,"[]","[]","['circular', 'espalhar', 'legendar']","[1, 1, 1]",0,3,3,0
650,"['decorrencia']","[1]","['telegram']","[1]",1,1,2,0
653,"[]","[]","['humanar']","[1]",0,1,1,0
656,"['saudar']","[1]","['compartilhar']","[1]",1,1,2,0
657,"['gabinet', 'mendonca', 'servidor', 'servidor']","[1, 1, 2, 2]","['circular', 'ganhar', 'imagem']","[1, 1, 1]",4,3,7,0
659,"['justicar', 'justicar', 'justicar']","[3, 3, 3]","['mentiroso', 'parabem', 'safar']","[1, 1, 1]",3,3,6,0
662,"[]","[]","['basto', 'ganhar', 'vc', 'vc', 'vc', 'vc']","[1, 1, 4, 4, 4, 4]",0,6,6,0
663,"['ernesto', 'saudar']","[1, 1]","['capturar', 'circular', 'compartilhar', 'usuario']","[1, 1, 1, 1]",2,4,6,0
665,"[]","[]","[]","[]",0,0,0,0
669,"['proposto']","[1]","['circular', 'compartilhar', 'misturar', 'sacar', 'sacar', 'usuario']","[1, 1, 1, 2, 2, 1]",1,6,7,0
671,"['bastidor', 'biliao', 'biliao', 'biliao', 'biliao', 'biliao', 'biliao', 'biliao', 'biliao', 'biliao', 'biliao', 'republico', 'republico', 'supremo']","[1, 10, 10, 10, 10, 10, 10, 10, 10, 10, 10, 2, 2, 1]","[]","[]",14,0,14,0
672,"['precedent']","[1]","['vc']","[1]",1,1,2,0
676,"[]","[]","['dorio', 'enganar']","[1, 1]",0,2,2,0
677,"['concedido', 'concedido']","[2, 2]","[]","[]",2,0,2,0
679,"['mello', 'republico']","[1, 1]","['compartilhar', 'espalhar', 'imagem', 'quinzena']","[1, 1, 1, 1]",2,4,6,0
680,"['dosar']","[1]","['desmaiar', 'espalhar', 'quinzena']","[1, 1, 1]",1,3,4,0
681,"[]","[]","['espalhar', 'falsar', 'redireciona']","[1, 1, 1]",0,3,3,0
685,"[]","[]","['botao', 'camiseta', 'camiseta', 'camiseta', 'clicar', 'compartilhar', 'compartilhar', 'compartilhar', 'compartilhar', 'enderecar', 'questionario']","[1, 3, 3, 3, 1, 4, 4, 4, 4, 1, 1]",0,11,11,0
686,"['autonomia', 'autonomia', 'carat', 'constituicao', 'constituicao', 'constituicao', 'constituicao', 'exercicio', 'federativo', 'federativo', 'ideologico', 'ideologico', 'ministrar', 'necessario', 'paralelo', 'permanencia', 'previsto', 'republico', 'republico', 'republico', 'republico', 'republico', 'republico']","[2, 2, 1, 4, 4, 4, 4, 1, 2, 2, 2, 2, 1, 1, 1, 1, 1, 6, 6, 6, 6, 6, 6]","[]","[]",23,0,23,0
687,"['epidemiar', 'previsao']","[1, 1]","['espalhar']","[1]",2,1,3,0
692,"[]","[]","[]","[]",0,0,0,0
694,"['determinacao', 'diagnosticar', 'domingo', 'planar', 'propagacao']","[1, 1, 1, 1, 1]","['atribuir', 'compartilhar', 'postagen']","[1, 1, 1]",5,3,8,0
695,"[]","[]","['arquivar']","[1]",0,1,1,0
698,"['discussao', 'recuperacao']","[1, 1]","['supostament']","[1]",2,1,3,0
699,"['justicar']","[1]","['circular', 'imagem', 'parir', 'pelar']","[1, 1, 1, 1]",1,4,5,0
701,"['proferir', 'respostar', 'sessao']","[1, 1, 1]","['compartilhar', 'fraudar', 'invadir', 'postagen', 'protestar', 'protestar']","[1, 1, 1, 1, 2, 2]",3,6,9,0
704,"['aurelio', 'aurelio', 'aurelio', 'aurelio', 'aurelio', 'fase', 'ministrar']","[5, 5, 5, 5, 5, 1, 1]","['adorar', 'amigar', 'imagem', 'imagem', 'soltar', 'verdadeiro']","[1, 1, 2, 2, 1, 1]",7,6,13,0
709,"['biliao', 'destinar', 'prtb', 'saudar', 'taxar']","[1, 1, 1, 1, 1]","['compartilhar']","[1]",5,1,6,0
710,"['esquema', 'estrategia', 'ministrar', 'planar', 'planar', 'republico', 'supremo']","[1, 1, 1, 2, 2, 1, 1]","['circular', 'compartilhar']","[1, 1]",7,2,9,0
712,"['aglomeracao', 'observar']","[1, 1]","['mansao', 'vc']","[1, 1]",2,2,4,0
713,"[]","[]","['estomago', 'garganta']","[1, 1]",0,2,2,0
714,"['adhanom', 'adhanom', 'saudar', 'tedro', 'tedro']","[2, 2, 1, 2, 2]","['camisa', 'circular', 'compartilhar', 'imagem']","[1, 1, 1, 1]",5,4,9,0
717,"['dedicar', 'enfermagem', 'hospitalizar', 'planar']","[1, 1, 1, 1]","['compartilhar', 'implantar', 'revoltar', 'revoltar', 'safar']","[1, 1, 2, 2, 1]",4,5,9,0
718,"[]","[]","['circular', 'gasolina', 'gasolina', 'imagem', 'legendar', 'logotipo']","[1, 2, 2, 1, 1, 1]",0,6,6,0
723,"['coreia', 'coreia']","[2, 2]","[]","[]",2,0,2,0
724,"[]","[]","['circular', 'imagem', 'imagem', 'legendar', 'protestar', 'protestar']","[1, 2, 2, 1, 2, 2]",0,6,6,0
725,"['adicionar']","[1]","['compartilhar']","[1]",1,1,2,0
726,"['arthur', 'edson', 'nelson']","[1, 1, 1]","['terrorismo']","[1]",3,1,4,0
729,"['equipamento']","[1]","['acidentar', 'acidentar', 'acidentar', 'circular', 'descricao', 'imagem']","[3, 3, 3, 1, 1, 1]",1,6,7,0
732,"['argumentar', 'californio', 'cepa', 'isolar']","[1, 1, 1, 1]","['compartilhar', 'supostament', 'usuario']","[1, 1, 1]",4,3,7,0
733,"['crescimento', 'implementacao', 'implementacao', 'monetario', 'passageiro', 'periodo', 'periodo', 'privar', 'privar', 'privar', 'privar', 'privar', 'reducao', 'viagem']","[1, 2, 2, 1, 1, 2, 2, 5, 5, 5, 5, 5, 1, 1]","['humanar']","[1]",14,1,15,0
734,"['precedent']","[1]","['equador', 'soltura']","[1, 1]",1,2,3,0
735,"['fase', 'positivar', 'saudar', 'velocidad']","[1, 1, 1, 1]","['misturar', 'verdadeiro', 'visualizacao']","[1, 1, 1]",4,3,7,0
737,"['avancar', 'quarentenar', 'viagem']","[1, 1, 1]","['camisa', 'compartilhar', 'ilustrar', 'imagem', 'postagen']","[1, 1, 1, 1, 1]",3,5,8,0
738,"[]","[]","['atribuir', 'compartilhar', 'faccao']","[1, 1, 1]",0,3,3,0
740,"['exministro', 'palacio', 'planalto', 'quedo']","[1, 1, 1, 1]","['casamentar']","[1]",4,1,5,0
744,"['apurar']","[1]","['espalhar', 'imagem', 'imagem']","[1, 2, 2]",1,3,4,0
745,"['superar', 'taxar']","[1, 1]","['parir', 'parir']","[2, 2]",2,2,4,0
746,"['client', 'determinacao', 'fabricacao', 'importacao', 'suspensao', 'suspenso']","[1, 1, 1, 1, 1, 1]","[]","[]",6,0,6,0
748,"['cerimonia', 'equipamento', 'planar', 'prever', 'previsto', 'proposto', 'proposto', 'reabertura', 'reabertura', 'reabertura', 'reabertura', 'reabertura', 'reabertura', 'reabertura', 'sugestao']","[1, 1, 1, 1, 1, 2, 2, 7, 7, 7, 7, 7, 7, 7, 1]","['crech', 'crech', 'usuario']","[2, 2, 1]",15,3,18,0
750,"['ricardo', 'ricardo']","[2, 2]","['biblia', 'catolico', 'catolico', 'catolico', 'catolico', 'cristao', 'espalhar']","[1, 4, 4, 4, 4, 1, 1]",2,7,9,0
753,"['resistencia']","[1]","['espalhar', 'misturar', 'segundar']","[1, 1, 1]",1,3,4,0
755,"['reabrir']","[1]","['caixao', 'caixao', 'compartilhar', 'gravacao', 'gravacao', 'idioma', 'legendar', 'supostament', 'viralizada']","[2, 2, 1, 2, 2, 1, 1, 1, 1]",1,9,10,0
762,"['mello']","[1]","['circular', 'compartilhar', 'compartilhar', 'imagem', 'imagem']","[1, 2, 2, 2, 2]",1,5,6,0
763,"['velocidad']","[1]","['circular', 'imagem', 'manipulacao', 'torrar', 'usuario', 'visualizacao']","[1, 1, 1, 1, 1, 1]",1,6,7,0
770,"['atrair', 'pagamento', 'suspeito']","[1, 1, 1]","['compartilhar', 'falsar', 'padrar']","[1, 1, 1]",3,3,6,0
771,"['colegio', 'colegio', 'condicao', 'condicao', 'palacio', 'palacio', 'piorar', 'reajustar', 'reajustar', 'saudar', 'saudar']","[2, 2, 2, 2, 2, 2, 1, 2, 2, 2, 2]","['chorar']","[1]",11,1,12,0
772,"[]","[]","[]","[]",0,0,0,0
775,"[]","[]","['amigar', 'amigar', 'amigar', 'ganhar', 'verdadeiro']","[3, 3, 3, 1, 1]",0,5,5,0
777,"['consequencia', 'transferir']","[1, 1]","['dorio', 'manipulacao']","[1, 1]",2,2,4,0
780,"['alcolumbr', 'circulacao', 'economia', 'economia', 'folhar', 'pagamento', 'planar', 'proposto', 'wilson', 'witzel']","[1, 1, 2, 2, 1, 1, 1, 1, 1, 1]","['compartilhar', 'espalhar', 'protestar', 'vazar']","[1, 1, 1, 1]",10,4,14,0
781,"[]","[]","['biblia', 'filmar', 'filmar', 'filmar', 'filmar']","[1, 4, 4, 4, 4]",0,5,5,0
782,"['calheiro', 'calheiro', 'depoimento', 'pratico', 'sessao']","[2, 2, 1, 1, 1]","['compartilhar', 'parir', 'sobrar']","[1, 1, 1]",5,3,8,0
786,"[]","[]","[]","[]",0,0,0,0
787,"[]","[]","[]","[]",0,0,0,0
788,"['apurar']","[1]","[]","[]",1,0,1,0
794,"['cupula']","[1]","['enganoso', 'manchet', 'manchet']","[1, 2, 2]",1,3,4,0
795,"['alunar', 'alunar', 'alunar', 'hospitalizar', 'regiao']","[3, 3, 3, 1, 1]","['rompimento']","[1]",5,1,6,0
796,"['companhia', 'companhia', 'equivalent', 'fluminens', 'fluminens', 'mantido', 'metropolitano', 'reducao', 'regiao', 'regiao', 'regiao']","[2, 2, 1, 2, 2, 1, 1, 1, 3, 3, 3]","['atribuir', 'boatar', 'compartilhar']","[1, 1, 1]",11,3,14,0
798,"['agravar', 'anteriorment', 'anteriorment', 'cepa', 'cepa', 'cepa', 'cepa', 'cepa', 'cepa', 'comportamento', 'gripezinha', 'mudanca', 'mutacao']","[1, 2, 2, 6, 6, 6, 6, 6, 6, 1, 1, 1, 1]","['garganta', 'garganta', 'garganta']","[3, 3, 3]",13,3,16,0
799,"['amplo', 'assistencia', 'autoridad', 'funcao', 'orientacao', 'orientacao', 'saudar', 'saudar', 'saudar']","[1, 1, 1, 1, 2, 2, 3, 3, 3]","[]","[]",9,0,9,0
800,"['dengu']","[1]","['boatar', 'circular', 'circular', 'suco']","[1, 2, 2, 1]",1,4,5,0
803,"[]","[]","[]","[]",0,0,0,0
804,"['comissao', 'minoria']","[1, 1]","['casamentar']","[1]",2,1,3,0
805,"['determinacao']","[1]","[]","[]",1,0,1,0
806,"['balancar', 'biliao', 'biliao', 'economia', 'importacao', 'importacao', 'kong', 'preliminar', 'quedo', 'quedo', 'reducao']","[1, 2, 2, 1, 2, 2, 1, 1, 2, 2, 1]","['boicotar', 'cbn', 'circular']","[1, 1, 1]",11,3,14,0
807,"['isolar', 'situacao']","[1, 1]","['assinalar', 'circular', 'circular', 'compartilhar', 'imagem', 'imagem', 'legendar', 'postagen']","[1, 2, 2, 1, 2, 2, 1, 1]",2,8,10,0
810,"[]","[]","[]","[]",0,0,0,0
811,"[]","[]","[]","[]",0,0,0,0
812,"['dedicar', 'reuniao', 'reuniao']","[1, 2, 2]","['amigar', 'cartaz']","[1, 1]",3,2,5,0
813,"[]","[]","[]","[]",0,0,0,0
817,"['folhar', 'fundacao', 'impactar', 'patamar', 'pratico', 'proporcao', 'varga']","[1, 1, 1, 1, 1, 1, 1]","['bandeiro', 'bandeiro', 'parir', 'parir', 'parir', 'pelar', 'pelar', 'segundar']","[2, 2, 3, 3, 3, 2, 2, 1]",7,8,15,0
818,"['propagacao']","[1]","[]","[]",1,0,1,0
820,"['entregu', 'regrar', 'respostar']","[1, 1, 1]","['enderecar', 'ganhar', 'ganhar', 'ganhar', 'parabem', 'parir', 'questionario', 'selecionar', 'sobrar', 'sortir', 'sortir']","[1, 3, 3, 3, 1, 1, 1, 1, 1, 2, 2]",3,11,14,0
821,"['plenario', 'plenario', 'viagem']","[2, 2, 1]","['circular', 'drone', 'minutar']","[1, 1, 1]",3,3,6,0
822,"[]","[]","['arquivar']","[1]",0,1,1,0
823,"['ministrar', 'recuperacao', 'risco']","[1, 1, 1]","[]","[]",3,0,3,0
824,"[]","[]","['atribuir', 'padrar', 'padrar', 'padrar', 'viralizado', 'viralizado']","[1, 3, 3, 3, 2, 2]",0,6,6,0
829,"['airlin', 'apurar', 'conduta', 'inquerito', 'preventivo', 'supremo']","[1, 1, 1, 1, 1, 1]","['circular', 'imagem', 'sequer']","[1, 1, 1]",6,3,9,0
831,"['balancar', 'crise', 'destinar', 'esperancar', 'esperancar', 'externo', 'supremo']","[1, 1, 1, 2, 2, 1, 1]","[]","[]",7,0,7,0
833,"['estatistico', 'saudar', 'suspeito']","[1, 1, 1]","['caixao', 'circular', 'realment']","[1, 1, 1]",3,3,6,0
838,"['oferecido', 'preocupacao', 'provincia']","[1, 1, 1]","['abencoar', 'cristao', 'cristao', 'cristao', 'cristao', 'minutar', 'misericordia', 'vc']","[1, 4, 4, 4, 4, 1, 1, 1]",3,8,11,0
841,"['regiao', 'regiao']","[2, 2]","['imagem', 'parir', 'segundar', 'sobrar']","[1, 1, 1, 1]",2,4,6,0
842,"[]","[]","[]","[]",0,0,0,0
843,"['fase', 'fase', 'fase', 'testagem']","[3, 3, 3, 1]","['cobaia', 'cobaia']","[2, 2]",4,2,6,0
847,"['campino', 'planar', 'plano']","[1, 1, 1]","['compartilhar', 'dorio']","[1, 1]",3,2,5,0
852,"[]","[]","['acidentar', 'amplament', 'compartilhar', 'compartilhar', 'compartilhar', 'ganhar', 'ganhar', 'verdadeiro']","[1, 1, 3, 3, 3, 2, 2, 1]",0,8,8,0
853,"['afp', 'comparacao']","[1, 1]","['circular', 'compartilhar', 'idioma', 'imagem', 'legendar', 'viralizado']","[1, 1, 1, 1, 1, 1]",2,6,8,0
855,"[]","[]","[]","[]",0,0,0,0
862,"['especialment', 'externo', 'mutacao']","[1, 1, 1]","['misturar', 'misturar', 'nasal', 'pelar', 'puro']","[2, 2, 1, 1, 1]",3,5,8,0
863,"['esperancar', 'molecular', 'obtido']","[1, 1, 1]","['espalhar', 'parir', 'replicar']","[1, 1, 1]",3,3,6,0
864,"['congresso', 'mantido', 'ministrar']","[1, 1, 1]","['fingir', 'ideologia', 'invadir', 'sacar']","[1, 1, 1, 1]",3,4,7,0
865,"['inedito', 'internacao']","[1, 1]","['versao']","[1]",2,1,3,0
866,"['aurelio', 'barroso', 'fachin', 'fux', 'lewandowski', 'randolf']","[1, 1, 1, 1, 1, 1]","['adelio', 'autopsia', 'gleisi', 'inocentar', 'lazaro', 'lazaro', 'lazaro', 'lazaro', 'lazaro', 'lazaro', 'lazaro', 'lazaro', 'lazaro', 'lazaro', 'lazaro', 'lazaro', 'lazaro', 'lazaro', 'lazaro', 'parir', 'parir', 'pelar', 'rosario']","[1, 1, 1, 1, 15, 15, 15, 15, 15, 15, 15, 15, 15, 15, 15, 15, 15, 15, 15, 2, 2, 1, 1]",6,23,29,0
867,"[]","[]","[]","[]",0,0,0,0
870,"['articulacao', 'dificuldad', 'distrito', 'exercicio', 'necessidad', 'realizacao']","[1, 1, 1, 1, 1, 1]","['amigar', 'inscricao', 'parabem']","[1, 1, 1]",6,3,9,0
874,"['respostar']","[1]","[]","[]",1,0,1,0
876,"['possibilidad']","[1]","['circular', 'indignar', 'legendar', 'postagen', 'usuario', 'venezuelano', 'viralizada']","[1, 1, 1, 1, 1, 1, 1]",1,7,8,0
879,"['hospitalizar', 'regiao', 'saudad']","[1, 1, 1]","['assassinar', 'atribuir', 'circular', 'crech']","[1, 1, 1, 1]",3,4,7,0
880,"['apurar', 'reuniao', 'subir']","[1, 1, 1]","['boatar']","[1]",3,1,4,0
882,"['circulacao', 'circulacao']","[2, 2]","['autopsia', 'autopsia', 'enganir', 'misturar', 'verdadeiro']","[2, 2, 1, 1, 1]",2,5,7,0
886,"['alteracao', 'boletim', 'constatar', 'constatar', 'distrito', 'distrito', 'vespera']","[1, 1, 2, 2, 2, 2, 1]","['circular', 'fraudar']","[1, 1]",7,2,9,0
887,"['compromisso', 'subir']","[1, 1]","['filmar', 'filmar', 'ganhar', 'humanar', 'humanar', 'intitular']","[2, 2, 1, 2, 2, 1]",2,6,8,0
889,"['pastar']","[1]","[]","[]",1,0,1,0
890,"['prazo']","[1]","['estranhar']","[1]",1,1,2,0
891,"['mudanca', 'periodo', 'pratico', 'pratico']","[1, 1, 2, 2]","['abortar', 'abortar', 'abortar', 'cristao']","[3, 3, 3, 1]",4,4,8,0
893,"[]","[]","['espalhar', 'parir', 'postagen']","[1, 1, 1]",0,3,3,0
894,"[]","[]","['circular', 'compartilhar', 'imenso', 'imenso', 'postagen', 'replicar', 'usuario']","[1, 1, 2, 2, 1, 1, 1]",0,7,7,0
895,"['reconhecimento']","[1]","['circular', 'imagem', 'imagem', 'imagem', 'protestar', 'protestar']","[1, 3, 3, 3, 2, 2]",1,6,7,0
899,"[]","[]","['compartilhar']","[1]",0,1,1,0
900,"[]","[]","[]","[]",0,0,0,0
903,"['mantido', 'universitario']","[1, 1]","['enganoso', 'nobel', 'postagen']","[1, 1, 1]",2,3,5,0
905,"['alcolumbr', 'demap', 'demrj', 'jantar', 'reuniao', 'supremo']","[1, 1, 1, 1, 1, 1]","['circular']","[1]",6,1,7,0
906,"['companhia', 'contrato', 'reforcar', 'suspensao']","[1, 1, 1, 1]","['circular', 'circular', 'desmentir', 'disseminar']","[2, 2, 1, 1]",4,4,8,0
907,"[]","[]","[]","[]",0,0,0,0
908,"['aplicacao']","[1]","['basto', 'parir', 'pelar']","[1, 1, 1]",1,3,4,0
909,"[]","[]","['assaltar', 'assaltar', 'assassinar', 'desgracar']","[2, 2, 1, 1]",0,4,4,0
911,"[]","[]","['indignar']","[1]",0,1,1,0
913,"['autoridad', 'autoridad', 'converso', 'deltan', 'justicar', 'ministrar', 'ministrar', 'ministrar']","[2, 2, 1, 1, 1, 3, 3, 3]","['circular', 'circular', 'compartilhar', 'imagem', 'imagem', 'telegram', 'telegram']","[2, 2, 1, 2, 2, 2, 2]",8,7,15,0
915,"[]","[]","['chorar', 'circular', 'compartilhar', 'idioma', 'soldar', 'torturar']","[1, 1, 1, 1, 1, 1]",0,6,6,0
918,"[]","[]","[]","[]",0,0,0,0
919,"['congresso']","[1]","['telejorn']","[1]",1,1,2,0
920,"['presenca']","[1]","['disfarcar', 'imagem', 'usuario', 'usuario']","[1, 1, 2, 2]",1,4,5,0
921,"['curso', 'infeccioso', 'saudar']","[1, 1, 1]","['circular', 'garganta']","[1, 1]",3,2,5,0
922,"[]","[]","['imagem']","[1]",0,1,1,0
924,"['ministrar', 'ministrar', 'reducao', 'saudar', 'saudar']","[2, 2, 1, 2, 2]","['caixao', 'caixao', 'vazio']","[2, 2, 1]",5,3,8,0
925,"['disseminacao', 'instituto', 'journal', 'saudar']","[1, 1, 1, 1]","['compartilhar', 'supostament']","[1, 1]",4,2,6,0
926,"[]","[]","['amigar', 'pelar']","[1, 1]",0,2,2,0
928,"['conformar', 'goncalv']","[1, 1]","['parir', 'parir', 'parir']","[3, 3, 3]",2,3,5,0
933,"['gabinet', 'investigacao', 'reuniao']","[1, 1, 1]","['boatar', 'circular', 'circular', 'motorista']","[1, 2, 2, 1]",3,4,7,0
934,"['epidemiar', 'lancamento']","[1, 1]","['ganhar', 'ilustrar', 'imagem', 'imagem', 'legendar']","[1, 1, 2, 2, 1]",2,5,7,0
935,"['previsao']","[1]","[]","[]",1,0,1,0
936,"[]","[]","['lazaro', 'lazaro']","[2, 2]",0,2,2,0
937,"[]","[]","[]","[]",0,0,0,0
939,"['administrativo', 'enfermagem', 'logistico', 'plano', 'saudar']","[1, 1, 1, 1, 1]","['amigar', 'wagner']","[1, 1]",5,2,7,0
940,"['biliao', 'previsto', 'rotina']","[1, 1, 1]","['enganoso', 'parir', 'parir', 'pelar', 'segundar']","[1, 2, 2, 1, 1]",3,5,8,0
941,"['adesao', 'autoridad', 'disseminacao', 'equipamento', 'percepcao', 'quedo', 'sabado', 'saudar']","[1, 1, 1, 1, 1, 1, 1, 1]","['circular', 'legendar']","[1, 1]",8,2,10,0
944,"['circulacao', 'infectar', 'positivar', 'positivar', 'positivar']","[1, 1, 3, 3, 3]","['espalhar', 'supostament', 'supostament', 'versao', 'versao', 'versao', 'versao', 'versao']","[1, 2, 2, 5, 5, 5, 5, 5]",5,8,13,0
947,"['internar']","[1]","['espalhar', 'manchet', 'quinzena']","[1, 1, 1]",1,3,4,0
948,"['argumentar', 'complicacao']","[1, 1]","['circular', 'garganta', 'garganta', 'misturar']","[1, 2, 2, 1]",2,4,6,0
950,"[]","[]","['nobel']","[1]",0,1,1,0
952,"[]","[]","['espalhar', 'espalhar', 'imagem']","[2, 2, 1]",0,3,3,0
954,"['normalidad']","[1]","['versao']","[1]",1,1,2,0
956,"['estrategia', 'imunizacao', 'necessario']","[1, 1, 1]","['circular', 'circular', 'enganoso']","[2, 2, 1]",3,3,6,0
957,"['avancar']","[1]","['agredir', 'circular', 'compartilhar', 'descricao', 'postagen', 'protestar', 'protestar']","[1, 1, 1, 1, 1, 2, 2]",1,7,8,0
958,"['decisao', 'exgovernador', 'privar', 'wilson', 'witzel', 'witzel']","[1, 1, 1, 1, 2, 2]","['checar', 'sobrar', 'sobrar']","[1, 2, 2]",6,3,9,0
959,"[]","[]","['botao', 'botao', 'camisa', 'camiseta', 'camiseta', 'camiseta', 'camiseta', 'clicar', 'clicar', 'compartilhar', 'compartilhar', 'compartilhar', 'ganhar', 'ganhar', 'ganhar', 'verdadeiro']","[2, 2, 1, 4, 4, 4, 4, 2, 2, 3, 3, 3, 3, 3, 3, 1]",0,16,16,0
960,"['concreto', 'periodo']","[1, 1]","['disseminar', 'disseminar', 'realment']","[2, 2, 1]",2,3,5,0
963,"['agravamento', 'alvaro', 'autoridad', 'preventivo', 'saudar']","[1, 1, 1, 1, 1]","[]","[]",5,0,5,0
966,"['decisao', 'decisao', 'supremo']","[2, 2, 1]","['estuprar', 'inocentar', 'inocentar', 'parabem', 'soltar', 'soltar', 'vazar']","[1, 2, 2, 1, 2, 2, 1]",3,7,10,0
967,"['ministrar', 'ministrar', 'palacio', 'planalto', 'reuniao', 'ricardo', 'sall']","[2, 2, 1, 1, 1, 1, 1]","[]","[]",7,0,7,0
971,"['folhar', 'instituto', 'palacio', 'planalto']","[1, 1, 1, 1]","['circular', 'compartilhar', 'compartilhar', 'expulsar', 'gravacao', 'inscricao', 'postagen']","[1, 2, 2, 1, 1, 1, 1]",4,7,11,0
972,"['apreensao', 'deltan', 'federar', 'gabinet', 'investigacao', 'republico']","[1, 1, 1, 1, 1, 1]","['parir', 'pelar', 'segundar']","[1, 1, 1]",6,3,9,0
973,"[]","[]","['gravacao', 'imagem', 'realment', 'vezar', 'visualizar']","[1, 1, 1, 1, 1]",0,5,5,0
974,"[]","[]","['atribuir', 'compartilhar', 'compartilhar', 'imagem', 'postagen']","[1, 2, 2, 1, 1]",0,5,5,0
978,"['ambientar', 'infectar']","[1, 1]","['compartilhar', 'estomago', 'estomago', 'garganta', 'verificar']","[1, 2, 2, 1, 1]",2,5,7,0
979,"['exportacao', 'exportacao', 'periodo', 'reajust', 'recordar']","[2, 2, 1, 1, 1]","[]","[]",5,0,5,0
980,"['necessidad', 'positivar', 'prever', 'prever', 'prever']","[1, 1, 3, 3, 3]","['compartilhar', 'puro']","[1, 1]",5,2,7,0
982,"['externo']","[1]","['circular', 'compartilhar', 'compartilhar', 'gravacao', 'legendar', 'postagen']","[1, 2, 2, 1, 1, 1]",1,6,7,0
984,"['amplo', 'carla', 'comissao', 'minoria', 'possibilidad', 'proposto', 'proposto', 'pslsp', 'regulamentar', 'situacao', 'zambelli', 'zambelli']","[1, 1, 1, 1, 1, 2, 2, 1, 1, 1, 2, 2]","['casamentar', 'compartilhar', 'disseminar', 'postagen']","[1, 1, 1, 1]",12,4,16,0
985,"['especifico', 'taxar']","[1, 1]","['circular', 'compartilhar', 'postagen', 'versao']","[1, 1, 1, 1]",2,4,6,0
988,"['decisao', 'discussao', 'projecao']","[1, 1, 1]","['atribuir', 'circular', 'falsar', 'falsar', 'falsar', 'falsar', 'ganhar', 'imagem', 'verificar', 'verificar', 'verificar']","[1, 1, 4, 4, 4, 4, 1, 1, 3, 3, 3]",3,11,14,0
990,"['manutencao', 'necessario', 'tendencia']","[1, 1, 1]","['espalhar', 'imagem', 'menino']","[1, 1, 1]",3,3,6,0
993,"['folhar']","[1]","['quinzena']","[1]",1,1,2,0
994,"['afastamento', 'afastamento', 'desvio', 'fabricio', 'fabricio', 'flavio', 'flavio', 'goncalv', 'inicialment', 'investigacao', 'irregularidad', 'justicar', 'justicar', 'ministrar', 'ministrar', 'queiroz', 'queiroz', 'republicanosrj', 'saudar', 'supremo', 'wilson', 'wilson', 'witzel', 'witzel', 'witzel']","[2, 2, 1, 2, 2, 2, 2, 1, 1, 1, 1, 2, 2, 2, 2, 2, 2, 1, 1, 1, 2, 2, 3, 3, 3]","['amigar', 'circular', 'soltar']","[1, 1, 1]",25,3,28,0
998,"['iniciativo']","[1]","['espalhar']","[1]",1,1,2,0
1001,"[]","[]","['compartilhar', 'espalhar', 'imagem']","[1, 1, 1]",0,3,3,0
1002,"['avancar', 'bbc', 'bbc']","[1, 2, 2]","['curioso', 'imagem', 'manipular', 'parir', 'parir', 'pelar', 'segundar']","[1, 1, 1, 2, 2, 1, 1]",3,7,10,0
1005,"['ministrar', 'quadro']","[1, 1]","['atribuir', 'circular']","[1, 1]",2,2,4,0
1006,"[]","[]","['camiseta', 'camiseta', 'circular', 'circular', 'estampar', 'imagem', 'inscricao', 'legendar', 'verdadeiro']","[2, 2, 2, 2, 1, 1, 1, 1, 1]",0,9,9,0
1007,"['coletivo', 'epidemiar', 'importancia', 'internacao', 'periodo', 'proporcao', 'sobretudo', 'taxar', 'taxar', 'taxar', 'transmissao', 'transmissao', 'transmissao']","[1, 1, 1, 1, 1, 1, 1, 3, 3, 3, 3, 3, 3]","['circular']","[1]",13,1,14,0
1009,"['decisao', 'ministrar', 'nomeacao', 'ramagem']","[1, 1, 1, 1]","[]","[]",4,0,4,0
1011,"['belgica', 'belgica', 'conjuntar', 'fundacao']","[2, 2, 1, 1]","['enderecar', 'enderecar', 'pelar', 'sortear']","[2, 2, 1, 1]",4,4,8,0
1013,"['andrew', 'internar', 'internar', 'investigacao']","[1, 2, 2, 1]","['agredir', 'captar', 'circular', 'falsar', 'filmar', 'filmar', 'legendar', 'protestar']","[1, 1, 1, 1, 2, 2, 1, 1]",4,8,12,0
1014,"['afastamento', 'afastamento', 'alvaro', 'assistencia', 'augusto', 'comissao', 'comissao', 'comissao', 'comissao', 'destacar', 'oliveira', 'presidir']","[2, 2, 1, 1, 1, 4, 4, 4, 4, 1, 1, 1]","[]","[]",12,0,12,0
1015,"['federar']","[1]","['mafia']","[1]",1,1,2,0
1017,"['regrar']","[1]","['circular']","[1]",1,1,2,0
1018,"['oficialment', 'rejeitar']","[1, 1]","['circular', 'fraudar', 'fraudar', 'fraudar']","[1, 3, 3, 3]",2,4,6,0
1020,"[]","[]","['fingir', 'mentiroso', 'parabem', 'rosario', 'rosario', 'rosario']","[1, 1, 1, 3, 3, 3]",0,6,6,0
1022,"['converso', 'converso', 'deltan', 'republico']","[2, 2, 1, 1]","['espalhar', 'imagem', 'telegram', 'vazar']","[1, 1, 1, 1]",4,4,8,0
1023,"['sabado']","[1]","['circular', 'expulsar', 'imagem', 'protestar', 'soltar']","[1, 1, 1, 1, 1]",1,5,6,0
1024,"['anvisa', 'ausencia', 'impacto', 'infeccioso', 'pastar', 'reducao', 'reflexo', 'risco', 'saudar', 'vigilancia']","[1, 1, 1, 1, 1, 1, 1, 1, 1, 1]","['circular', 'segundar', 'sobrar']","[1, 1, 1]",10,3,13,0
1026,"['respostar']","[1]","['parabem']","[1]",1,1,2,0
1028,"['saudar', 'saudar']","[2, 2]","['faccao', 'manipular', 'vazar']","[1, 1, 1]",2,3,5,0
1030,"['republico']","[1]","['circular']","[1]",1,1,2,0
1031,"['anuncio', 'justicar', 'preventivo', 'preventivo', 'resolucao', 'respectivament', 'respirador']","[1, 1, 2, 2, 1, 1, 1]","['enganir', 'inscricao', 'legendar', 'postagen']","[1, 1, 1, 1]",7,4,11,0
1032,"[]","[]","[]","[]",0,0,0,0
1033,"[]","[]","[]","[]",0,0,0,0
1034,"['biliao', 'biliao', 'biliao', 'dificultar', 'discussao', 'distrito', 'recurso', 'recurso', 'transferir', 'transferir', 'transferir']","[3, 3, 3, 1, 1, 1, 2, 2, 3, 3, 3]","[]","[]",11,0,11,0
1035,"['biliao', 'desenvolvido', 'especifico', 'estimativo', 'expectativa', 'expectativa']","[1, 1, 1, 1, 2, 2]","[]","[]",6,0,6,0
1036,"[]","[]","[]","[]",0,0,0,0
1039,"['advocaciager', 'apurar', 'bancada', 'decisao', 'especifico', 'federar', 'federar', 'processo', 'suspenso']","[1, 1, 1, 1, 1, 2, 2, 1, 1]","['gravacao']","[1]",9,1,10,0
1040,"['ministrar', 'republico']","[1, 1]","['ganhar']","[1]",2,1,3,0
1041,"[]","[]","['circular', 'compartilhar']","[1, 1]",0,2,2,0
1042,"[]","[]","['circular', 'compartilhar', 'ganhar', 'imagem', 'legendar', 'postagen']","[1, 1, 1, 1, 1, 1]",0,6,6,0
1043,"[]","[]","['bandeiro', 'bandeiro', 'desgracar', 'dorio']","[2, 2, 1, 1]",0,4,4,0
1045,"['justicar', 'substituicao']","[1, 1]","['circular', 'fraudar', 'imagem', 'mafia']","[1, 1, 1, 1]",2,4,6,0
1047,"['situacao']","[1]","['amplament', 'circular', 'compartilhar', 'compartilhar']","[1, 1, 2, 2]",1,4,5,0
1049,"['alternativo', 'saudar', 'saudar']","[1, 2, 2]","['misturar', 'vitaminar']","[1, 1]",3,2,5,0
1050,"['economia', 'infectar', 'reforcar']","[1, 1, 1]","['circular', 'espalhar', 'espalhar', 'imagem', 'inscricao']","[1, 2, 2, 1, 1]",3,5,8,0
1051,"['consequencia', 'economia', 'privar', 'privar', 'varar']","[1, 1, 2, 2, 1]","['protestar', 'protestar', 'socialismo']","[2, 2, 1]",5,3,8,0
1052,"['campino', 'metropolitano']","[1, 1]","['atirar', 'catedr']","[1, 1]",2,2,4,0
1055,"[]","[]","['imagem', 'minutar', 'segundar']","[1, 1, 1]",0,3,3,0
1056,"[]","[]","[]","[]",0,0,0,0
1058,"['depressao', 'habito']","[1, 1]","['amplament', 'circular', 'compartilhar', 'postagen', 'versao']","[1, 1, 1, 1, 1]",2,5,7,0
1063,"['suspeito']","[1]","['compartilhar', 'imagem', 'parir', 'parir', 'sobrar', 'vezar']","[1, 1, 2, 2, 1, 1]",1,6,7,0
1064,"['desenvolvido', 'instalacao']","[1, 1]","['humanar']","[1]",2,1,3,0
1065,"['hospitalizar', 'submetido']","[1, 1]","['compartilhar', 'compartilhar', 'crer']","[2, 2, 1]",2,3,5,0
1066,"['subir', 'subir', 'transmissao', 'transmissao']","[2, 2, 2, 2]","['dorio', 'dorio', 'dorio', 'realment']","[3, 3, 3, 1]",4,4,8,0
1068,"['autoridad', 'renata', 'saudar']","[1, 1, 1]","['circular', 'imagem', 'imagem', 'legendar']","[1, 2, 2, 1]",3,4,7,0
1071,"['atuacao', 'consultoria', 'depoimento', 'depoimento', 'disseminacao', 'gabinet', 'paralelo', 'republico']","[1, 1, 2, 2, 1, 1, 1, 1]","['pelar', 'sobrar', 'sobrar']","[1, 2, 2]",8,3,11,0
1072,"['infectar', 'pulmonar']","[1, 1]","['espalhar', 'pelar']","[1, 1]",2,2,4,0
1074,"['congresso', 'plenario', 'prazo', 'republico']","[1, 1, 1, 1]","[]","[]",4,0,4,0
1078,"['dificuldad']","[1]","['circular', 'compartilhar', 'imagem', 'imagem', 'inscricao']","[1, 1, 2, 2, 1]",1,5,6,0
1080,"[]","[]","['circular', 'imagem', 'indignar', 'legendar', 'lembres', 'usuario', 'viralizada']","[1, 1, 1, 1, 1, 1, 1]",0,7,7,0
1081,"['alunar', 'autorizacao', 'contabilizar', 'destinar', 'esforco', 'esforco', 'intenso', 'intenso', 'nomeacao', 'recordar', 'sabado', 'saudar', 'subir', 'vespera']","[1, 1, 1, 1, 2, 2, 2, 2, 1, 1, 1, 1, 1, 1]","['invadir']","[1]",14,1,15,0
1082,"['iniciativo', 'republico', 'secom']","[1, 1, 1]","[]","[]",3,0,3,0
1084,"['destinar', 'especialment', 'moderno', 'moderno', 'quarentenar', 'quarentenar']","[1, 1, 2, 2, 2, 2]","['autopsia', 'autopsia']","[2, 2]",6,2,8,0
1092,"[]","[]","[]","[]",0,0,0,0
1097,"[]","[]","['espalhar', 'imagem']","[1, 1]",0,2,2,0
1098,"[]","[]","['atribuir', 'fotografo', 'imagem', 'postagen', 'reverso', 'viralizada']","[1, 1, 1, 1, 1, 1]",0,6,6,0
1100,"[]","[]","['checar', 'compartilhar', 'compartilhar', 'manipular', 'soltar', 'usuario']","[1, 2, 2, 1, 1, 1]",0,6,6,0
1103,"['etapa', 'etapa', 'etapa']","[3, 3, 3]","['clicar', 'compartilhar', 'galaxi', 'ganhar', 'ganhar', 'instrucao', 'instrucao', 'lembres', 'parabem', 'parabem', 'reivindicar', 'reivindicar', 'reivindicar', 'sortir', 'sortir', 'sortir', 'verificar']","[1, 1, 1, 2, 2, 2, 2, 1, 2, 2, 3, 3, 3, 3, 3, 3, 1]",3,17,20,0
1106,"['constituicao', 'converso', 'expectativa', 'regrar', 'regrar', 'regrar', 'regrar', 'salao']","[1, 1, 1, 4, 4, 4, 4, 1]","['ganhar', 'ganhar', 'ganhar', 'ganhar', 'ganhar', 'ganhar', 'ganhar', 'ganhar', 'ganhar', 'torrar']","[9, 9, 9, 9, 9, 9, 9, 9, 9, 1]",8,10,18,0
1107,"['infraestrutura', 'recurso', 'saudar', 'viagem']","[1, 1, 1, 1]","['desgracar', 'ganhar', 'indignacao', 'lixar', 'sacar']","[1, 1, 1, 1, 1]",4,5,9,0
1109,"['expressar']","[1]","['capturar', 'compartilhar', 'gleisi', 'gleisi', 'indignacao', 'misericordia', 'supostament', 'usuario']","[1, 1, 2, 2, 1, 1, 1, 1]",1,8,9,0
1111,"['desenvolvimento', 'servidor']","[1, 1]","['circular', 'circular']","[2, 2]",2,2,4,0
1112,"['aglomeracao', 'domingo', 'spaulo']","[1, 1, 1]","['arquivar', 'circular', 'falsar', 'imagem']","[1, 1, 1, 1]",3,4,7,0
1114,"['adhanom', 'adhanom', 'europeu', 'infectar', 'tedro']","[2, 2, 1, 1, 1]","['imagem', 'legendar']","[1, 1]",5,2,7,0
1115,"['administrativo', 'administrativo', 'administrativo', 'anosr', 'anosr', 'campino', 'parceria', 'parceria', 'parceria', 'prazo', 'prazo', 'prazo', 'prazo', 'prazo', 'prazo', 'recebido', 'recebido', 'recebido', 'transicao', 'transicao', 'transicao']","[3, 3, 3, 2, 2, 1, 3, 3, 3, 6, 6, 6, 6, 6, 6, 3, 3, 3, 3, 3, 3]","[]","[]",21,0,21,0
1120,"[]","[]","[]","[]",0,0,0,0
1121,"['distrito', 'investigacao', 'santiago']","[1, 1, 1]","[]","[]",3,0,3,0
1122,"[]","[]","['menino', 'motorista', 'usuario']","[1, 1, 1]",0,3,3,0
1128,"['federar']","[1]","['circular', 'gravacao', 'sortir', 'verdadeiro']","[1, 1, 1, 1]",1,4,5,0
1129,"['especialment', 'exercicio', 'instituto', 'instituto', 'instituto', 'necessario', 'periodo', 'prever', 'previsao']","[1, 1, 3, 3, 3, 1, 1, 1, 1]","['desmaiar', 'equador', 'sequer', 'telejorn', 'verificar']","[1, 1, 1, 1, 1]",9,5,14,0
1130,"['converso', 'henri', 'henri', 'investigacao']","[1, 2, 2, 1]","['adelio', 'adelio', 'amplament', 'circular', 'compartilhar', 'menino', 'postagen', 'versao']","[2, 2, 1, 1, 1, 1, 1, 1]",4,8,12,0
1132,"['aglomeracao', 'aglomeracao', 'aglomeracao', 'aglomeracao', 'aglomeracao', 'aglomeracao', 'aglomeracao', 'aglomeracao', 'aglomeracao', 'crise', 'crise', 'crise', 'crise', 'crise', 'dialogo', 'dialogo', 'dialogo', 'dialogo', 'enfrentamento', 'enfrentamento', 'enfrentamento', 'enfrentamento', 'iniciativo', 'iniciativo', 'iniciativo', 'iniciativo', 'iniciativo', 'opcao', 'opcao', 'opcao', 'opcao', 'opcao', 'reducao', 'reducao', 'reducao', 'reducao', 'reducao', 'regiao', 'saudar', 'saudar', 'saudar', 'saudar', 'saudar', 'saudar', 'saudar', 'saudar', 'saudar', 'situacao', 'situacao', 'situacao', 'situacao', 'situacao']","[9, 9, 9, 9, 9, 9, 9, 9, 9, 5, 5, 5, 5, 5, 4, 4, 4, 4, 4, 4, 4, 4, 5, 5, 5, 5, 5, 5, 5, 5, 5, 5, 5, 5, 5, 5, 5, 1, 9, 9, 9, 9, 9, 9, 9, 9, 9, 5, 5, 5, 5, 5]","[]","[]",52,0,52,0
1133,"['aglomeracao', 'propagacao']","[1, 1]","['legendar', 'postagen', 'sequer', 'viralizada', 'visualizar']","[1, 1, 1, 1, 1]",2,5,7,0
1136,"['observar']","[1]","['fingir', 'fingir', 'vc']","[2, 2, 1]",1,3,4,0
1139,"['anuncio', 'desenvolvimento', 'instituto', 'investigacao', 'rejeitar']","[1, 1, 1, 1, 1]","['dorio', 'dorio']","[2, 2]",5,2,7,0
1141,"[]","[]","['fraudar', 'gravacao', 'supostament']","[1, 1, 1]",0,3,3,0
1143,"['mello']","[1]","['motorista', 'terrorismo']","[1, 1]",1,2,3,0
1146,"[]","[]","['efarsa']","[1]",0,1,1,0
1148,"['alcolumbr', 'aprovacao', 'broadcast', 'broadcast', 'comissao', 'decisao', 'demap', 'inquerito', 'instalacao', 'integrant', 'paralisar', 'supremo']","[1, 1, 2, 2, 1, 1, 1, 1, 1, 1, 1, 1]","['atribuir', 'mencao', 'viralizado']","[1, 1, 1]",12,3,15,0
1149,"['minoria']","[1]","['ganhar', 'realment', 'realment', 'safar', 'vc']","[1, 2, 2, 1, 1]",1,5,6,0
1152,"['ambientar', 'impactar', 'mudanca']","[1, 1, 1]","['gretar', 'gretar', 'humanar', 'parir', 'parir', 'protestar']","[2, 2, 1, 2, 2, 1]",3,6,9,0
1155,"['universitario']","[1]","[]","[]",1,0,1,0
1157,"['acumular', 'ministrar', 'reducao', 'saudar', 'saudar']","[1, 1, 1, 2, 2]","['circular', 'compartilhar']","[1, 1]",5,2,7,0
1160,"['extraordinario']","[1]","[]","[]",1,0,1,0
1167,"['autoridad', 'saudar']","[1, 1]","['circular', 'imagem', 'legendar', 'misturar']","[1, 1, 1, 1]",2,4,6,0
1168,"['companhia']","[1]","['parir', 'parir', 'parir', 'sobrar']","[3, 3, 3, 1]",1,4,5,0
1169,"['anuncio']","[1]","['compartilhar', 'espalhar']","[1, 1]",1,2,3,0
1173,"['defendido', 'estrategia', 'flavio', 'implementar', 'minimizar', 'propagacao', 'saudar', 'saudar', 'saudar']","[1, 1, 1, 1, 1, 1, 3, 3, 3]","['legendar']","[1]",9,1,10,0
1176,"['especialment', 'exercicio', 'instituto', 'instituto', 'instituto', 'periodo', 'prever', 'previsao']","[1, 1, 3, 3, 3, 1, 1, 1]","['equador', 'sequer', 'telejorn']","[1, 1, 1]",8,3,11,0
1177,"[]","[]","['captar', 'rouanet', 'rouanet', 'rouanet', 'rouanet', 'sobrar']","[1, 4, 4, 4, 4, 1]",0,6,6,0
1178,"['atrasar', 'barroso', 'destacar', 'domingo', 'equipamento', 'equipamento', 'equipamento', 'equipamento', 'justicar', 'manutencao', 'ministrar', 'ministrar', 'prever']","[1, 1, 1, 1, 4, 4, 4, 4, 1, 1, 2, 2, 1]","['circular', 'fraudar', 'mencao']","[1, 1, 1]",13,3,16,0
1180,"['domingo', 'necessario']","[1, 1]","['adelio', 'gleisi', 'gleisi']","[1, 2, 2]",2,3,5,0
1181,"[]","[]","['circular', 'imagem', 'usuario']","[1, 1, 1]",0,3,3,0
1182,"[]","[]","['parir', 'segundar']","[1, 1]",0,2,2,0
1184,"[]","[]","['protestar', 'protestar', 'terrorismo', 'vc', 'vc', 'vc']","[2, 2, 1, 3, 3, 3]",0,6,6,0
1186,"[]","[]","[]","[]",0,0,0,0
1187,"[]","[]","['cristao', 'cristao', 'vc']","[2, 2, 1]",0,3,3,0
1189,"[]","[]","[]","[]",0,0,0,0
1190,"[]","[]","['boicot', 'boicotar', 'verdadeiro']","[1, 1, 1]",0,3,3,0
1191,"['autoridad', 'enfatizar', 'privar', 'privar']","[1, 1, 2, 2]","['assaltar', 'assaltar', 'rosario', 'rosario', 'rosario']","[2, 2, 3, 3, 3]",4,5,9,0
1192,"['colegio']","[1]","['ganhar', 'parabem']","[1, 1]",1,2,3,0
1193,"[]","[]","['realment']","[1]",0,1,1,0
1195,"['congresso', 'decorrent', 'provisorio']","[1, 1, 1]","[]","[]",3,0,3,0
1196,"['escalar']","[1]","['minutar']","[1]",1,1,2,0
1197,"['argumentar', 'argumentar', 'constatar', 'equivalent', 'pratico', 'quarentenar', 'regiao']","[2, 2, 1, 1, 1, 1, 1]","[]","[]",7,0,7,0
1199,"['antecipar', 'cnj', 'concedido', 'justicar', 'justicar', 'magistrado', 'periodo', 'possibilidad', 'previsto', 'propagacao']","[1, 1, 1, 2, 2, 1, 1, 1, 1, 1]","['circular', 'compartilhar']","[1, 1]",10,2,12,0
1200,"['cj']","[1]","['circular', 'circular', 'estranhar', 'idioma', 'imagem', 'legendar', 'postagen', 'reverso', 'usuario']","[2, 2, 1, 1, 1, 1, 1, 1, 1]",1,9,10,0
1202,"['decorrent']","[1]","['incendio']","[1]",1,1,2,0
1203,"['parceria', 'planar']","[1, 1]","['basto', 'compartilhar']","[1, 1]",2,2,4,0
1205,"['emendar', 'emendar', 'legislativo']","[2, 2, 1]","['dorio', 'implantar']","[1, 1]",3,2,5,0
1209,"[]","[]","['atribuir', 'atribuir', 'circular', 'circular', 'imagem', 'imagem', 'manchet']","[2, 2, 2, 2, 2, 2, 1]",0,7,7,0
1210,"['distrito', 'espirito', 'roraima']","[1, 1, 1]","['vc']","[1]",3,1,4,0
1211,"['capitar', 'comparacao', 'concedido', 'confederacao', 'especifico', 'justificativo', 'liderar', 'regiao', 'regiao', 'situacao', 'tesourar', 'transferencia', 'volumar']","[1, 1, 1, 1, 1, 1, 1, 2, 2, 1, 1, 1, 1]","['verificar']","[1]",13,1,14,0
1218,"['compromisso', 'juro', 'recurso']","[1, 1, 1]","[]","[]",3,0,3,0
1220,"[]","[]","['circular', 'imagem']","[1, 1]",0,2,2,0
1222,"['saudar']","[1]","['misturar', 'verdadeiro']","[1, 1]",1,2,3,0
1223,"['antecipar', 'antecipar', 'antecipar']","[3, 3, 3]","['arvor', 'dorio', 'dorio']","[1, 2, 2]",3,3,6,0
1224,"['passageiro', 'passageiro', 'passageiro']","[3, 3, 3]","[]","[]",3,0,3,0
1225,"['economia', 'impulsionar', 'moderno', 'necessario', 'temporada']","[1, 1, 1, 1, 1]","['escravo', 'escravo', 'escravo', 'escravo', 'escravo', 'escravo', 'verdadeiro']","[6, 6, 6, 6, 6, 6, 1]",5,7,12,0
1226,"['domicilio', 'mudanca', 'privar']","[1, 1, 1]","['vc', 'vc', 'versao']","[2, 2, 1]",3,3,6,0
1229,"['anticorpo', 'anticorpo', 'anvisa', 'imunizacao', 'imunizacao', 'necessario', 'realizacao', 'vigilancia']","[2, 2, 1, 2, 2, 1, 1, 1]","['enganir', 'parir', 'quantum']","[1, 1, 1]",8,3,11,0
1231,"['equipamento']","[1]","['caixao', 'imagem', 'legendar', 'mencao', 'realment', 'usuario', 'viralizada']","[1, 1, 1, 1, 1, 1, 1]",1,7,8,0
1232,"['alergia', 'andrew', 'anvisa', 'desenvolvido', 'destacar', 'dosar', 'fase', 'saudar', 'saudar', 'vigilancia']","[1, 1, 1, 1, 1, 1, 1, 2, 2, 1]","['circular', 'imagem', 'legendar', 'reverso']","[1, 1, 1, 1]",10,4,14,0
1233,"['monetario', 'mudanca', 'periodo', 'periodo', 'possibilidad', 'prazo', 'prorrogar', 'prorrogar', 'prorrogar', 'prorrogar', 'servidor', 'transmissao']","[1, 1, 2, 2, 1, 1, 4, 4, 4, 4, 1, 1]","['greve', 'implantar', 'implantar']","[1, 2, 2]",12,3,15,0
1234,"['ambientar', 'recordar', 'rejeicao']","[1, 1, 1]","['circular', 'imagem', 'insinuar', 'legendar']","[1, 1, 1, 1]",3,4,7,0
1236,"['funcao', 'situacao']","[1, 1]","['atribuir', 'circular', 'compartilhar', 'reivindicar', 'replicar', 'sortir', 'usuario']","[1, 1, 1, 1, 1, 1, 1]",2,7,9,0
1238,"['comissao', 'condicao', 'destacar', 'elaborar', 'esforco', 'provincia', 'provincia', 'respiratorio', 'saudar']","[1, 1, 1, 1, 1, 2, 2, 1, 1]","[]","[]",9,0,9,0
1239,"[]","[]","['auditoria', 'fraudar', 'fraudar', 'sobrar']","[1, 2, 2, 1]",0,4,4,0
1240,"['periodo', 'regiao']","[1, 1]","['circular', 'disseminar', 'fotografia', 'fotografo', 'imagem', 'imagem', 'imagem']","[1, 1, 1, 1, 3, 3, 3]",2,7,9,0
1242,"['biliao', 'biliao']","[2, 2]","['lixar', 'vc']","[1, 1]",2,2,4,0
1244,"['adulto', 'adulto']","[2, 2]","['bandeiro', 'estuprar', 'ideologia', 'implantar', 'implantar']","[1, 1, 1, 2, 2]",2,5,7,0
1246,"['especialment', 'republico', 'saneamento', 'saneamento']","[1, 1, 2, 2]","['cartaz', 'cartaz', 'cartaz', 'cartaz', 'parir', 'parir', 'protestar', 'protestar', 'protestar', 'protestar', 'protestar', 'protestar']","[4, 4, 4, 4, 2, 2, 6, 6, 6, 6, 6, 6]",4,12,16,0
1247,"['flavio', 'flavio', 'flavio', 'lavagem', 'processo', 'pslrj']","[3, 3, 3, 1, 1, 1]","['circular']","[1]",6,1,7,0
1251,"['estatistico', 'previo']","[1, 1]","['enganoso', 'fraudar', 'parir', 'sequer', 'vezar']","[1, 1, 1, 1, 1]",2,5,7,0
1253,"['ambientar', 'contencao']","[1, 1]","['venezuelano']","[1]",2,1,3,0
1254,"[]","[]","['dorio', 'dorio']","[2, 2]",0,2,2,0
1255,"['aurelio', 'biliao', 'condicao', 'constituicao', 'decisao', 'enquadrar', 'excecao', 'inedito', 'julgamento', 'regulamentar', 'republico', 'ricardo', 'situacao']","[1, 1, 1, 1, 1, 1, 1, 1, 1, 1, 1, 1, 1]","['cbn', 'imagem', 'indignacao', 'indignar', 'inocentar', 'manipulacao', 'manobrar', 'mentiroso', 'versao']","[1, 1, 1, 1, 1, 1, 1, 1, 1]",13,9,22,0
1257,"[]","[]","['adelio', 'espalhar', 'intitular', 'minutar', 'segundar']","[1, 1, 1, 1, 1]",0,5,5,0
1258,"[]","[]","[]","[]",0,0,0,0
1259,"[]","[]","['torrar']","[1]",0,1,1,0
1261,"[]","[]","['parir', 'parir', 'segundar']","[2, 2, 1]",0,3,3,0
1262,"['quarentenar', 'sugestao']","[1, 1]","[]","[]",2,0,2,0
1263,"[]","[]","['indignar', 'parir', 'versao', 'versao', 'versao']","[1, 1, 3, 3, 3]",0,5,5,0
1270,"['condicao', 'estatistico', 'periodo', 'saudar', 'saudar']","[1, 1, 1, 2, 2]","['circular']","[1]",5,1,6,0
1271,"['assintomatico', 'assintomatico', 'economia', 'interpretar', 'transmissao']","[2, 2, 1, 1, 1]","['compartilhar', 'compartilhar', 'imagem', 'replicar', 'usuario']","[2, 2, 1, 1, 1]",5,5,10,0
1274,"['sabado']","[1]","['compartilhar', 'fraudar', 'ilustrar', 'imagem', 'imagem', 'parir', 'viralizada']","[1, 1, 1, 2, 2, 1, 1]",1,7,8,0
1276,"['crise', 'crise', 'dificuldad', 'parceria', 'parceria', 'servidor']","[2, 2, 1, 2, 2, 1]","['carrefour', 'carrefour', 'clicar', 'clicar', 'compartilhar', 'compartilhar']","[2, 2, 2, 2, 2, 2]",6,6,12,0
1277,"['justicar', 'ministrar', 'necessario']","[1, 1, 1]","[]","[]",3,0,3,0
1279,"['coordenar', 'habitant', 'habitant']","[1, 2, 2]","['implantar']","[1]",3,1,4,0
1282,"['cardiologista']","[1]","['atribuir', 'circular']","[1, 1]",1,2,3,0
1283,"['alunar', 'autoridad', 'dificuldad', 'folhar', 'justicar', 'pratico']","[1, 1, 1, 1, 1, 1]","['usuario']","[1]",6,1,7,0
1288,"['parceiro', 'situacao']","[1, 1]","['ganhar', 'humanar']","[1, 1]",2,2,4,0
1292,"['boletim', 'equipamento', 'isolar', 'periodo', 'transmissao']","[1, 1, 1, 1, 1]","['arquivar', 'arquivar']","[2, 2]",5,2,7,0
1293,"[]","[]","['enganoso']","[1]",0,1,1,0
1294,"['alvorar', 'palacio', 'reabrir', 'reabrir', 'reabrir']","[1, 1, 3, 3, 3]","[]","[]",5,0,5,0
1296,"['ambientar', 'infectar', 'periodo']","[1, 1, 1]","['estomago', 'garganta']","[1, 1]",3,2,5,0
1297,"['biliao', 'parceria']","[1, 1]","['compartilhar', 'copiar', 'dorio', 'dorio', 'dorio', 'dorio', 'dorio', 'ganhar', 'ganhar', 'ganhar']","[1, 1, 5, 5, 5, 5, 5, 3, 3, 3]",2,10,12,0
1302,"['recebido']","[1]","['incendio']","[1]",1,1,2,0
1305,"[]","[]","[]","[]",0,0,0,0
1308,"['biliao', 'inquerito', 'instituto', 'investigacao', 'planar']","[1, 1, 1, 1, 1]","['dorio', 'dorio', 'dorio', 'enganar', 'ganhar', 'ganhar', 'ganhar', 'ganhar', 'ganhar', 'safar']","[3, 3, 3, 1, 5, 5, 5, 5, 5, 1]",5,10,15,0
1312,"['ccj', 'ministrar', 'plenario']","[1, 1, 1]","['lixar']","[1]",3,1,4,0
1313,"['curvo']","[1]","['arquivar', 'circular']","[1, 1]",1,2,3,0
1319,"[]","[]","['circular', 'cocaina']","[1, 1]",0,2,2,0
1321,"[]","[]","['carrefour', 'imagem', 'sobrar']","[1, 1, 1]",0,3,3,0
1323,"['apurar', 'apurar', 'desenvolvimento', 'equipamento']","[2, 2, 1, 1]","['barragem', 'barragem', 'postagen', 'rompimento', 'transposicao']","[2, 2, 1, 1, 1]",4,5,9,0
1325,"['lorenz', 'taxar']","[1, 1]","['vitaminar', 'vitaminar', 'vitaminar', 'vitaminar', 'vitaminar']","[5, 5, 5, 5, 5]",2,5,7,0
1326,"['determinacao']","[1]","[]","[]",1,0,1,0
1327,"['diretoria']","[1]","['motorista']","[1]",1,1,2,0
1328,"[]","[]","['circular', 'limao', 'limao', 'vitaminar', 'vitaminar']","[1, 2, 2, 2, 2]",0,5,5,0
1329,"['condenacao', 'julgamento', 'palacio', 'planalto']","[1, 1, 1, 1]","['circular', 'circular', 'imagem']","[2, 2, 1]",4,3,7,0
1330,"['administrativo', 'antonio', 'portavoz', 'vieira']","[1, 1, 1, 1]","['atribuir', 'circular']","[1, 1]",4,2,6,0
1331,"[]","[]","['arvor', 'gretar', 'gretar']","[1, 2, 2]",0,3,3,0
1333,"['adicionar', 'quarentenar', 'surtir']","[1, 1, 1]","['atribuir', 'circular', 'compartilhar', 'compartilhar']","[1, 1, 2, 2]",3,4,7,0
1335,"['circulacao', 'funcionamento', 'metropolitano', 'regiao', 'suspenso']","[1, 1, 1, 1, 1]","['circular', 'compartilhar', 'greve', 'imagem', 'imagem', 'sacar', 'sacar']","[1, 1, 1, 2, 2, 2, 2]",5,7,12,0
1336,"[]","[]","[]","[]",0,0,0,0
1337,"['contemplar', 'periodo']","[1, 1]","['captar', 'parir', 'parir', 'pelar']","[1, 2, 2, 1]",2,4,6,0
1340,"['positivar', 'positivar', 'positivar', 'positivar', 'situacao']","[4, 4, 4, 4, 1]","['compartilhar', 'falsar', 'falsar', 'motorista', 'pego']","[1, 2, 2, 1, 1]",5,5,10,0
1344,"['espanha', 'moderno']","[1, 1]","[]","[]",2,0,2,0
1347,"['apurar', 'boletim', 'henriqu', 'observar', 'regulamentar', 'vespera']","[1, 1, 1, 1, 1, 1]","['pelar', 'pelar', 'pelar', 'pelar', 'sortear']","[4, 4, 4, 4, 1]",6,5,11,0
1350,"['acordo', 'ambientar', 'crise', 'crise', 'diminuicao', 'dosar', 'fronteiro', 'mutacao', 'observar', 'resistencia', 'respiratorio', 'saudar']","[1, 1, 2, 2, 1, 1, 1, 1, 1, 1, 1, 1]","['garganta', 'implantar']","[1, 1]",12,2,14,0
1352,"['administrativo', 'enfermagem', 'logistico', 'plano', 'saudar']","[1, 1, 1, 1, 1]","['amigar']","[1]",5,1,6,0
1353,"['positivar', 'respirador']","[1, 1]","['dorio', 'macho']","[1, 1]",2,2,4,0
1354,"['habitant', 'saudar', 'saudar', 'taxar', 'taxar', 'taxar', 'taxar', 'taxar']","[1, 2, 2, 5, 5, 5, 5, 5]","['circular']","[1]",8,1,9,0
1357,"['articulacao', 'esquema']","[1, 1]","['greve']","[1]",2,1,3,0
1358,"['flavio']","[1]","[]","[]",1,0,1,0
1359,"['equipamento']","[1]","[]","[]",1,0,1,0
1362,"['cilindro', 'martim', 'martim']","[1, 2, 2]","['capturar', 'compartilhar', 'replicar']","[1, 1, 1]",3,3,6,0
1365,"['situacao']","[1]","['espalhar', 'imagem', 'quinzena']","[1, 1, 1]",1,3,4,0
1367,"['possibilidad']","[1]","['circular', 'falsar', 'verdadeiro']","[1, 1, 1]",1,3,4,0
1368,"['aurelio', 'lewandowski', 'manutencao', 'mello', 'mello', 'punicao']","[1, 1, 1, 2, 2, 1]","['amigar', 'assassinar', 'estuprar']","[1, 1, 1]",6,3,9,0
1374,"['folhar', 'parceria', 'sabatino']","[1, 1, 1]","[]","[]",3,0,3,0
1375,"[]","[]","[]","[]",0,0,0,0
1377,"['desgastar', 'piorar', 'respirador', 'respirador', 'respirador']","[1, 1, 3, 3, 3]","['atribuir', 'circular', 'imagem', 'imagem', 'imagem']","[1, 1, 3, 3, 3]",5,5,10,0
1378,"[]","[]","['curioso', 'imagem', 'quinzena']","[1, 1, 1]",0,3,3,0
1383,"['curvo']","[1]","['arquivar']","[1]",1,1,2,0
1384,"['biliao', 'crise', 'crise', 'excecao', 'fluminens']","[1, 2, 2, 1, 1]","['carrefour', 'circular']","[1, 1]",5,2,7,0
1387,"['aplicacao', 'economia']","[1, 1]","['ganhar']","[1]",2,1,3,0
1388,"['gued']","[1]","['fingir', 'imagem']","[1, 1]",1,2,3,0
1389,"['agravar', 'autoridad', 'complicacao', 'intensivo', 'monitoramento', 'mudanca', 'necessario', 'respiratorio', 'saudar', 'submetido', 'ventilador']","[1, 1, 1, 1, 1, 1, 1, 1, 1, 1, 1]","['autopsia', 'cbn', 'sequer', 'viralizado']","[1, 1, 1, 1]",11,4,15,0
1390,"[]","[]","[]","[]",0,0,0,0
1392,"['autoridad', 'autoridad', 'carla', 'ministrar', 'pslsp', 'zambelli']","[2, 2, 1, 1, 1, 1]","['abusar', 'abusar', 'arquivar', 'basto', 'compartilhar']","[2, 2, 1, 1, 1]",6,5,11,0
1393,"['distrito']","[1]","['circular', 'imagem', 'imagem', 'imagem', 'legendar', 'reverso', 'viralizado']","[1, 3, 3, 3, 1, 1, 1]",1,7,8,0
1396,"['biliao', 'inedito', 'ricardo', 'situacao', 'situacao']","[1, 1, 1, 2, 2]","['cbn', 'escravo', 'manobrar']","[1, 1, 1]",5,3,8,0
1397,"[]","[]","['botao', 'clicar', 'compartilhar', 'compartilhar', 'compartilhar', 'compartilhar', 'ganhar', 'ganhar']","[1, 1, 4, 4, 4, 4, 2, 2]",0,8,8,0
1398,"['apreensao', 'apreensao', 'apreensao', 'campino', 'fundacao', 'instituto', 'instituto']","[3, 3, 3, 1, 1, 2, 2]","['boatar', 'boatar', 'circular', 'cocaina', 'compartilhar', 'imagem', 'imagem', 'trafico', 'verificar', 'visualizacao']","[2, 2, 1, 1, 1, 2, 2, 1, 1, 1]",7,10,17,0
1399,"['boletim', 'boletim', 'divergencia', 'divergencia', 'equipamento', 'obtido']","[2, 2, 2, 2, 1, 1]","['viralizado']","[1]",6,1,7,0
1400,"['autorizacao', 'lewandowski', 'ministrar']","[1, 1, 1]","['dubai', 'dubai', 'sobrar']","[2, 2, 1]",3,3,6,0
1404,"['estimular']","[1]","['circular']","[1]",1,1,2,0
1407,"['absoluto', 'observar', 'observar', 'observar']","[1, 3, 3, 3]","[]","[]",4,0,4,0
1412,"['henriqu', 'planar', 'planar']","[1, 2, 2]","['implantar']","[1]",3,1,4,0
1413,"['autoridad', 'colaborar', 'deteccao', 'especializar', 'provincia', 'treinamento']","[1, 1, 1, 1, 1, 1]","['circular', 'circular', 'motorista']","[2, 2, 1]",6,3,9,0
1415,"['concedido', 'concedido', 'congresso', 'congresso', 'crise', 'crise', 'economia', 'republico', 'sessao']","[2, 2, 2, 2, 2, 2, 1, 1, 1]","['lupa', 'verificar']","[1, 1]",9,2,11,0
1416,"['equipamento', 'especializar', 'especifico']","[1, 1, 1]","['circular', 'imagem']","[1, 1]",3,2,5,0
1417,"['afp', 'comissao', 'periodo']","[1, 1, 1]","['compartilhar', 'imagem', 'inscricao']","[1, 1, 1]",3,3,6,0
1419,"['apurar', 'apurar', 'apurar', 'celso']","[3, 3, 3, 1]","['capturar', 'fraudar', 'versao']","[1, 1, 1]",4,3,7,0
1421,"[]","[]","['basto']","[1]",0,1,1,0
1425,"['regiao']","[1]","['clicar', 'motorista']","[1, 1]",1,2,3,0
1427,"['possibilidad']","[1]","[]","[]",1,0,1,0
1429,"['alckmin', 'exjuiz', 'exministro', 'geraldo', 'justicar', 'planar', 'republico']","[1, 1, 1, 1, 1, 1, 1]","['circular', 'compartilhar', 'imagem', 'imagem', 'usuario', 'verificar']","[1, 1, 2, 2, 1, 1]",7,6,13,0
1436,"['folhar', 'parceria', 'proposto', 'renata', 'sabatino', 'souza']","[1, 1, 1, 1, 1, 1]","['checar', 'lupa']","[1, 1]",6,2,8,0
1438,"['atuacao', 'autoridad', 'biliao', 'entendimento', 'necessidad']","[1, 1, 1, 1, 1]","['narrativo', 'parir', 'parir', 'parir', 'pelar', 'pelar', 'pelar', 'pelar', 'sobrar', 'sobrar']","[1, 3, 3, 3, 4, 4, 4, 4, 2, 2]",5,10,15,0
1439,"['ricardo', 'ricardo']","[2, 2]","['revoltar', 'revoltar', 'revoltar', 'vazar', 'vazar']","[3, 3, 3, 2, 2]",2,5,7,0
1440,"['estrategico', 'expansao', 'saudar']","[1, 1, 1]","['cuspir', 'pelar', 'sobrar', 'vezar']","[1, 1, 1, 1]",3,4,7,0
1441,"['henriqu', 'internar', 'suspeito', 'suspeito']","[1, 1, 2, 2]","['caixao', 'ganhar', 'ganhar', 'sacar', 'sacar', 'vc', 'vc']","[1, 2, 2, 2, 2, 2, 2]",4,7,11,0
1444,"['araujo', 'araujo']","[2, 2]","['circular', 'motorista']","[1, 1]",2,2,4,0
1445,"['avancar', 'comissao', 'fluminens', 'plenario', 'sessao']","[1, 1, 1, 1, 1]","['circular', 'legendar', 'verificar']","[1, 1, 1]",5,3,8,0
1448,"['respostar']","[1]","['fraudar', 'insinuar', 'pelar']","[1, 1, 1]",1,3,4,0
1450,"[]","[]","['barragem', 'misericordia', 'misericordia']","[1, 2, 2]",0,3,3,0
1451,"['planar']","[1]","['secreto', 'vazar', 'vazar', 'vazar', 'vazar']","[1, 4, 4, 4, 4]",1,5,6,0
1453,"['diagnosticar', 'minimizar']","[1, 1]","[]","[]",2,0,2,0
1454,"['conformar', 'infraestrutura', 'metropolitano', 'ministrar', 'paralisar', 'quilometro', 'tcu']","[1, 1, 1, 1, 1, 1, 1]","['pelar']","[1]",7,1,8,0
1458,"['diagnosticar', 'notificar', 'saudar', 'saudar', 'surtir']","[1, 1, 2, 2, 1]","['circular', 'legendar']","[1, 1]",5,2,7,0
1459,"['bancada', 'decisao']","[1, 1]","['parabem', 'versao']","[1, 1]",2,2,4,0
1460,"['acumular', 'agravar', 'complicacao', 'desenvolvimento', 'epidemiar', 'particularment', 'prescricao']","[1, 1, 1, 1, 1, 1, 1]","['pelar', 'supostament', 'usuario']","[1, 1, 1]",7,3,10,0
1462,"[]","[]","['arvor']","[1]",0,1,1,0
1463,"[]","[]","['agredir', 'assaltar', 'camiseta', 'pelar', 'pelar']","[1, 1, 1, 2, 2]",0,5,5,0
1464,"['dedicar']","[1]","['cristao', 'cristao', 'cristao', 'grupar', 'minutar', 'parir', 'parir', 'vezar']","[3, 3, 3, 1, 1, 2, 2, 1]",1,8,9,0
1466,"['associacao', 'periodo']","[1, 1]","['torturar']","[1]",2,1,3,0
1467,"[]","[]","['desmaiar', 'desmaiar', 'sortir']","[2, 2, 1]",0,3,3,0
1468,"['dificuldad', 'fase', 'fase', 'fase', 'impactar', 'infectar', 'infectar', 'infectar', 'lavagem', 'minimizar', 'minimizar', 'necessario', 'prazo', 'recurso', 'transferir', 'transferir']","[1, 3, 3, 3, 1, 3, 3, 3, 1, 2, 2, 1, 1, 1, 2, 2]","['garganta', 'garganta', 'garganta', 'garganta', 'garganta', 'lembres', 'lembres', 'misturar', 'nasal', 'nasal', 'nasal', 'versao']","[5, 5, 5, 5, 5, 2, 2, 1, 3, 3, 3, 1]",16,12,28,0
1471,"['necessario']","[1]","['boatar', 'circular', 'circular', 'falsar']","[1, 2, 2, 1]",1,4,5,0
1472,"['cupula']","[1]","['realment']","[1]",1,1,2,0
1473,"['respiratorio', 'saudar', 'sigla', 'surtir']","[1, 1, 1, 1]","[]","[]",4,0,4,0
1474,"['logistico', 'wellington']","[1, 1]","['caixao', 'circular', 'imagem', 'verificar']","[1, 1, 1, 1]",2,4,6,0
1478,"['administrativo', 'autoridad', 'exjuiz', 'improbidad', 'julgamento', 'justicar', 'ministrar']","[1, 1, 1, 1, 1, 1, 1]","['abusar', 'circular', 'enganar', 'falsar', 'imagem', 'imagem', 'vazar', 'verdadeiro', 'verdadeiro', 'versao']","[1, 1, 1, 1, 2, 2, 1, 2, 2, 1]",7,10,17,0
1481,"['exministro', 'lavagem', 'ministrar', 'monitoram', 'monitoramento', 'pastar', 'transferencia']","[1, 1, 1, 1, 1, 1, 1]","[]","[]",7,0,7,0
1482,"['regrar', 'situacao']","[1, 1]","['arvor', 'espalhar']","[1, 1]",2,2,4,0
1485,"[]","[]","['compartilhar', 'legendar', 'versao']","[1, 1, 1]",0,3,3,0
1486,"['conjuntar']","[1]","['camiseta', 'camiseta', 'circular', 'circular', 'imagem', 'imagem', 'mencao', 'menino']","[2, 2, 2, 2, 2, 2, 1, 1]",1,8,9,0
1487,"['antonio', 'antonio', 'equivalent', 'nomeacao']","[2, 2, 1, 1]","['cartaz', 'circular', 'disseminar', 'falsar']","[1, 1, 1, 1]",4,4,8,0
1490,"['tambem']","[1]","['amigar', 'ganhar', 'incendio', 'incendio']","[1, 1, 2, 2]",1,4,5,0
1497,"['caxia', 'caxia', 'decorrencia', 'planar', 'situacao', 'submetido']","[2, 2, 1, 1, 1, 1]","['cbn', 'circular']","[1, 1]",6,2,8,0
1498,"['lewandowski', 'positivar']","[1, 1]","[]","[]",2,0,2,0
1499,"['conformar', 'observar']","[1, 1]","['pego', 'pelar', 'pelar', 'pelar']","[1, 3, 3, 3]",2,4,6,0
1500,"['arrecadar']","[1]","['espalhar', 'parir', 'parir', 'parir']","[1, 3, 3, 3]",1,4,5,0
1502,"['agravamento', 'saudar', 'saudar']","[1, 2, 2]","['amplament', 'circular', 'compartilhar', 'imagem']","[1, 1, 1, 1]",3,4,7,0
1505,"['aprovacao', 'aprovacao', 'aprovacao', 'recordar']","[3, 3, 3, 1]","[]","[]",4,0,4,0
1506,"['ribeiro']","[1]","['imagem']","[1]",1,1,2,0
1507,"['converso', 'respirador']","[1, 1]","[]","[]",2,0,2,0
1508,"['globonew', 'sabado', 'sabado']","[1, 2, 2]","['camisa', 'circular', 'imagem', 'soltar']","[1, 1, 1, 1]",3,4,7,0
1510,"['antonio', 'exprefeito', 'minimizar', 'viagem']","[1, 1, 1, 1]","['circular', 'espalhar', 'estranhar']","[1, 1, 1]",4,3,7,0
1511,"['surtir']","[1]","['captar', 'captar', 'rouanet']","[2, 2, 1]",1,3,4,0
1515,"['anticorpo', 'negativar']","[1, 1]","['humanar']","[1]",2,1,3,0
1517,"['europeu', 'europeu', 'europeu', 'saudar', 'saudar', 'saudar', 'saudar', 'saudar']","[3, 3, 3, 5, 5, 5, 5, 5]","['compartilhar', 'compartilhar', 'macho', 'protestar']","[2, 2, 1, 1]",8,4,12,0
1519,"['crescimento', 'intensivo', 'plantao', 'reducao', 'saudar']","[1, 1, 1, 1, 1]","['circular', 'imagem', 'imagem', 'legendar', 'manipulacao', 'vazio']","[1, 2, 2, 1, 1, 1]",5,6,11,0
1523,"['companhia', 'companhia', 'companhia', 'definitivo', 'espanha', 'feriar', 'presenca', 'supremo']","[3, 3, 3, 1, 1, 1, 1, 1]","['checar', 'parir', 'parir', 'parir', 'parir', 'pelar', 'vazar']","[1, 4, 4, 4, 4, 1, 1]",8,7,15,0
1525,"['adotada', 'orientacao', 'orientacao', 'saudar', 'saudar']","[1, 2, 2, 2, 2]","['circular', 'circular', 'legendar', 'postagen', 'telejorn']","[2, 2, 1, 1, 1]",5,5,10,0
1527,"['instalacao', 'instalacao']","[2, 2]","['circular', 'fotografia', 'idioma', 'legendar', 'logotipo', 'postagen', 'versao']","[1, 1, 1, 1, 1, 1, 1]",2,7,9,0
1531,"[]","[]","['disseminar', 'enfim', 'segundar', 'vezar']","[1, 1, 1, 1]",0,4,4,0
1532,"['positivar', 'sputnik']","[1, 1]","['desmentir', 'desmentir', 'enganir', 'parir', 'parir', 'torrar', 'versao', 'versao', 'versao', 'vitaminar', 'vitaminar', 'zincar']","[2, 2, 1, 2, 2, 1, 3, 3, 3, 2, 2, 1]",2,12,14,0
1534,"[]","[]","['espalhar']","[1]",0,1,1,0
1538,"['agravar', 'cilindro', 'crise', 'dificuldad', 'escassez', 'logistico', 'saudar']","[1, 1, 1, 1, 1, 1, 1]","['replicar', 'versao']","[1, 1]",7,2,9,0
1542,"['cirurgico', 'fronteiro', 'impulsionar', 'lavagem', 'liderar', 'mudanca', 'planar', 'planar', 'plano', 'plano', 'plano', 'plano', 'plano', 'reducao']","[1, 1, 1, 1, 1, 1, 2, 2, 5, 5, 5, 5, 5, 1]","['bandeiro', 'crer', 'ideologia', 'menino', 'menino', 'menino', 'minutar', 'renunciar', 'sequer', 'terrorismo', 'terrorismo', 'terrorismo', 'terrorismo']","[1, 1, 1, 3, 3, 3, 1, 1, 1, 4, 4, 4, 4]",14,13,27,0
1546,"['colombio', 'conformar', 'desenvolvido', 'fluxo', 'fluxo', 'quarentenar', 'quarentenar', 'quarentenar', 'sabado', 'voo', 'voo', 'voo']","[1, 1, 1, 2, 2, 3, 3, 3, 1, 3, 3, 3]","['realment', 'realment', 'realment', 'realment']","[4, 4, 4, 4]",12,4,16,0
1548,"['especifico']","[1]","['transposicao']","[1]",1,1,2,0
1550,"['consequencia']","[1]","['atribuir', 'circular', 'compartilhar', 'desgracar', 'imagem', 'parir', 'postagen', 'postagen', 'viralizada']","[1, 1, 1, 1, 1, 1, 2, 2, 1]",1,9,10,0
1553,"['exprefeito', 'infraestrutura', 'ministrar']","[1, 1, 1]","['atribuir', 'atribuir', 'imagem', 'imagem', 'verdadeiro']","[2, 2, 2, 2, 1]",3,5,8,0
1554,"['biliao', 'coletivo', 'entregu', 'liderar', 'republico', 'republico', 'superar']","[1, 1, 1, 1, 2, 2, 1]","['boicotar', 'deitar', 'disseminar', 'falsar', 'ganhar', 'ganhar', 'lixar', 'revoltar', 'venezuelano', 'verdadeiro']","[1, 1, 1, 1, 2, 2, 1, 1, 1, 1]",7,10,17,0
1555,"['adotada', 'jornada', 'propagacao']","[1, 1, 1]","['compartilhar', 'gravacao', 'legendar', 'postagen']","[1, 1, 1, 1]",3,4,7,0
1557,"[]","[]","['abencoar', 'limao']","[1, 1]",0,2,2,0
1558,"['calheiro', 'calheiro', 'emendar', 'emendar', 'esquema', 'importacao', 'importacao', 'importacao', 'randolf', 'randolf', 'randolf']","[2, 2, 2, 2, 1, 3, 3, 3, 3, 3, 3]","['compartilhar', 'interaco', 'legendar', 'postagen']","[1, 1, 1, 1]",11,4,15,0
1559,"['prazo']","[1]","['clicar', 'clicar', 'compartilhar', 'enderecar', 'ganhar', 'parir', 'sapato', 'sapato', 'sapato']","[2, 2, 1, 1, 1, 1, 3, 3, 3]",1,9,10,0
1561,"[]","[]","['fraudar']","[1]",0,1,1,0
1562,"['cirurgico', 'desenvolvido', 'destacar', 'dificuldad', 'equipamento', 'importancia', 'internar', 'intervalar', 'realizacao', 'relativo', 'saudar', 'tedro', 'tedro']","[1, 1, 1, 1, 1, 1, 1, 1, 1, 1, 1, 2, 2]","['circular', 'espalhar', 'legendar']","[1, 1, 1]",13,3,16,0
1563,"['consenso', 'crescimento', 'crescimento', 'economia', 'economia', 'economia', 'expectativa', 'pib', 'revisar', 'situacao']","[1, 2, 2, 3, 3, 3, 1, 1, 1, 1]","['grupar', 'parir', 'parir', 'parir', 'parir']","[1, 4, 4, 4, 4]",10,5,15,0
1566,"['biliao', 'colaboracao', 'desenvolvido', 'fundacao', 'implementacao', 'mutacao', 'parceria', 'rastreamento', 'tesourar']","[1, 1, 1, 1, 1, 1, 1, 1, 1]","['instrucao', 'instrucao', 'quantum']","[2, 2, 1]",9,3,12,0
1567,"['infectar']","[1]","['enganoso', 'parir', 'parir', 'pelar', 'realment']","[1, 2, 2, 1, 1]",1,5,6,0
1569,"[]","[]","['amigar', 'incendio', 'versao']","[1, 1, 1]",0,3,3,0
1570,"[]","[]","['atirar', 'atirar', 'parir', 'parir', 'parir', 'socialismo', 'socialismo']","[2, 2, 3, 3, 3, 2, 2]",0,7,7,0
1571,"['oficialment']","[1]","[]","[]",1,0,1,0
1572,"['instituto']","[1]","['circular']","[1]",1,1,2,0
1573,"['normalment', 'reducao', 'suspeito', 'velocidad']","[1, 1, 1, 1]","['checagem', 'circular', 'falsar', 'fraudar', 'gravacao', 'manipulacao', 'parir', 'pelar', 'pelar', 'verificar', 'versao']","[1, 1, 1, 1, 1, 1, 1, 2, 2, 1, 1]",4,11,15,0
1574,"['ministrar', 'ministrar', 'saudar', 'saudar']","[2, 2, 2, 2]","[]","[]",4,0,4,0
1577,"['inglaterra', 'revisar', 'taxar']","[1, 1, 1]","['compartilhar']","[1]",3,1,4,0
1578,"['apreensao']","[1]","['circular', 'gravacao']","[1, 1]",1,2,3,0
1579,"[]","[]","['sobrar']","[1]",0,1,1,0
1581,"['toquio']","[1]","[]","[]",1,0,1,0
1582,"['boletim', 'destinar', 'destinar', 'epidemiologico', 'habitant', 'internacao', 'internar']","[1, 2, 2, 1, 1, 1, 1]","['circular', 'compartilhar', 'implantar', 'pelar', 'segundar']","[1, 1, 1, 1, 1]",7,5,12,0
1583,"['emendar', 'suspeito']","[1, 1]","['assassinar']","[1]",2,1,3,0
1585,"[]","[]","['circular', 'compartilhar', 'filmar', 'pelar', 'quinzena', 'rouanet', 'wagner']","[1, 1, 1, 1, 1, 1, 1]",0,7,7,0
1586,"['fundamentar']","[1]","['amplament', 'circular', 'compartilhar', 'verificacao']","[1, 1, 1, 1]",1,4,5,0
1589,"['desenvolvido', 'desenvolvido', 'sigla']","[2, 2, 1]","['abortar', 'abortar', 'enganir', 'humanar', 'insinuar']","[2, 2, 1, 1, 1]",3,5,8,0
1590,"['comissao', 'minoria', 'previsto', 'proposto', 'proposto', 'reconhecimento', 'revogar']","[1, 1, 1, 2, 2, 1, 1]","['atribuir', 'casamentar', 'postagen']","[1, 1, 1]",7,3,10,0
1591,"['ambientar', 'dificuldad', 'diretoria', 'enfatizar', 'infectar', 'periodo']","[1, 1, 1, 1, 1, 1]","['compartilhar', 'estomago', 'estomago', 'garganta', 'garganta', 'garganta', 'garganta', 'misturar', 'nasal', 'nasal', 'nasal', 'verificacao']","[1, 2, 2, 4, 4, 4, 4, 1, 3, 3, 3, 1]",6,12,18,0
1592,"['inedito', 'velocidad']","[1, 1]","['filmar']","[1]",2,1,3,0
1594,"['saudar', 'saudar']","[2, 2]","['enganir', 'parir', 'segundar', 'sobrar']","[1, 1, 1, 1]",2,4,6,0
1595,"['biliao', 'biliao', 'biliao', 'destinar', 'recurso', 'rotina', 'saudar', 'saudar', 'suspensao', 'transferencia']","[3, 3, 3, 1, 1, 1, 2, 2, 1, 1]","['enganoso', 'parir', 'parir', 'parir', 'parir']","[1, 4, 4, 4, 4]",10,5,15,0
1596,"[]","[]","['compartilhar', 'grupar', 'humanar', 'lixar', 'menino', 'menino', 'parir', 'parir', 'parir', 'pelar', 'soldar']","[1, 1, 1, 1, 2, 2, 3, 3, 3, 1, 1]",0,11,11,0
1597,"['etapa', 'gabinet', 'ministrar', 'palacio']","[1, 1, 1, 1]","['dorio', 'parabem']","[1, 1]",4,2,6,0
1600,"['aliquota', 'aliquota', 'comissao', 'conformar', 'legislativo', 'subir', 'tramitacao', 'transmissao']","[2, 2, 1, 1, 1, 1, 1, 1]","['circular']","[1]",8,1,9,0
1601,"[]","[]","['clicar', 'compartilhar', 'compartilhar', 'ganhar', 'ganhar', 'ganhar', 'instrucao', 'sortear']","[1, 2, 2, 3, 3, 3, 1, 1]",0,8,8,0
1602,"['discussao', 'parceiro', 'turma', 'turma', 'turma', 'turma']","[1, 1, 4, 4, 4, 4]","['enderecar', 'ganhar', 'ganhar', 'ganhar', 'preencher', 'sortear', 'sortear', 'verificar']","[1, 3, 3, 3, 1, 2, 2, 1]",6,8,14,0
1603,"['periodo']","[1]","['amigar', 'imagem', 'imagem', 'legendar']","[1, 2, 2, 1]",1,4,5,0
1604,"[]","[]","['parir']","[1]",0,1,1,0
1605,"[]","[]","['facada', 'quinzena']","[1, 1]",0,2,2,0
1606,"[]","[]","[]","[]",0,0,0,0
1607,"['arrecadacao', 'destinar']","[1, 1]","['circular', 'supostament']","[1, 1]",2,2,4,0
1609,"['argumentar', 'concorrent', 'regiao', 'tatto', 'variacao']","[1, 1, 1, 1, 1]","['espalhar', 'fraudar']","[1, 1]",5,2,7,0
1610,"['adhanom', 'amplo', 'reabertura', 'saudar', 'tedro']","[1, 1, 1, 1, 1]","['compartilhar', 'manchet', 'manchet']","[1, 2, 2]",5,3,8,0
1611,"[]","[]","[]","[]",0,0,0,0
1612,"['desenvolvido', 'etapa', 'fase', 'instituto', 'parceria', 'respostar', 'saudar']","[1, 1, 1, 1, 1, 1, 1]","['cbn', 'circular', 'espalhar', 'misturar']","[1, 1, 1, 1]",7,4,11,0
1617,"[]","[]","['versao']","[1]",0,1,1,0
1618,"['crise', 'equipamento', 'exigencia', 'individuar', 'pagamento', 'pagamento', 'parcelar', 'parcelar', 'parcelar', 'previsto', 'recurso', 'recurso', 'regulamentar', 'sancao']","[1, 1, 1, 1, 2, 2, 3, 3, 3, 1, 2, 2, 1, 1]","['compartilhar', 'realment', 'verificar']","[1, 1, 1]",14,3,17,0
1620,"['colunista', 'oficialment']","[1, 1]","['circular', 'compartilhar', 'espalhar', 'imagem', 'legendar', 'mansao', 'mansao', 'reverso', 'socialismo', 'vc']","[1, 1, 1, 1, 1, 2, 2, 1, 1, 1]",2,10,12,0
1622,"['crise', 'sabado']","[1, 1]","['amigar', 'amigar']","[2, 2]",2,2,4,0
1624,"[]","[]","['menino']","[1]",0,1,1,0
1625,"[]","[]","['circular', 'fotografo', 'imagem', 'imagem', 'legendar']","[1, 1, 2, 2, 1]",0,5,5,0
1626,"['autoridad', 'habitant', 'habitant', 'habitant', 'habitant', 'habitant', 'habitant']","[1, 6, 6, 6, 6, 6, 6]","['enganir', 'manchet']","[1, 1]",7,2,9,0
1629,"[]","[]","['imagem']","[1]",0,1,1,0
1630,"['positivar', 'possibilidad']","[1, 1]","['fingir', 'fingir']","[2, 2]",2,2,4,0
1631,"['afastamento', 'afastamento', 'afastamento', 'afastamento', 'aurelio', 'aurelio', 'aurelio', 'aurelio', 'decisao', 'mello', 'ministrar', 'ministrar', 'republico']","[4, 4, 4, 4, 4, 4, 4, 4, 1, 1, 2, 2, 1]","[]","[]",13,0,13,0
1636,"['afetado', 'afetado']","[2, 2]","['acidentar', 'espalhar', 'espalhar', 'espalhar', 'falsar', 'nobel', 'nobel']","[1, 3, 3, 3, 1, 2, 2]",2,7,9,0
1641,"[]","[]","['atribuir', 'boatar', 'circular', 'desmentir', 'idioma', 'verificar']","[1, 1, 1, 1, 1, 1]",0,6,6,0
1643,"[]","[]","[]","[]",0,0,0,0
1646,"['alternativo', 'psicologo']","[1, 1]","['circular', 'circular']","[2, 2]",2,2,4,0
1647,"[]","[]","[]","[]",0,0,0,0
1649,"['epidemiar', 'epidemiar', 'epidemiar', 'periodo', 'reducao', 'respiratorio', 'suspeito']","[3, 3, 3, 1, 1, 1, 1]","['compartilhar', 'desmentir']","[1, 1]",7,2,9,0
1651,"['concessionario', 'congresso', 'economia', 'privar', 'republico']","[1, 1, 1, 1, 1]","['basto', 'copiar', 'desligar', 'enfim', 'ganhar', 'minutar', 'privacidad', 'soltar', 'soltar']","[1, 1, 1, 1, 1, 1, 1, 2, 2]",5,9,14,0
1652,"['acumular', 'saudar']","[1, 1]","['circular', 'filmar', 'legendar', 'vazar', 'versao', 'visualizacao']","[1, 1, 1, 1, 1, 1]",2,6,8,0
1653,"['recurso']","[1]","['invadir', 'vazar']","[1, 1]",1,2,3,0
1654,"['anvisa']","[1]","[]","[]",1,0,1,0
1655,"['academico', 'apurar', 'comparacao']","[1, 1, 1]","['circular', 'enganir', 'gravacao', 'mencao', 'verdadeiro']","[1, 1, 1, 1, 1]",3,5,8,0
1656,"['autoridad', 'saudar']","[1, 1]","[]","[]",2,0,2,0
1658,"['iniciativo', 'saudar']","[1, 1]","['basto', 'basto', 'carrefour', 'carrefour', 'carrefour', 'clicar']","[2, 2, 3, 3, 3, 1]",2,6,8,0
1659,"['diariament', 'domingo']","[1, 1]","['protestar']","[1]",2,1,3,0
1660,"[]","[]","['sobrar']","[1]",0,1,1,0
1663,"[]","[]","[]","[]",0,0,0,0
1664,"['necessario', 'regiao', 'respostar']","[1, 1, 1]","['compartilhar', 'incendio', 'incendio', 'preencher', 'realment']","[1, 2, 2, 1, 1]",3,5,8,0
1665,"['situacao']","[1]","[]","[]",1,0,1,0
1673,"['instituto', 'investigacao']","[1, 1]","['boatar', 'circular', 'inocentar', 'menino']","[1, 1, 1, 1]",2,4,6,0
1675,"[]","[]","['circular', 'imagem', 'imagem', 'legendar', 'missil']","[1, 2, 2, 1, 1]",0,5,5,0
1676,"['acordo', 'aprovacao', 'conjuntar', 'conjuntar', 'constituicao', 'exercicio', 'investigacao', 'investigacao', 'monetario', 'monetario', 'pagamento', 'pagamento', 'pagamento', 'pagamento', 'pagamento', 'recebido', 'remessar', 'suspeito', 'tesourar', 'transferir']","[1, 1, 2, 2, 1, 1, 2, 2, 2, 2, 5, 5, 5, 5, 5, 1, 1, 1, 1, 1]","['verificacao']","[1]",20,1,21,0
1677,"[]","[]","[]","[]",0,0,0,0
1680,"['adotada']","[1]","['arquivar', 'copiar', 'dorio', 'parir', 'telegram']","[1, 1, 1, 1, 1]",1,5,6,0
1682,"['humanitario', 'regrar', 'situacao']","[1, 1, 1]","['arvor']","[1]",3,1,4,0
1684,"['anvisa']","[1]","['filmar', 'filmar', 'safar']","[2, 2, 1]",1,3,4,0
1685,"['domingo', 'reuniao', 'superar']","[1, 1, 1]","[]","[]",3,0,3,0
1689,"['espanha', 'fabricio', 'flavio', 'machadar', 'pslrj', 'queiroz', 'republico']","[1, 1, 1, 1, 1, 1, 1]","['checar', 'circular', 'cocaina']","[1, 1, 1]",7,3,10,0
1690,"['justicar', 'preservar', 'regiao']","[1, 1, 1]","[]","[]",3,0,3,0
1692,"[]","[]","['camiseta', 'compartilhar', 'espalhar', 'imagem', 'pelar', 'protestar', 'soltar']","[1, 1, 1, 1, 1, 1, 1]",0,7,7,0
1694,"['flexibilizar']","[1]","['espalhar', 'gleisi', 'pelar', 'quinzena']","[1, 1, 1, 1]",1,4,5,0
1695,"['positivar']","[1]","['circular']","[1]",1,1,2,0
1697,"['comissao', 'diretoria']","[1, 1]","[]","[]",2,0,2,0
1700,"['conformar']","[1]","['legendar', 'pelar', 'visualizacao']","[1, 1, 1]",1,3,4,0
1705,"['crise', 'impulsionar']","[1, 1]","['circular']","[1]",2,1,3,0
1706,"['transmissao', 'transmissao']","[2, 2]","['circular']","[1]",2,1,3,0
1707,"['liderar', 'vespera']","[1, 1]","['circular']","[1]",2,1,3,0
1710,"['epidemiar']","[1]","['compartilhar', 'disseminar', 'espalhar', 'filmar', 'parir', 'quinzena', 'segundar']","[1, 1, 1, 1, 1, 1, 1]",1,7,8,0
1711,"['compilar', 'demandar', 'intensivo', 'saudar', 'saudar']","[1, 1, 1, 2, 2]","['circular', 'circular', 'imagem']","[2, 2, 1]",5,3,8,0
1712,"['pagamento']","[1]","['ganhar']","[1]",1,1,2,0
1716,"['suspeito']","[1]","[]","[]",1,0,1,0
1717,"['palacio', 'palacio', 'palacio', 'palacio', 'palacio', 'positivar', 'positivar', 'positivar', 'positivar', 'positivar', 'positivar', 'possibilidad', 'primeiroministro', 'primeiroministro', 'reuniao', 'saudar']","[5, 5, 5, 5, 5, 6, 6, 6, 6, 6, 6, 1, 2, 2, 1, 1]","[]","[]",16,0,16,0
1719,"[]","[]","[]","[]",0,0,0,0
1720,"['adversario', 'almeida', 'associacao', 'celso']","[1, 1, 1, 1]","['circular', 'incendio']","[1, 1]",4,2,6,0
1721,"['arrecadar']","[1]","['assinalar', 'circular', 'compartilhar']","[1, 1, 1]",1,3,4,0
1724,"['necessario', 'preservar', 'quarentenar']","[1, 1, 1]","['adorar', 'dorio', 'versao', 'versao']","[1, 1, 2, 2]",3,4,7,0
1725,"['condicao', 'piorar']","[1, 1]","['ganhar', 'menino']","[1, 1]",2,2,4,0
1727,"[]","[]","['circular']","[1]",0,1,1,0
1728,"['reafirmar', 'saudar']","[1, 1]","['circular', 'circular']","[2, 2]",2,2,4,0
1731,"['reuniao']","[1]","[]","[]",1,0,1,0
1732,"['conformar', 'investigacao', 'quilometro', 'regiao', 'saudar']","[1, 1, 1, 1, 1]","['acidentar', 'circular', 'filmar', 'imagem', 'imagem', 'imagem', 'versao']","[1, 1, 1, 3, 3, 3, 1]",5,7,12,0
1733,"['internar']","[1]","['fraudar', 'parir', 'sobrar', 'verificar']","[1, 1, 1, 1]",1,4,5,0
1736,"['contabilizar', 'epidemiar', 'indicador', 'internacao', 'internacao', 'liderar', 'painel', 'quedo', 'recordar', 'respectivament', 'superar']","[1, 1, 1, 2, 2, 1, 1, 1, 1, 1, 1]","['verdadeiro']","[1]",11,1,12,0
1738,"['previsao']","[1]","['ganhar', 'quinzena']","[1, 1]",1,2,3,0
1739,"['aglomeracao', 'aglomeracao', 'plantao', 'turma']","[2, 2, 1, 1]","['invadir', 'lembres', 'parabem', 'rouanet', 'versao', 'versao', 'versao', 'versao', 'versao']","[1, 1, 1, 1, 5, 5, 5, 5, 5]",4,9,13,0
1740,"['demandar', 'resultado', 'vulnerabilidad']","[1, 1, 1]","['fraudar', 'invadir', 'invadir', 'manipular', 'parir', 'verificar']","[1, 2, 2, 1, 1, 1]",3,6,9,0
1742,"['aliviar', 'respiratorio', 'saudar', 'saudar', 'saudar', 'sigla', 'surtir']","[1, 1, 3, 3, 3, 1, 1]","['circular', 'circular', 'gravacao']","[2, 2, 1]",7,3,10,0
1744,"[]","[]","['espalhar', 'imagem']","[1, 1]",0,2,2,0
1745,"['jn']","[1]","[]","[]",1,0,1,0
1747,"['monitoramento']","[1]","['checar', 'circular']","[1, 1]",1,2,3,0
1748,"['jn', 'recordar']","[1, 1]","['bonner', 'desmentir', 'parir', 'parir']","[1, 1, 2, 2]",2,4,6,0
1749,"['economia', 'reforcar']","[1, 1]","['carrefour', 'carrefour', 'carrefour', 'carrefour', 'circular', 'legendar', 'manobrar']","[4, 4, 4, 4, 1, 1, 1]",2,7,9,0
1752,"['decorrencia']","[1]","['compartilhar', 'inscricao', 'preencher', 'preencher']","[1, 1, 2, 2]",1,4,5,0
1754,"['barroso', 'comissao', 'ministrar', 'proposto']","[1, 1, 1, 1]","['capturar', 'circular', 'fraudar', 'interaco', 'puro', 'usuario']","[1, 1, 1, 1, 1, 1]",4,6,10,0
1758,"['congresso', 'domingo', 'souza', 'supremo']","[1, 1, 1, 1]","['atribuir', 'circular', 'gravacao']","[1, 1, 1]",4,3,7,0
1760,"[]","[]","[]","[]",0,0,0,0
1761,"['governista', 'levantamento', 'levantamento']","[1, 2, 2]","['compartilhar', 'postagen']","[1, 1]",3,2,5,0
1763,"['conjuntar']","[1]","[]","[]",1,0,1,0
1764,"[]","[]","['espalhar', 'quinzena']","[1, 1]",0,2,2,0
1765,"['autoridad', 'demandar', 'isolar', 'isolar', 'isolar', 'periodo', 'preocupacao', 'suportar', 'velocidad']","[1, 1, 3, 3, 3, 1, 1, 1, 1]","['realment', 'realment', 'realment', 'verdadeiro']","[3, 3, 3, 1]",9,4,13,0
1766,"[]","[]","[]","[]",0,0,0,0
1770,"['saudar', 'saudar']","[2, 2]","['enganir']","[1]",2,1,3,0
1771,"[]","[]","['acidentar']","[1]",0,1,1,0
1772,"['ambito', 'infectar', 'internar', 'ministrar', 'saudar']","[1, 1, 1, 1, 1]","['cbn', 'circular']","[1, 1]",5,2,7,0
1776,"['complicacao', 'destinar', 'internacao', 'isolar', 'privar', 'submetido']","[1, 1, 1, 1, 1, 1]","[]","[]",6,0,6,0
1777,"['ministrar']","[1]","['compartilhar', 'espalhar']","[1, 1]",1,2,3,0
1780,"[]","[]","['falsar']","[1]",0,1,1,0
1783,"['bolsonarista', 'mexico']","[1, 1]","['acidentar', 'circular', 'imagem']","[1, 1, 1]",2,3,5,0
1786,"['saudar']","[1]","[]","[]",1,0,1,0
1787,"[]","[]","['espalhar', 'parir']","[1, 1]",0,2,2,0
1790,"[]","[]","['ganhar']","[1]",0,1,1,0
1791,"['manutencao']","[1]","['invadir', 'quantum']","[1, 1]",1,2,3,0
1792,"[]","[]","['realment']","[1]",0,1,1,0
1796,"['randolf', 'randolf', 'randolf', 'randolf']","[4, 4, 4, 4]","[]","[]",4,0,4,0
1797,"['compilar', 'conjunto']","[1, 1]","['circular']","[1]",2,1,3,0
1798,"['biliao', 'justicar', 'ministrar']","[1, 1, 1]","[]","[]",3,0,3,0
1802,"['aglomeracao', 'escalar', 'fase', 'fase', 'previsao', 'previsao', 'previsao', 'previsao', 'previsao', 'saudar', 'saudar', 'servidor', 'servidor', 'servidor', 'servidor', 'situacao']","[1, 1, 2, 2, 5, 5, 5, 5, 5, 2, 2, 4, 4, 4, 4, 1]","[]","[]",16,0,16,0
1803,"['adotada', 'cirurgico', 'crise', 'cupula', 'domingo', 'emergenciai', 'especializar', 'estrategico', 'fronteiro', 'fronteiro', 'fronteiro', 'gabinet', 'instalacao', 'monitoramento', 'precaucao', 'regiao', 'reuniao', 'reuniao', 'reuniao', 'roraima', 'roraima', 'sabado', 'situacao', 'situacao', 'sudest', 'sudest', 'suprimento']","[1, 1, 1, 1, 1, 1, 1, 1, 3, 3, 3, 1, 1, 1, 1, 1, 3, 3, 3, 2, 2, 1, 2, 2, 2, 2, 1]","['missil', 'venezuelano']","[1, 1]",27,2,29,0
1804,"[]","[]","['verdadeiro']","[1]",0,1,1,0
1807,"[]","[]","['circular', 'mentiroso']","[1, 1]",0,2,2,0
1808,"['autoridad', 'autoridad', 'autoridad', 'decorrencia', 'especialment', 'infectar', 'reforcar', 'saudar', 'saudar', 'saudar', 'saudar', 'surtir']","[3, 3, 3, 1, 1, 1, 1, 4, 4, 4, 4, 1]","['circular', 'vitaminar']","[1, 1]",12,2,14,0
1809,"['justicar']","[1]","['versao', 'versao', 'versao']","[3, 3, 3]",1,3,4,0
1810,"['andrew', 'andrew', 'avancar', 'hospitalizar', 'isolar', 'levantamento', 'levantamento', 'levantamento', 'saudar', 'totalizar']","[2, 2, 1, 1, 1, 3, 3, 3, 1, 1]","['circular', 'circular']","[2, 2]",10,2,12,0
1811,"['globonew']","[1]","['gravacao', 'logotipo', 'verificar']","[1, 1, 1]",1,3,4,0
1812,"[]","[]","['acidentar', 'crer', 'desfilar', 'parir']","[1, 1, 1, 1]",0,4,4,0
1813,"['magistrado']","[1]","['circular', 'circular', 'ganhar']","[2, 2, 1]",1,3,4,0
1814,"['domingo', 'domingo']","[2, 2]","['bandeiro', 'bandeiro', 'bandeiro', 'circular', 'greve', 'imagem', 'imagem', 'protestar', 'protestar', 'protestar', 'protestar']","[3, 3, 3, 1, 1, 2, 2, 4, 4, 4, 4]",2,11,13,0
1816,"['autoridad', 'equipamento', 'exercicio', 'pratico', 'saudar']","[1, 1, 1, 1, 1]","[]","[]",5,0,5,0
1817,"['inedito', 'integro']","[1, 1]","['compartilhar', 'faccao']","[1, 1]",2,2,4,0
1819,"['esforco', 'etapa']","[1, 1]","['circular', 'compartilhar']","[1, 1]",2,2,4,0
1821,"[]","[]","[]","[]",0,0,0,0
1822,"['saudar', 'situacao']","[1, 1]","['compartilhar', 'estranhar', 'postagen', 'usuario']","[1, 1, 1, 1]",2,4,6,0
1824,"['crise', 'economia', 'intenso', 'paralisar', 'projecao', 'republico']","[1, 1, 1, 1, 1, 1]","['ganhar']","[1]",6,1,7,0
1825,"['positivar', 'saudar']","[1, 1]","['dorio', 'dorio']","[2, 2]",2,2,4,0
1829,"[]","[]","[]","[]",0,0,0,0
1830,"['instituto']","[1]","['motorista', 'motorista', 'sortir']","[2, 2, 1]",1,3,4,0
1831,"[]","[]","['parir', 'parir', 'parir', 'torrar', 'torrar', 'torrar', 'torrar']","[3, 3, 3, 4, 4, 4, 4]",0,7,7,0
1834,"['ausencia', 'realizacao']","[1, 1]","['arquivar', 'circular', 'fraudar', 'fraudar', 'fraudar', 'visualizacao']","[1, 1, 3, 3, 3, 1]",2,6,8,0
1835,"[]","[]","['catolico', 'vc']","[1, 1]",0,2,2,0
1839,"['republico']","[1]","[]","[]",1,0,1,0
1840,"[]","[]","['espalhar', 'quinzena']","[1, 1]",0,2,2,0
1842,"[]","[]","['acidentar', 'bispar', 'cristao', 'imagem', 'imagem']","[1, 1, 1, 2, 2]",0,5,5,0
1846,"['converso', 'converso', 'converso', 'dialogo', 'gabinet', 'justicar', 'ministrar', 'ministrar', 'supremo']","[3, 3, 3, 1, 1, 1, 2, 2, 1]","['atribuir', 'circular', 'legendar']","[1, 1, 1]",9,3,12,0
1851,"['cupula', 'primeiroministro']","[1, 1]","['canadens', 'canadens', 'canadens', 'canadens', 'canadens', 'canadens']","[6, 6, 6, 6, 6, 6]",2,6,8,0
1852,"['arthur', 'disseminacao', 'ministrar', 'republico']","[1, 1, 1, 1]","['postagen']","[1]",4,1,5,0
1860,"['disseminacao', 'periodo']","[1, 1]","['checar', 'disseminar', 'falsar', 'verificacao']","[1, 1, 1, 1]",2,4,6,0
1862,"['assistencia', 'ausencia', 'decorrencia', 'decorrent', 'periodo', 'primario', 'reflexo']","[1, 1, 1, 1, 1, 1, 1]","['desligar', 'desligar', 'imagem', 'postagen', 'soltar']","[2, 2, 1, 1, 1]",7,5,12,0
1864,"['bbc', 'interino']","[1, 1]","['atribuir', 'capturar', 'imagem', 'supostament']","[1, 1, 1, 1]",2,4,6,0
1865,"['saudar']","[1]","['vc']","[1]",1,1,2,0
1867,"['investigacao', 'observar', 'saudad', 'saudad']","[1, 1, 2, 2]","['assassinar', 'crech', 'crech', 'crech', 'imagem', 'imagem']","[1, 3, 3, 3, 2, 2]",4,6,10,0
1868,"['globonew', 'renata']","[1, 1]","['capturar', 'circular', 'compartilhar', 'compartilhar', 'gravacao', 'legendar', 'verificar']","[1, 1, 2, 2, 1, 1, 1]",2,7,9,0
1869,"[]","[]","['filmar', 'sacar']","[1, 1]",0,2,2,0
1873,"[]","[]","['basto', 'basto', 'parabem', 'sortear', 'sortear', 'sortear', 'sortear']","[2, 2, 1, 4, 4, 4, 4]",0,7,7,0
1875,"['depoimento', 'ministrar', 'ministrar', 'ministrar', 'sessao']","[1, 3, 3, 3, 1]","['torturar', 'torturar', 'torturar']","[3, 3, 3]",5,3,8,0
1876,"[]","[]","['atribuir', 'atribuir', 'cartaz', 'circular', 'circular', 'espalhar', 'gleisi', 'gleisi', 'imagem', 'verdadeiro']","[2, 2, 1, 2, 2, 1, 2, 2, 1, 1]",0,10,10,0
1877,"['aprovacao', 'calculo', 'congresso', 'crescimento', 'gued', 'henriqu', 'pib', 'proposto', 'saudar']","[1, 1, 1, 1, 1, 1, 1, 1, 1]","['acidentar', 'ganhar']","[1, 1]",9,2,11,0
1880,"[]","[]","['compartilhar', 'grupar', 'segundar']","[1, 1, 1]",0,3,3,0
1885,"['bolsonarista', 'domingo', 'inquerito', 'justicar', 'oswaldo', 'supremo', 'tramitar']","[1, 1, 1, 1, 1, 1, 1]","['fraudar']","[1]",7,1,8,0
1889,"['redondo']","[1]","['imagem']","[1]",1,1,2,0
1890,"['autoridad', 'economia', 'liderar', 'liderar', 'merkel', 'merkel', 'merkel', 'respostar']","[1, 1, 2, 2, 3, 3, 3, 1]","['sacar']","[1]",8,1,9,0
1891,"['ministrar', 'presidir', 'randolf', 'supremo']","[1, 1, 1, 1]","['circular', 'mafia']","[1, 1]",4,2,6,0
1892,"[]","[]","['espalhar', 'imagem', 'manchet', 'supostament']","[1, 1, 1, 1]",0,4,4,0
1894,"['treinamento']","[1]","[]","[]",1,0,1,0
1900,"['afp', 'afp', 'biliao', 'saudar']","[2, 2, 1, 1]","['checar', 'circular', 'compartilhar', 'compartilhar', 'realment', 'verificacao', 'versao']","[1, 1, 2, 2, 1, 1, 1]",4,7,11,0
1901,"['californio', 'exgovernador']","[1, 1]","['camiseta', 'clicar', 'imagem', 'inscricao']","[1, 1, 1, 1]",2,4,6,0
1905,"[]","[]","['compartilhar', 'gretar', 'imagem', 'quinzena']","[1, 1, 1, 1]",0,4,4,0
1909,"['flavio', 'flavio', 'internar', 'positivar', 'psicologo', 'pslsp', 'pslsp']","[2, 2, 1, 1, 1, 2, 2]","['circular', 'compartilhar', 'imagem', 'intitular', 'legendar']","[1, 1, 1, 1, 1]",7,5,12,0
1912,"['antonio', 'diariament', 'economia', 'relaxar', 'ricardo', 'ricardo', 'vigilancia']","[1, 1, 1, 1, 2, 2, 1]","['captar', 'manipulacao']","[1, 1]",7,2,9,0
1913,"[]","[]","['pelar', 'quinzena', 'segundar']","[1, 1, 1]",0,3,3,0
1915,"['apreensao', 'condicao']","[1, 1]","['imagem', 'postagen', 'verificar']","[1, 1, 1]",2,3,5,0
1918,"[]","[]","['cadastramento', 'cadastramento', 'cadastramento', 'cadastramento']","[4, 4, 4, 4]",0,4,4,0
1919,"[]","[]","[]","[]",0,0,0,0
1920,"['impacto', 'saudar', 'saudar', 'saudar', 'saudar', 'saudar', 'saudar']","[1, 6, 6, 6, 6, 6, 6]","['disfarcar']","[1]",7,1,8,0
1921,"[]","[]","['indignar', 'parir']","[1, 1]",0,2,2,0
1923,"['economia', 'justicar', 'ministrar']","[1, 1, 1]","['curioso']","[1]",3,1,4,0
1926,"['ministrar', 'ministrar', 'ministrar', 'ricardo']","[3, 3, 3, 1]","[]","[]",4,0,4,0
1927,"['situacao']","[1]","['circular', 'circular', 'imagem', 'inscricao', 'parabem', 'socialismo', 'soldar']","[2, 2, 1, 1, 1, 1, 1]",1,7,8,0
1928,"['folhar', 'parceria', 'sabatino', 'spaulo', 'wilson', 'witzel']","[1, 1, 1, 1, 1, 1]","[]","[]",6,0,6,0
1930,"[]","[]","['circular', 'ganhar', 'nobel']","[1, 1, 1]",0,3,3,0
1932,"['equipamento', 'justicar']","[1, 1]","[]","[]",2,0,2,0
1934,"[]","[]","['compartilhar', 'gravacao', 'postagen', 'verdadeiro']","[1, 1, 1, 1]",0,4,4,0
1935,"['domingo', 'quarentenar']","[1, 1]","[]","[]",2,0,2,0
1936,"['infectar', 'liderar']","[1, 1]","[]","[]",2,0,2,0
1939,"[]","[]","['circular', 'ganhar', 'imagem', 'manipular', 'verdadeiro']","[1, 1, 1, 1, 1]",0,5,5,0
1941,"['destacar']","[1]","[]","[]",1,0,1,0
1942,"['perspectivo']","[1]","['capturar', 'circular', 'compartilhar', 'imagem', 'imagem', 'imagem', 'reverso', 'versao']","[1, 1, 1, 3, 3, 3, 1, 1]",1,8,9,0
1946,"['desenvolvimento', 'disseminacao']","[1, 1]","['checar', 'compartilhar', 'verificacao']","[1, 1, 1]",2,3,5,0
1947,"[]","[]","[]","[]",0,0,0,0
1948,"['acumular', 'adiamento', 'competicao', 'decisao', 'toquio', 'toquio']","[1, 1, 1, 1, 2, 2]","['circular', 'imagem', 'legendar', 'reverso', 'visualizacao']","[1, 1, 1, 1, 1]",6,5,11,0
1949,"['client', 'determinacao', 'determinacao', 'determinacao', 'funcionamento', 'necessario', 'saudar']","[1, 3, 3, 3, 1, 1, 1]","['circular']","[1]",7,1,8,0
1951,"[]","[]","[]","[]",0,0,0,0
1954,"['orientacao', 'parceiro', 'parceiro', 'pratico']","[1, 2, 2, 1]","[]","[]",4,0,4,0
1957,"['campino', 'campino', 'campino']","[3, 3, 3]","['catedr', 'catedr', 'padrar', 'padrar', 'padrar', 'vc']","[2, 2, 3, 3, 3, 1]",3,6,9,0
1958,"['aprovacao', 'conformar']","[1, 1]","[]","[]",2,0,2,0
1959,"['proprio']","[1]","['abencoar', 'abencoar']","[2, 2]",1,2,3,0
1964,"['ausencia', 'infectar', 'infectar', 'revisar']","[1, 2, 2, 1]","[]","[]",4,0,4,0
1966,"['fronteiro']","[1]","['circular', 'legendar', 'legendar', 'tumulo', 'tumulo', 'vazio']","[1, 2, 2, 2, 2, 1]",1,6,7,0
1975,"['conformar', 'justicar', 'lewandowski', 'ministrar', 'ricardo', 'supremo']","[1, 1, 1, 1, 1, 1]","['verdadeiro']","[1]",6,1,7,0
1976,"[]","[]","['espalhar', 'quinzena']","[1, 1]",0,2,2,0
1978,"[]","[]","['pelar']","[1]",0,1,1,0
1980,"['argumentar', 'condicao', 'decisao', 'prever', 'rejeicao']","[1, 1, 1, 1, 1]","['circular']","[1]",5,1,6,0
1983,"['instituto']","[1]","['intitular']","[1]",1,1,2,0
1984,"['domingo', 'posturar']","[1, 1]","['bandeiro', 'bandeiro', 'bandeiro', 'sobrar', 'vc']","[3, 3, 3, 1, 1]",2,5,7,0
1985,"[]","[]","['botao', 'clicar', 'compartilhar', 'compartilhar', 'compartilhar', 'compartilhar', 'ganhar', 'instrucao', 'questionario']","[1, 1, 4, 4, 4, 4, 1, 1, 1]",0,9,9,0
1986,"['bandeirant', 'cooperacao']","[1, 1]","[]","[]",2,0,2,0
1988,"[]","[]","['versao', 'versao']","[2, 2]",0,2,2,0
1989,"['arthur', 'celso', 'regiao']","[1, 1, 1]","['basto', 'circular', 'falsar', 'fraudar', 'legendar', 'manipular']","[1, 1, 1, 1, 1, 1]",3,6,9,0
1990,"[]","[]","[]","[]",0,0,0,0
1992,"['lorenzon', 'onyx', 'reducao']","[1, 1, 1]","['greve']","[1]",3,1,4,0
1995,"['minimizar', 'republico', 'saudar']","[1, 1, 1]","['compartilhar']","[1]",3,1,4,0
1996,"['acumular', 'aspecto', 'biliao', 'crise', 'desenvolvimento', 'funcao', 'funcao', 'paralisar', 'proposto', 'rastreamento', 'saudar', 'saudar']","[1, 1, 1, 1, 1, 2, 2, 1, 1, 1, 2, 2]","['basto', 'circular', 'enfim', 'implantar', 'implantar', 'pelar', 'privacidad']","[1, 1, 1, 2, 2, 1, 1]",12,7,19,0
1997,"[]","[]","['compartilhar', 'sortir']","[1, 1]",0,2,2,0
1999,"[]","[]","[]","[]",0,0,0,0
2002,"['favorito', 'respostar']","[1, 1]","['camiseta', 'clicar', 'compartilhar', 'compartilhar', 'instrucao', 'sapato', 'verificar']","[1, 1, 2, 2, 1, 1, 1]",2,7,9,0
2005,"[]","[]","['enfim', 'sacar', 'segundar']","[1, 1, 1]",0,3,3,0
2010,"['humanitario']","[1]","['compartilhar', 'gravacao', 'legendar', 'venezuelano']","[1, 1, 1, 1]",1,4,5,0
2011,"[]","[]","['espalhar', 'imagem', 'quinzena']","[1, 1, 1]",0,3,3,0
2013,"[]","[]","['barragem', 'espalhar', 'imagem', 'rompimento']","[1, 1, 1, 1]",0,4,4,0
2016,"['converso']","[1]","['abortar', 'bandeiro', 'bandeiro', 'bandeiro', 'enganar', 'melancia', 'verdadeiro']","[1, 3, 3, 3, 1, 1, 1]",1,7,8,0
2017,"['gued', 'ministrar']","[1, 1]","['espalhar', 'parir']","[1, 1]",2,2,4,0
2018,"['instituto', 'proporcao']","[1, 1]","['parir']","[1]",2,1,3,0
2022,"['saudar']","[1]","[]","[]",1,0,1,0
2024,"['ambientar', 'destacar', 'epicentro', 'infectar', 'minimizar', 'ministrar', 'ministrar', 'ricardo', 'sall', 'sall', 'saudar']","[1, 1, 1, 1, 1, 2, 2, 1, 2, 2, 1]","['enganir', 'postagen', 'viralizado']","[1, 1, 1]",11,3,14,0
2025,"['anvisa', 'aprovacao', 'efetividad', 'fase', 'vigilancia']","[1, 1, 1, 1, 1]","['checar', 'parir', 'pelar', 'sobrar', 'sobrar']","[1, 1, 1, 2, 2]",5,5,10,0
2026,"['associacao', 'associacao', 'prescricao']","[2, 2, 1]","['circular', 'sequer']","[1, 1]",3,2,5,0
2027,"['batalhar', 'mudanca', 'nelson', 'saudar', 'vespera']","[1, 1, 1, 1, 1]","['intitular']","[1]",5,1,6,0
2028,"['domingo']","[1]","['amplament', 'circular', 'compartilhar', 'compartilhar', 'supostament']","[1, 1, 2, 2, 1]",1,5,6,0
2029,"['dificultar', 'escassez', 'examinar', 'fluxo', 'intensivo', 'investigacao', 'necessario', 'periodo', 'respiratorio', 'saudar', 'saudar', 'saudar', 'ventilador']","[1, 1, 1, 1, 1, 1, 1, 1, 1, 3, 3, 3, 1]","['autopsia', 'autopsia', 'parir', 'parir', 'sobrar']","[2, 2, 2, 2, 1]",13,5,18,0
2032,"['capitar', 'cupula', 'exministro']","[1, 1, 1]","['compartilhar', 'fraudar', 'fraudar', 'ganhar', 'versao']","[1, 2, 2, 1, 1]",3,5,8,0
2034,"['gued']","[1]","['enganoso', 'gravacao', 'interaco']","[1, 1, 1]",1,3,4,0
2036,"['bbc', 'concedido', 'infancia']","[1, 1, 1]","['abusar', 'verdadeiro']","[1, 1]",3,2,5,0
2037,"['argumentar', 'justicar', 'justicar', 'sentenca', 'sentenca']","[1, 2, 2, 2, 2]","['desgracar', 'estuprar', 'estuprar', 'estuprar', 'estuprar', 'estuprar', 'inocentar']","[1, 5, 5, 5, 5, 5, 1]",5,7,12,0
2038,"[]","[]","['amigar', 'compartilhar', 'compartilhar', 'ganhar', 'vc', 'vc']","[1, 2, 2, 1, 2, 2]",0,6,6,0
2040,"['provincia', 'pulmonar', 'rejeitar']","[1, 1, 1]","['amplament', 'circular', 'compartilhar', 'imagem', 'replicar', 'usuario']","[1, 1, 1, 1, 1, 1]",3,6,9,0
2043,"[]","[]","['espalhar', 'espalhar', 'falsar', 'parir', 'sobrar', 'verdadeiro']","[2, 2, 1, 1, 1, 1]",0,6,6,0
2044,"[]","[]","['amigar', 'lembres', 'lembres']","[1, 2, 2]",0,3,3,0
2045,"[]","[]","['inscricao', 'inscricao', 'preencher']","[2, 2, 1]",0,3,3,0
2046,"['aprovacao', 'republico']","[1, 1]","[]","[]",2,0,2,0
2047,"['imunizacao', 'sigla']","[1, 1]","['espalhar', 'misturar']","[1, 1]",2,2,4,0
2048,"['risco']","[1]","['espalhar', 'imagem']","[1, 1]",1,2,3,0
2055,"['dosar', 'positivar']","[1, 1]","['enganoso', 'fotografia', 'parir']","[1, 1, 1]",2,3,5,0
2056,"['anuncio', 'arrecadacao', 'arrecadacao', 'arrecadar', 'biliao', 'colunista', 'comparacao', 'expectativa', 'pagamento', 'possibilidad', 'recurso', 'sabado', 'servidor', 'servidor', 'totalizar']","[1, 2, 2, 1, 1, 1, 1, 1, 1, 1, 1, 1, 2, 2, 1]","[]","[]",15,0,15,0
2057,"['especialment']","[1]","['desmaiar', 'equador', 'verificar']","[1, 1, 1]",1,3,4,0
2058,"['liderar', 'temporariament']","[1, 1]","['escravo', 'estampar', 'parir', 'parir', 'parir']","[1, 1, 3, 3, 3]",2,5,7,0
2059,"['bolsonarista', 'congresso', 'congresso']","[1, 2, 2]","['invadir', 'invadir', 'macho']","[2, 2, 1]",3,3,6,0
2063,"['californio', 'exgovernador', 'renzo']","[1, 1, 1]","['camiseta', 'checagem', 'circular', 'ilustrar', 'inscricao', 'pelar', 'pelar', 'verificar']","[1, 1, 1, 1, 1, 2, 2, 1]",3,8,11,0
2067,"['balancar', 'balancar', 'integro', 'palacio', 'palacio', 'planalto', 'reuniao', 'reuniao', 'reuniao']","[2, 2, 1, 2, 2, 1, 3, 3, 3]","['bandeiro', 'bandeiro', 'circular', 'imagem', 'versao', 'versao']","[2, 2, 1, 1, 2, 2]",9,6,15,0
2068,"['estagio', 'redondo', 'redondo', 'redondo', 'saudar']","[1, 3, 3, 3, 1]","[]","[]",5,0,5,0
2069,"['colunista', 'globonew', 'gued', 'gued', 'gued', 'gued', 'ministrar', 'ministrar']","[1, 1, 4, 4, 4, 4, 2, 2]","['circular', 'compartilhar', 'ganhar', 'replicar', 'versao', 'visualizacao']","[1, 1, 1, 1, 1, 1]",8,6,14,0
2072,"['ambientar', 'posturar']","[1, 1]","['compartilhar', 'mafia', 'terrorismo']","[1, 1, 1]",2,3,5,0
2073,"[]","[]","[]","[]",0,0,0,0
2074,"['supremo']","[1]","['cedula', 'circular', 'fraudar', 'idioma', 'imagem', 'legendar', 'postagen', 'visualizar']","[1, 1, 1, 1, 1, 1, 1, 1]",1,8,9,0
2075,"['destacar']","[1]","['circular', 'circular', 'desmentir', 'viralizado']","[2, 2, 1, 1]",1,4,5,0
2076,"['interlocutor']","[1]","['filmar']","[1]",1,1,2,0
2077,"['exministro']","[1]","[]","[]",1,0,1,0
2079,"['pratico']","[1]","['atirar', 'compartilhar', 'compartilhar', 'filmar', 'gravacao', 'gravacao', 'gretar', 'gretar']","[1, 2, 2, 1, 2, 2, 2, 2]",1,8,9,0
2081,"['deslocamento', 'reflexo']","[1, 1]","['carbono', 'dioxido', 'motorista', 'usuario']","[1, 1, 1, 1]",2,4,6,0
2082,"['reducao']","[1]","['capturar', 'compartilhar', 'intitular', 'postagen']","[1, 1, 1, 1]",1,4,5,0
2083,"[]","[]","['compartilhar', 'compartilhar', 'pelar', 'vezar']","[2, 2, 1, 1]",0,4,4,0
2084,"[]","[]","['sacar', 'sacar', 'vc']","[2, 2, 1]",0,3,3,0
2085,"[]","[]","['espalhar', 'imagem', 'quinzena']","[1, 1, 1]",0,3,3,0
2089,"['crise', 'economia', 'gued', 'ministrar', 'palacio', 'planalto', 'republico']","[1, 1, 1, 1, 1, 1, 1]","[]","[]",7,0,7,0
2090,"['decorrencia']","[1]","['amplament', 'assinalar', 'camisa', 'camiseta', 'compartilhar', 'fotografia', 'humanar', 'idioma', 'legendar', 'legendar', 'postagen', 'versao']","[1, 1, 1, 1, 1, 1, 1, 1, 2, 2, 1, 1]",1,12,13,0
2091,"[]","[]","['circular', 'fotografo', 'imagem', 'imagem', 'reverso', 'sequer']","[1, 1, 2, 2, 1, 1]",0,6,6,0
2093,"['aprovacao', 'instituto', 'moderno', 'oficialment', 'parceria']","[1, 1, 1, 1, 1]","['amigar', 'amigar', 'sequer']","[2, 2, 1]",5,3,8,0
2094,"['biliao', 'biliao', 'biliao', 'crise', 'escalar', 'impactar', 'surtir']","[3, 3, 3, 1, 1, 1, 1]","['indignacao', 'verdadeiro']","[1, 1]",7,2,9,0
2095,"['ambientar', 'desenvolvimento', 'estimativo', 'federar']","[1, 1, 1, 1]","['circular', 'fotografo', 'pelar', 'protestar']","[1, 1, 1, 1]",4,4,8,0
2101,"['adotada', 'propagacao', 'restritivo']","[1, 1, 1]","['circular', 'compartilhar', 'imagem', 'imagem', 'legendar', 'viralizada']","[1, 1, 2, 2, 1, 1]",3,6,9,0
2102,"['adversario']","[1]","['circular', 'imagem', 'usuario', 'verificar', 'verificar']","[1, 1, 1, 2, 2]",1,5,6,0
2103,"['autoridad', 'defendido', 'processo', 'respirador', 'saudar', 'varar']","[1, 1, 1, 1, 1, 1]","['atribuir', 'circular', 'desmentir', 'fotografia']","[1, 1, 1, 1]",6,4,10,0
2105,"['fronteiro']","[1]","['amplament', 'compartilhar', 'compartilhar', 'gasolina', 'gasolina', 'gasolina', 'gravacao', 'usuario']","[1, 2, 2, 3, 3, 3, 1, 1]",1,8,9,0
2106,"['aplicacao', 'dosar', 'observar']","[1, 1, 1]","['circular', 'circular', 'fotografo', 'imagem', 'imagem', 'legendar', 'viralizado']","[2, 2, 1, 2, 2, 1, 1]",3,7,10,0
2108,"[]","[]","['curioso', 'imenso']","[1, 1]",0,2,2,0
2109,"['lira', 'lira']","[2, 2]","['fraudar', 'fraudar', 'fraudar']","[3, 3, 3]",2,3,5,0
2113,"['inicialment']","[1]","['usuario']","[1]",1,1,2,0
2115,"[]","[]","['arvor', 'arvor', 'circular']","[2, 2, 1]",0,3,3,0
2116,"['folhar', 'folhar']","[2, 2]","['manchet', 'menino']","[1, 1]",2,2,4,0
2119,"['agravar', 'alcolumbr', 'congresso', 'consenso', 'coordenar', 'planar', 'republico', 'republico', 'situacao', 'supremo']","[1, 1, 1, 1, 1, 1, 2, 2, 1, 1]","['escutar']","[1]",10,1,11,0
2122,"['acompanhamento', 'aspecto', 'avancar', 'biliao', 'destacar', 'etapa', 'exportacao', 'imunizacao', 'lancamento', 'parceria', 'proposto', 'reabrir', 'rejeitar', 'rigoroso', 'saudar', 'servidor', 'transmissao']","[1, 1, 1, 1, 1, 1, 1, 1, 1, 1, 1, 1, 1, 1, 1, 1, 1]","['bandeiro', 'compartilhar', 'espalhar', 'humanar', 'lembres', 'patrocinador', 'privacidad', 'verificar']","[1, 1, 1, 1, 1, 1, 1, 1]",17,8,25,0
2126,"['autoridad', 'diminuicao', 'orientacao', 'quadro', 'respiratorio', 'respiratorio', 'respiratorio', 'saudar']","[1, 1, 1, 1, 3, 3, 3, 1]","['boatar', 'circular', 'garganta']","[1, 1, 1]",8,3,11,0
2127,"['autoridad', 'contribuicao', 'contribuicao', 'crise', 'enfrentamento', 'jn', 'positivar', 'risco', 'saudar', 'suspeito']","[1, 2, 2, 1, 1, 1, 1, 1, 1, 1]","['ideologia', 'ideologia', 'imagem', 'misturar', 'verdadeiro']","[2, 2, 1, 1, 1]",10,5,15,0
2128,"[]","[]","['arquivar', 'arquivar', 'arquivar', 'boicotar', 'grupar', 'sobrar']","[3, 3, 3, 1, 1, 1]",0,6,6,0
2129,"['belgica', 'consenso', 'decisao', 'posicionamento', 'quadro', 'saudar']","[1, 1, 1, 1, 1, 1]","['circular']","[1]",6,1,7,0
2130,"['instituto']","[1]","['legendar']","[1]",1,1,2,0
2131,"['augusto', 'emprestimo', 'esquema', 'heleno', 'ministrar', 'reuniao']","[1, 1, 1, 1, 1, 1]","['vc', 'vc']","[2, 2]",6,2,8,0
2134,"['consequencia', 'crise', 'estagio', 'previsto', 'regiao', 'situacao']","[1, 1, 1, 1, 1, 1]","['compartilhar', 'compartilhar', 'imagem', 'imagem']","[2, 2, 2, 2]",6,4,10,0
2135,"['acumular', 'converso']","[1, 1]","['desligar', 'gravacao', 'manipulacao', 'manipular', 'manipular', 'pelar', 'pelar', 'pelar', 'visualizacao']","[1, 1, 1, 2, 2, 3, 3, 3, 1]",2,9,11,0
2139,"['desenvolvido', 'fundacao', 'fundacao']","[1, 2, 2]","['cbn', 'espalhar', 'pelar', 'pelar', 'realment', 'verdadeiro']","[1, 1, 2, 2, 1, 1]",3,6,9,0
2141,"['espirito', 'espirito', 'justicar', 'justicar']","[2, 2, 2, 2]","[]","[]",4,0,4,0
2142,"['anuncio', 'ministrar', 'sorocaba']","[1, 1, 1]","['circular', 'imagem', 'imagem', 'imagem', 'imagem', 'inscricao', 'reverso']","[1, 4, 4, 4, 4, 1, 1]",3,7,10,0
2144,"['argumentar', 'atuacao', 'conduta', 'edson', 'fachin', 'fachin', 'fachin', 'fachin', 'ministrar', 'supremo', 'supremo']","[1, 1, 1, 1, 4, 4, 4, 4, 1, 2, 2]","['checar', 'circular', 'imagem', 'postagen']","[1, 1, 1, 1]",11,4,15,0
2145,"['celebrar', 'destinar', 'destinar', 'favorito', 'viagem', 'viagem', 'voo']","[1, 2, 2, 1, 2, 2, 1]","['clicar', 'compartilhar', 'compartilhar', 'instrucao']","[1, 2, 2, 1]",7,4,11,0
2146,"['volumar']","[1]","['compartilhar', 'gravacao', 'ilustrar', 'imagem', 'legendar', 'maldiz', 'motorista', 'postagen', 'usuario', 'visualizacao']","[1, 1, 1, 1, 1, 1, 1, 1, 1, 1]",1,10,11,0
2149,"[]","[]","['postagen']","[1]",0,1,1,0
2150,"[]","[]","['biblia', 'biblia', 'circular', 'compartilhar', 'sobrar', 'versao']","[2, 2, 1, 1, 1, 1]",0,6,6,0
2152,"['ambientar', 'ambientar', 'cilindro', 'demandar', 'martim', 'martim', 'martim', 'privar']","[2, 2, 1, 1, 3, 3, 3, 1]","['amigar', 'imagem']","[1, 1]",8,2,10,0
2156,"[]","[]","['compartilhar', 'fraudar', 'gravacao', 'postagen', 'visualizar']","[1, 1, 1, 1, 1]",0,5,5,0
2160,"['passageiro']","[1]","['espalhar', 'parir']","[1, 1]",1,2,3,0
2161,"['aplicacao', 'dosar', 'dosar', 'dosar', 'esquema', 'infectar', 'periodo', 'positivar', 'respostar']","[1, 3, 3, 3, 1, 1, 1, 1, 1]","['assinalar', 'enganoso', 'parir', 'parir', 'parir', 'parir', 'pelar', 'pelar']","[1, 1, 4, 4, 4, 4, 2, 2]",9,8,17,0
2162,"['anuncio', 'ministrar', 'sorocaba', 'supremo']","[1, 1, 1, 1]","['circular', 'supostament']","[1, 1]",4,2,6,0
2164,"['emendar', 'fase', 'mudanca', 'necessidad', 'possibilidad', 'pratico', 'saudar']","[1, 1, 1, 1, 1, 1, 1]","['abortar', 'abortar', 'abortar', 'abortar', 'abortar', 'compartilhar', 'tampouco']","[5, 5, 5, 5, 5, 1, 1]",7,7,14,0
2168,"['situacao']","[1]","['parabem', 'parabem']","[2, 2]",1,2,3,0
2172,"['globonew']","[1]","['imagem', 'manchet', 'telejorn']","[1, 1, 1]",1,3,4,0
2173,"[]","[]","['circular', 'drone', 'drone', 'drone', 'drone', 'imagem', 'imagem', 'legendar']","[1, 4, 4, 4, 4, 2, 2, 1]",0,8,8,0
2175,"[]","[]","['pelar', 'usuario']","[1, 1]",0,2,2,0
2178,"[]","[]","['casamentar']","[1]",0,1,1,0
2179,"[]","[]","['suco', 'vitaminar']","[1, 1]",0,2,2,0
2181,"['domingo']","[1]","['compartilhar', 'postagen', 'versao']","[1, 1, 1]",1,3,4,0
2183,"[]","[]","['bonner']","[1]",0,1,1,0
2185,"[]","[]","['adelio', 'adelio', 'bispar']","[2, 2, 1]",0,3,3,0
2186,"['conformar', 'proposto']","[1, 1]","[]","[]",2,0,2,0
2188,"[]","[]","['vazio']","[1]",0,1,1,0
2194,"['respostar']","[1]","['parir', 'parir', 'parir']","[3, 3, 3]",1,3,4,0
2195,"['domingo']","[1]","['compartilhar', 'usuario', 'viralizada']","[1, 1, 1]",1,3,4,0
2198,"['mutacao']","[1]","['desligar']","[1]",1,1,2,0
2199,"[]","[]","['cristao', 'enganar', 'enganar', 'enganir']","[1, 2, 2, 1]",0,4,4,0
2200,"[]","[]","['basto', 'nordestino']","[1, 1]",0,2,2,0
2201,"[]","[]","['compartilhar']","[1]",0,1,1,0
2202,"[]","[]","[]","[]",0,0,0,0
2205,"['condicao', 'incerteza', 'preced']","[1, 1, 1]","['incendio', 'missil', 'realment', 'sobrar']","[1, 1, 1, 1]",3,4,7,0
2206,"[]","[]","['nordestino', 'nordestino']","[2, 2]",0,2,2,0
2208,"['aglomeracao']","[1]","['circular', 'compartilhar', 'desfilar', 'dorio', 'ilustrar', 'imagem', 'manipular', 'usuario', 'vagabundar']","[1, 1, 1, 1, 1, 1, 1, 1, 1]",1,9,10,0
2210,"['autoridad', 'condicao', 'dificuldad', 'emergenciai', 'equipamento', 'justificativo', 'subir', 'tesourar']","[1, 1, 1, 1, 1, 1, 1, 1]","['sacar', 'sortir', 'verificar']","[1, 1, 1]",8,3,11,0
2213,"['cerimonia', 'compromisso', 'integrant']","[1, 1, 1]","['camisa', 'circular', 'legendar', 'legendar']","[1, 1, 2, 2]",3,4,7,0
2216,"[]","[]","['assassinar', 'circular', 'circular', 'disseminar', 'imagem', 'imagem']","[1, 2, 2, 1, 2, 2]",0,6,6,0
2217,"[]","[]","['espalhar', 'menino']","[1, 1]",0,2,2,0
2218,"['sabado']","[1]","[]","[]",1,0,1,0
2219,"['autoridad', 'prorrogar']","[1, 1]","['cuspir', 'cuspir', 'pelar', 'versao']","[2, 2, 1, 1]",2,4,6,0
2220,"['avancar', 'celebrar']","[1, 1]","['bandeiro', 'bandeiro', 'compartilhar', 'compartilhar', 'dubai', 'idioma', 'imagem', 'legendar', 'torrar']","[2, 2, 2, 2, 1, 1, 1, 1, 1]",2,9,11,0
2221,"['subir']","[1]","['circular', 'compartilhar']","[1, 1]",1,2,3,0
2222,"['amplo', 'comissao', 'possibilidad', 'regrar', 'regulamentar']","[1, 1, 1, 1, 1]","['casamentar', 'casamentar']","[2, 2]",5,2,7,0
2223,"[]","[]","['boatar', 'circular', 'incendio', 'soldar', 'soldar']","[1, 1, 1, 2, 2]",0,5,5,0
2229,"[]","[]","['compartilhar']","[1]",0,1,1,0
2230,"['calamidad', 'converso', 'negativar', 'nogueira', 'nogueira', 'notificar']","[1, 1, 1, 2, 2, 1]","['caixao', 'compartilhar', 'soltar']","[1, 1, 1]",6,3,9,0
2231,"[]","[]","[]","[]",0,0,0,0
2234,"['destacar', 'dificuldad', 'dinamarca', 'mudanca', 'observar', 'reducao', 'viagem']","[1, 1, 1, 1, 1, 1, 1]","['arvor', 'gretar', 'gretar', 'greve', 'imagem', 'imagem', 'legendar', 'realment']","[1, 2, 2, 1, 2, 2, 1, 1]",7,8,15,0
2235,"['reabertura', 'regiao']","[1, 1]","['compartilhar', 'inscricao', 'motorista', 'preencher']","[1, 1, 1, 1]",2,4,6,0
2237,"['converso', 'deltan', 'dialogo', 'domingo', 'exjuiz', 'forcatarefa', 'justicar', 'ministrar', 'sentenca']","[1, 1, 1, 1, 1, 1, 1, 1, 1]","['atribuir', 'atribuir', 'circular', 'imagem', 'telegram', 'vazar']","[2, 2, 1, 1, 1, 1]",9,6,15,0
2243,"['domingo', 'mudanca', 'sabado']","[1, 1, 1]","['circular']","[1]",3,1,4,0
2246,"['pib', 'positivar']","[1, 1]","['enganar']","[1]",2,1,3,0
2248,"[]","[]","['atribuir', 'supostament']","[1, 1]",0,2,2,0
2253,"['realizacao']","[1]","['verdadeiro']","[1]",1,1,2,0
2254,"['inedito']","[1]","['compartilhar', 'estranhar', 'pelar', 'sobrar']","[1, 1, 1, 1]",1,4,5,0
2256,"[]","[]","[]","[]",0,0,0,0
2258,"['biliao', 'propagacao', 'respiratorio', 'saudar']","[1, 1, 1, 1]","['cbn', 'circular', 'circular', 'compartilhar', 'garganta']","[1, 2, 2, 1, 1]",4,5,9,0
2259,"[]","[]","['clicar', 'clicar', 'compartilhar', 'compartilhar', 'compartilhar', 'galaxi', 'galaxi', 'instrucao', 'macho', 'parabem', 'parir', 'questionario', 'reivindicar', 'reivindicar']","[2, 2, 3, 3, 3, 2, 2, 1, 1, 1, 1, 1, 2, 2]",0,14,14,0
2261,"[]","[]","['invadir']","[1]",0,1,1,0
2263,"['autoridad', 'boletim', 'justicar', 'necessario']","[1, 1, 1, 1]","['checagem', 'compartilhar', 'imagem', 'implantar', 'viralizada']","[1, 1, 1, 1, 1]",4,5,9,0
2264,"['atrasar', 'domingo', 'justicar', 'mudanca']","[1, 1, 1, 1]","['fraudar']","[1]",4,1,5,0
2265,"[]","[]","[]","[]",0,0,0,0
2267,"[]","[]","['gasolina']","[1]",0,1,1,0
2269,"['aplicacao', 'autoridad', 'saudar']","[1, 1, 1]","['crer', 'versao', 'versao', 'versao']","[1, 3, 3, 3]",3,4,7,0
2273,"['cenario']","[1]","['circular', 'circular', 'imagem', 'invadir']","[2, 2, 1, 1]",1,4,5,0
2274,"[]","[]","[]","[]",0,0,0,0
2276,"[]","[]","['verdadeiro']","[1]",0,1,1,0
2284,"['exministro', 'ministrar', 'monitoram', 'pastar']","[1, 1, 1, 1]","['compartilhar', 'compartilhar', 'postagen']","[2, 2, 1]",4,3,7,0
2286,"[]","[]","['amplament', 'circular', 'compartilhar', 'humanar', 'ilustrar', 'postagen', 'telegram']","[1, 1, 1, 1, 1, 1, 1]",0,7,7,0
2289,"['armazenamento', 'benjamin', 'benjamin', 'instalacao', 'ministrar']","[1, 2, 2, 1, 1]","['acidentar', 'humanar', 'inocentar', 'missil', 'missil', 'missil']","[1, 1, 1, 3, 3, 3]",5,6,11,0
2291,"['comissao', 'decisao', 'vespera']","[1, 1, 1]","['adorar', 'ganhar', 'ideologia', 'pelar', 'pelar', 'pelar', 'segundar', 'versao', 'versao', 'versao', 'versao', 'versao']","[1, 1, 1, 3, 3, 3, 1, 5, 5, 5, 5, 5]",3,12,15,0
2294,"['situacao', 'turma']","[1, 1]","[]","[]",2,0,2,0
2295,"['internar']","[1]","['realment']","[1]",1,1,2,0
2300,"['agravar', 'crise', 'opcao', 'paralisar', 'quarentenar', 'reabertura', 'reabrir', 'situacao', 'turista', 'turistico']","[1, 1, 1, 1, 1, 1, 1, 1, 1, 1]","['circular', 'circular', 'inscricao', 'parir', 'torrar', 'torrar', 'torrar', 'torrar', 'usuario']","[2, 2, 1, 1, 4, 4, 4, 4, 1]",10,9,19,0
2302,"['destacar', 'necessario']","[1, 1]","[]","[]",2,0,2,0
2305,"['levantamento', 'saudar']","[1, 1]","['circular']","[1]",2,1,3,0
2307,"['deflagrar', 'justicar', 'ministrar']","[1, 1, 1]","['boatar', 'circular', 'despejar', 'vazar']","[1, 1, 1, 1]",3,4,7,0
2308,"[]","[]","[]","[]",0,0,0,0
2309,"['prioridad']","[1]","['gravacao', 'imagem', 'imagem', 'legendar', 'reverso']","[1, 2, 2, 1, 1]",1,5,6,0
2313,"['pagamento', 'proposto']","[1, 1]","['circular']","[1]",2,1,3,0
2314,"['painel', 'saudar']","[1, 1]","['circular', 'imagem', 'imagem', 'legendar', 'pelar', 'reverso']","[1, 2, 2, 1, 1, 1]",2,6,8,0
2316,"['companhia', 'reajust']","[1, 1]","['enganoso', 'pelar']","[1, 1]",2,2,4,0
2317,"['alcolumbr', 'alcolumbr', 'alcolumbr', 'articulacao', 'isolar']","[3, 3, 3, 1, 1]","['checar', 'circular', 'imagem', 'verdadeiro', 'verificar']","[1, 1, 1, 1, 1]",5,5,10,0
2319,"['acordo', 'delacao', 'delacao', 'esquema', 'pagamento', 'recurso', 'supremo']","[1, 2, 2, 1, 1, 1, 1]","['circular']","[1]",7,1,8,0
2323,"['autoridad', 'descumprir', 'saudar']","[1, 1, 1]","['circular', 'fotografo', 'imagem', 'legendar']","[1, 1, 1, 1]",3,4,7,0
2324,"['fronteiro']","[1]","['compartilhar']","[1]",1,1,2,0
2325,"['absoluto', 'especifico', 'estatistico', 'oswaldo', 'saudar', 'saudar']","[1, 1, 1, 1, 2, 2]","['desmentir', 'verificar']","[1, 1]",6,2,8,0
2326,"['absoluto', 'cenario', 'cenario', 'cenario', 'companhia', 'congresso', 'congresso', 'consequencia', 'curvo', 'decisao', 'economia', 'economia', 'economia', 'economia', 'economia', 'epidemiar', 'globonew', 'impactar', 'impactar', 'impactar', 'importancia', 'inglaterra', 'internar', 'internar', 'internar', 'internar', 'planar', 'preocupacao', 'preservacao', 'ricardo', 'tendencia', 'tendencia']","[1, 3, 3, 3, 1, 2, 2, 1, 1, 1, 5, 5, 5, 5, 5, 1, 1, 3, 3, 3, 1, 1, 4, 4, 4, 4, 1, 1, 1, 1, 2, 2]","['amplament', 'assaltar', 'assaltar', 'circular', 'escravo', 'estuprar', 'imagem', 'sacar', 'sapato', 'sapato', 'verdadeiro']","[1, 2, 2, 1, 1, 1, 1, 1, 2, 2, 1]",32,11,43,0
2329,"['concedido', 'economia', 'gued', 'ministrar', 'montant', 'prever', 'realizacao', 'recurso']","[1, 1, 1, 1, 1, 1, 1, 1]","['falsar', 'viralizada', 'viralizado']","[1, 1, 1]",8,3,11,0
2330,"[]","[]","[]","[]",0,0,0,0
2332,"['folhar', 'folhar', 'salao']","[2, 2, 1]","['circular', 'ilustrar', 'postagen']","[1, 1, 1]",3,3,6,0
2334,"['anuncio', 'anvisa', 'processo', 'quadro', 'sigla', 'vigilancia', 'vigilancia']","[1, 1, 1, 1, 1, 2, 2]","['cbn', 'circular', 'compartilhar', 'dioxido', 'dioxido', 'dioxido']","[1, 1, 1, 3, 3, 3]",7,6,13,0
2336,"[]","[]","[]","[]",0,0,0,0
2338,"['biliao', 'biliao', 'biliao', 'europeu', 'europeu', 'europeu', 'europeu', 'fronteiro', 'fronteiro', 'situacao', 'superar']","[3, 3, 3, 4, 4, 4, 4, 2, 2, 1, 1]","['enganar', 'ganhar']","[1, 1]",11,2,13,0
2340,"[]","[]","[]","[]",0,0,0,0
2342,"[]","[]","['circular']","[1]",0,1,1,0
2344,"[]","[]","['espalhar', 'imagem', 'quinzena']","[1, 1, 1]",0,3,3,0
2347,"[]","[]","['transposicao', 'transposicao', 'transposicao']","[3, 3, 3]",0,3,3,0
2349,"['companhia', 'michael', 'necessidad']","[1, 1, 1]","['assinalar', 'circular', 'idioma', 'postagen']","[1, 1, 1, 1]",3,4,7,0
2351,"['pagamento', 'provisorio', 'suspensao']","[1, 1, 1]","['espalhar', 'logotipo', 'pego', 'quinzena']","[1, 1, 1, 1]",3,4,7,0
2354,"[]","[]","['gravacao', 'menino']","[1, 1]",0,2,2,0
2357,"[]","[]","['chorar', 'copiar', 'versao', 'versao']","[1, 1, 2, 2]",0,4,4,0
2358,"['etapa', 'rastreamento']","[1, 1]","['compartilhar', 'compartilhar', 'ganhar', 'preencher']","[2, 2, 1, 1]",2,4,6,0
2359,"['biliao']","[1]","[]","[]",1,0,1,0
2360,"['cerimonia', 'ministrar']","[1, 1]","['expulsar']","[1]",2,1,3,0
2361,"[]","[]","[]","[]",0,0,0,0
2362,"[]","[]","[]","[]",0,0,0,0
2363,"['client']","[1]","['enderecar', 'estranhar', 'estuprar', 'invadir', 'motorista', 'motorista', 'motorista', 'motorista', 'motorista', 'motorista', 'motorista', 'motorista', 'motorista', 'motorista', 'motorista', 'motorista', 'sacar', 'sortir', 'verdadeiro']","[1, 1, 1, 1, 12, 12, 12, 12, 12, 12, 12, 12, 12, 12, 12, 12, 1, 1, 1]",1,19,20,0
2365,"['ambientar', 'competicao', 'domingo']","[1, 1, 1]","[]","[]",3,0,3,0
2370,"['goncalv']","[1]","[]","[]",1,0,1,0
2375,"[]","[]","['misericordia']","[1]",0,1,1,0
2376,"[]","[]","['atribuir', 'circular', 'misturar', 'postagen']","[1, 1, 1, 1]",0,4,4,0
2377,"['contagioso', 'epidemiar', 'passageiro', 'possibilidad', 'surtir']","[1, 1, 1, 1, 1]","[]","[]",5,0,5,0
2378,"[]","[]","[]","[]",0,0,0,0
2379,"['crise', 'necessario', 'quedo']","[1, 1, 1]","['basto', 'circular', 'circular', 'falsar', 'tampouco']","[1, 2, 2, 1, 1]",3,5,8,0
2382,"[]","[]","['circular']","[1]",0,1,1,0
2383,"['renata']","[1]","['bonner', 'bonner', 'bonner', 'compartilhar', 'espalhar', 'gravacao', 'gravacao', 'legendar', 'postagen', 'viralizado']","[3, 3, 3, 1, 1, 2, 2, 1, 1, 1]",1,10,11,0
2384,"[]","[]","['circular', 'imagem']","[1, 1]",0,2,2,0
2387,"['equipamento', 'equipamento', 'saudar', 'saudar', 'saudar', 'saudar', 'trafego']","[2, 2, 4, 4, 4, 4, 1]","['circular']","[1]",7,1,8,0
2388,"[]","[]","['espalhar', 'minutar']","[1, 1]",0,2,2,0
2389,"[]","[]","['circular', 'imagem', 'legendar', 'reverso', 'verificar']","[1, 1, 1, 1, 1]",0,5,5,0
2390,"['calculo', 'client', 'domingo', 'domingo', 'domingo', 'mantido', 'preservar', 'regiao', 'sabado']","[1, 1, 3, 3, 3, 1, 1, 1, 1]","['gasolina', 'verdadeiro']","[1, 1]",9,2,11,0
2391,"[]","[]","['espalhar', 'indignacao', 'mansao', 'telejorn']","[1, 1, 1, 1]",0,4,4,0
2394,"['regiao', 'regiao']","[2, 2]","['imagem', 'imagem', 'legendar', 'visualizacao']","[2, 2, 1, 1]",2,4,6,0
2395,"['estrategia', 'inicialment', 'instituto', 'pslsp']","[1, 1, 1, 1]","['capturar', 'circular', 'compartilhar', 'pelar', 'pelar', 'segundar', 'usuario']","[1, 1, 1, 2, 2, 1, 1]",4,7,11,0
2396,"['comparacao', 'escalar', 'normalment', 'normalment', 'observacao', 'regiao', 'umido']","[1, 1, 2, 2, 1, 1, 1]","['capturar', 'desmentir', 'espalhar', 'ilustrar', 'imagem', 'imagem', 'incendio', 'incendio', 'incendio', 'incendio']","[1, 1, 1, 1, 2, 2, 4, 4, 4, 4]",7,10,17,0
2398,"[]","[]","[]","[]",0,0,0,0
2399,"['fux', 'fux', 'inicialment', 'ministrar', 'ministrar', 'ministrar', 'pratico', 'processo', 'reclamacao', 'reclamacao', 'reuniao', 'sentenca', 'supremo', 'supremo']","[2, 2, 1, 3, 3, 3, 1, 1, 2, 2, 1, 1, 2, 2]","['menino', 'menino', 'secreto', 'secreto', 'secreto', 'soltura']","[2, 2, 3, 3, 3, 1]",14,6,20,0
2403,"['entregu', 'regrar', 'respostar']","[1, 1, 1]","['enderecar', 'ganhar', 'ganhar', 'ganhar', 'macho', 'macho', 'minutar', 'parabem', 'parabem', 'parabem', 'sapato', 'sapato', 'selecionar', 'sortir', 'usuario', 'usuario']","[1, 3, 3, 3, 2, 2, 1, 3, 3, 3, 2, 2, 1, 1, 2, 2]",3,16,19,0
2404,"['argumentar', 'colaboracao', 'corpu', 'decisao', 'esquema', 'examinar', 'exministro', 'habea', 'justicar', 'ministrar', 'preventivo', 'recurso', 'regiao', 'supremo']","[1, 1, 1, 1, 1, 1, 1, 1, 1, 1, 1, 1, 1, 1]","['acidentar', 'atribuir', 'circular']","[1, 1, 1]",14,3,17,0
2405,"['domingo']","[1]","['compartilhar', 'imagem', 'parabem', 'parabem', 'realment', 'replicar', 'usuario']","[1, 1, 2, 2, 1, 1, 1]",1,7,8,0
2406,"['palacio', 'planalto', 'planalto']","[1, 2, 2]","['mansao']","[1]",3,1,4,0
2408,"['carat', 'moderno']","[1, 1]","['compartilhar', 'imagem', 'imagem', 'imagem', 'legendar', 'reverso', 'supostament', 'viralizada', 'viralizada']","[1, 3, 3, 3, 1, 1, 1, 2, 2]",2,9,11,0
2412,"[]","[]","[]","[]",0,0,0,0
2414,"['autoridad', 'investigacao', 'saudar', 'saudar']","[1, 1, 2, 2]","['espalhar', 'espalhar']","[2, 2]",4,2,6,0
2415,"['ministrar']","[1]","[]","[]",1,0,1,0
2416,"['depoimento', 'depoimento', 'depoimento', 'regiao']","[3, 3, 3, 1]","['acidentar', 'boatar', 'espalhar', 'imagem', 'incendio', 'incendio', 'incendio']","[1, 1, 1, 1, 3, 3, 3]",4,7,11,0
2417,"['regiao']","[1]","['circular', 'compartilhar', 'imagem', 'legendar', 'postagen', 'reverso', 'viralizada']","[1, 1, 1, 1, 1, 1, 1]",1,7,8,0
2419,"[]","[]","[]","[]",0,0,0,0
2420,"['gued', 'supremo', 'suspeicao']","[1, 1, 1]","[]","[]",3,0,3,0
2422,"['anuncio', 'ministrar']","[1, 1]","['compartilhar', 'estampar', 'invadir', 'legendar']","[1, 1, 1, 1]",2,4,6,0
2425,"['elaborar', 'elaborar', 'parceria', 'turma']","[2, 2, 1, 1]","[]","[]",4,0,4,0
2426,"['antonio', 'condicao', 'exministro']","[1, 1, 1]","['assassinar', 'falsar']","[1, 1]",3,2,5,0
2429,"[]","[]","[]","[]",0,0,0,0
2433,"['regrar', 'respostar']","[1, 1]","['enderecar', 'ganhar', 'ganhar', 'parabem', 'parabem', 'parir', 'parir', 'questionario', 'selecionar', 'sobrar', 'sortir']","[1, 2, 2, 2, 2, 2, 2, 1, 1, 1, 1]",2,11,13,0
2434,"[]","[]","[]","[]",0,0,0,0
2435,"['sabado']","[1]","['mansao', 'mansao', 'mansao', 'parabem', 'vagabundar', 'versao']","[3, 3, 3, 1, 1, 1]",1,6,7,0
2438,"['ricardo']","[1]","['parir', 'sobrar']","[1, 1]",1,2,3,0
2439,"['congresso', 'congresso', 'economia', 'planar', 'subir']","[2, 2, 1, 1, 1]","['greve', 'revoltar']","[1, 1]",5,2,7,0
2440,"[]","[]","['clicar', 'imagem', 'incendio', 'insinuar', 'legendar', 'postagen']","[1, 1, 1, 1, 1, 1]",0,6,6,0
2443,"['privar', 'recurso', 'recurso']","[1, 2, 2]","['captar', 'captar', 'captar', 'captar', 'circular', 'filmar', 'rouanet', 'rouanet', 'sequer']","[4, 4, 4, 4, 1, 1, 2, 2, 1]",3,9,12,0
2447,"['saudar']","[1]","['checar', 'circular', 'compartilhar', 'desmentir', 'espalhar']","[1, 1, 1, 1, 1]",1,5,6,0
2450,"['anteriorment', 'tcu', 'tcu']","[1, 2, 2]","['desmentir', 'parir', 'pelar']","[1, 1, 1]",3,3,6,0
2451,"['permanencia', 'prioritario', 'saudar']","[1, 1, 1]","['anoso', 'anoso']","[2, 2]",3,2,5,0
2454,"[]","[]","['incendio']","[1]",0,1,1,0
2458,"[]","[]","['cedula', 'fraudar']","[1, 1]",0,2,2,0
2461,"['biliao', 'biliao', 'biliao', 'feriar', 'feriar']","[3, 3, 3, 2, 2]","['amigar', 'amigar', 'caixao', 'pego', 'realment']","[2, 2, 1, 1, 1]",5,5,10,0
2462,"[]","[]","['usuario']","[1]",0,1,1,0
2464,"['converso']","[1]","['atirar', 'circular', 'imagem', 'imagem', 'imagem']","[1, 1, 3, 3, 3]",1,5,6,0
2466,"['epidemiar', 'estrategia', 'modelo', 'necessario', 'periodo', 'periodo', 'piorar', 'transmissao', 'transmissao', 'transmissao']","[1, 1, 1, 1, 2, 2, 1, 3, 3, 3]","['circular']","[1]",10,1,11,0
2471,"['correspondent', 'domingo', 'opcao']","[1, 1, 1]","['circular']","[1]",3,1,4,0
2473,"['domingo', 'periodo', 'periodo']","[1, 2, 2]","[]","[]",3,0,3,0
2475,"[]","[]","['abencoar', 'adorar', 'inocentar', 'manipular', 'realment']","[1, 1, 1, 1, 1]",0,5,5,0
2478,"[]","[]","[]","[]",0,0,0,0
2481,"['estimular', 'impactar']","[1, 1]","['agredir', 'camisa', 'disfarcar', 'espalhar', 'imagem']","[1, 1, 1, 1, 1]",2,5,7,0
2486,"[]","[]","[]","[]",0,0,0,0
2489,"['ministrar', 'normalment', 'quarentenar', 'saudar']","[1, 1, 1, 1]","['clicar', 'enganir']","[1, 1]",4,2,6,0
2490,"[]","[]","['adorar', 'desligar', 'parabem', 'sacar', 'vc']","[1, 1, 1, 1, 1]",0,5,5,0
2494,"['almeida', 'almeida', 'cometido', 'destacar']","[2, 2, 1, 1]","['capturar', 'compartilhar', 'fraudar', 'fraudar', 'imagem', 'postagen', 'postagen', 'rouanet', 'rouanet']","[1, 1, 2, 2, 1, 2, 2, 2, 2]",4,9,13,0
2496,"['pratico', 'pratico', 'pratico', 'pratico']","[4, 4, 4, 4]","['assassinar', 'despejar', 'despejar', 'garganta', 'garganta', 'garganta', 'torturar', 'torturar', 'torturar', 'torturar']","[1, 2, 2, 3, 3, 3, 4, 4, 4, 4]",4,10,14,0
2499,"['enfermagem']","[1]","[]","[]",1,0,1,0
2500,"['consolidar', 'destacar', 'henriqu', 'necessario']","[1, 1, 1, 1]","['amplament', 'checar', 'compartilhar']","[1, 1, 1]",4,3,7,0
2502,"['agravar', 'aprovacao', 'aprovacao', 'aprovacao', 'crise', 'escassez', 'saudar']","[1, 3, 3, 3, 1, 1, 1]","['circular', 'compartilhar', 'ganhar', 'postagen']","[1, 1, 1, 1]",7,4,11,0
2504,"[]","[]","['compartilhar', 'compartilhar', 'ganhar', 'ganhar', 'ganhar', 'ganhar', 'ganhar', 'sortir', 'usuario', 'vazio']","[2, 2, 5, 5, 5, 5, 5, 1, 1, 1]",0,10,10,0
2508,"['henriqu']","[1]","[]","[]",1,0,1,0
2509,"['cenario']","[1]","['arquivar']","[1]",1,1,2,0
2511,"['contabilizar']","[1]","['clicar', 'clicar', 'compartilhar', 'fraudar']","[2, 2, 1, 1]",1,4,5,0
2512,"['integrant', 'reducao']","[1, 1]","[]","[]",2,0,2,0
2514,"['consequencia', 'intenso', 'recuperacao', 'submetido']","[1, 1, 1, 1]","['atribuir', 'circular', 'ganhar', 'garganta', 'imagem']","[1, 1, 1, 1, 1]",4,5,9,0
2515,"['constituicao', 'equivalent', 'saudar', 'saudar', 'saudar', 'sigla']","[1, 1, 3, 3, 3, 1]","['supostament']","[1]",6,1,7,0
2516,"[]","[]","['lixar', 'lixar', 'lixar', 'parir']","[3, 3, 3, 1]",0,4,4,0
2518,"['administrativo', 'decisao', 'decorrencia', 'decorrent', 'exercicio', 'funcao', 'improbidad', 'julgamento', 'justicar', 'plenario', 'processo', 'supremo']","[1, 1, 1, 1, 1, 1, 1, 1, 1, 1, 1, 1]","['circular']","[1]",12,1,13,0
2519,"[]","[]","[]","[]",0,0,0,0
2520,"['cirurgico', 'infectar', 'taxar', 'transmissao']","[1, 1, 1, 1]","['verificar']","[1]",4,1,5,0
2521,"['alteracao', 'comparacao', 'consolidar', 'limitacao', 'saudar']","[1, 1, 1, 1, 1]","[]","[]",5,0,5,0
2522,"['temporariament']","[1]","['compartilhar', 'compartilhar', 'compartilhar', 'espalhar', 'imagem']","[3, 3, 3, 1, 1]",1,5,6,0
2523,"['tcu', 'tcu', 'tcu']","[3, 3, 3]","[]","[]",3,0,3,0
2524,"['atuacao', 'supremo', 'supremo', 'supremo']","[1, 3, 3, 3]","['manchet']","[1]",4,1,5,0
2525,"['decisao', 'decorrencia', 'pratico', 'suspensao', 'toquio']","[1, 1, 1, 1, 1]","['enganoso', 'parir', 'parir', 'parir', 'pelar', 'segundar']","[1, 3, 3, 3, 1, 1]",5,6,11,0
2530,"['ambito', 'fundamentar', 'servidor']","[1, 1, 1]","['cartaz', 'circular', 'circular']","[1, 2, 2]",3,3,6,0
2536,"[]","[]","['circular', 'circular']","[2, 2]",0,2,2,0
2537,"['afetado', 'bandeirant', 'cenario', 'circulacao', 'saudar']","[1, 1, 1, 1, 1]","['boatar']","[1]",5,1,6,0
2543,"['corpu', 'habea', 'justicar', 'necessario', 'piorar', 'supremo']","[1, 1, 1, 1, 1, 1]","['replicar']","[1]",6,1,7,0
2544,"['decorrencia', 'levantamento']","[1, 1]","['amplament', 'circular', 'imagem', 'postagen']","[1, 1, 1, 1]",2,4,6,0
2545,"['estimular', 'propagacao']","[1, 1]","['disseminar']","[1]",2,1,3,0
2548,"['economia']","[1]","['fraudar', 'gasolina', 'usuario']","[1, 1, 1]",1,3,4,0
2549,"[]","[]","['arvor', 'circular', 'compartilhar', 'gravacao', 'soltar', 'usuario']","[1, 1, 1, 1, 1, 1]",0,6,6,0
2550,"['circulacao', 'destacar', 'privar', 'regulamentar']","[1, 1, 1, 1]","['cartaz', 'circular', 'espalhar', 'imagem']","[1, 1, 1, 1]",4,4,8,0
2557,"['desenvolvimento']","[1]","[]","[]",1,0,1,0
2559,"[]","[]","['menino']","[1]",0,1,1,0
2560,"['companhia']","[1]","['circular', 'circular', 'imagem', 'imagem', 'imagem', 'legendar']","[2, 2, 3, 3, 3, 1]",1,6,7,0
2563,"['martim', 'martim', 'martim']","[3, 3, 3]","['parir', 'venezuelano', 'venezuelano']","[1, 2, 2]",3,3,6,0
2564,"[]","[]","['estuprar', 'vazio']","[1, 1]",0,2,2,0
2565,"['independentement', 'preocupacao']","[1, 1]","['protestar', 'sobrar']","[1, 1]",2,2,4,0
2566,"['justicar', 'justicar']","[2, 2]","['circular', 'desmentir', 'imagem', 'legendar']","[1, 1, 1, 1]",2,4,6,0
2567,"['ambientar', 'economia', 'esperancar', 'estatistico', 'intensivo', 'intensivo', 'liderar', 'mudanca', 'necessario', 'necessario', 'normalment', 'respirador', 'saudar', 'saudar', 'saudar', 'ventilador', 'ventilador']","[1, 1, 1, 1, 2, 2, 1, 1, 2, 2, 1, 1, 3, 3, 3, 2, 2]","['autopsia', 'autopsia', 'autopsia', 'autopsia', 'compartilhar', 'compartilhar', 'dioxido', 'disseminar', 'enganar', 'equador', 'equador', 'equador', 'equador', 'equador', 'equador', 'equador', 'minutar']","[4, 4, 4, 4, 2, 2, 1, 1, 1, 7, 7, 7, 7, 7, 7, 7, 1]",17,17,34,0
2568,"['afp', 'antecipar', 'anticorpo']","[1, 1, 1]","['amplament', 'checagem', 'circular', 'postagen', 'supostament', 'telegram', 'viralizada', 'visualizar']","[1, 1, 1, 1, 1, 1, 1, 1]",3,8,11,0
2569,"['treinar']","[1]","['ideologia', 'invadir', 'realment', 'secreto']","[1, 1, 1, 1]",1,4,5,0
2571,"[]","[]","['espalhar']","[1]",0,1,1,0
2573,"['comportamento', 'posturar', 'posturar', 'quadro', 'republico']","[1, 2, 2, 1, 1]","['chorar', 'usuario']","[1, 1]",5,2,7,0
2574,"['entregu', 'regrar', 'respostar']","[1, 1, 1]","['clicar', 'clicar', 'compartilhar', 'compartilhar', 'compartilhar', 'enderecar', 'ganhar', 'ganhar', 'instrucao', 'macho', 'parabem', 'parabem', 'parir', 'questionario', 'reivindicar', 'reivindicar', 'selecionar', 'sobrar', 'sortir']","[2, 2, 3, 3, 3, 1, 2, 2, 1, 1, 2, 2, 1, 1, 2, 2, 1, 1, 1]",3,19,22,0
2575,"['imunizacao']","[1]","['circular', 'imagem', 'realment']","[1, 1, 1]",1,3,4,0
2577,"['autoridad', 'habito', 'quadro', 'saudar', 'taxar']","[1, 1, 1, 1, 1]","['cbn', 'circular', 'vitaminar']","[1, 1, 1]",5,3,8,0
2579,"[]","[]","['curioso', 'parir']","[1, 1]",0,2,2,0
2581,"[]","[]","['atribuir', 'circular', 'realment']","[1, 1, 1]",0,3,3,0
2582,"['internar']","[1]","['espalhar', 'imagem', 'quinzena']","[1, 1, 1]",1,3,4,0
2583,"['impactar', 'mudanca']","[1, 1]","['circular', 'fraudar', 'humanar', 'postagen']","[1, 1, 1, 1]",2,4,6,0
2586,"['recebido', 'supremo', 'supremo']","[1, 2, 2]","['boatar', 'circular']","[1, 1]",3,2,5,0
2592,"['autoridad', 'estatistico', 'intubacao', 'moderno', 'parceria']","[1, 1, 1, 1, 1]","[]","[]",5,0,5,0
2593,"['estimular', 'impactar']","[1, 1]","['agredir', 'camisa', 'disfarcar', 'espalhar', 'imagem', 'parir']","[1, 1, 1, 1, 1, 1]",2,6,8,0
2594,"['atrasar', 'bolsonarista', 'randolf']","[1, 1, 1]","['parir', 'pelar', 'pelar']","[1, 2, 2]",3,3,6,0
2596,"['merkel']","[1]","['imagem']","[1]",1,1,2,0
2598,"['expressivo']","[1]","['arquivar', 'compartilhar', 'compartilhar', 'grupar']","[1, 2, 2, 1]",1,4,5,0
2599,"[]","[]","['compartilhar', 'enganir']","[1, 1]",0,2,2,0
2602,"[]","[]","['atirar', 'atirar', 'circular', 'deitar', 'gretar', 'gretar', 'gretar', 'gretar', 'legendar', 'verdadeiro']","[2, 2, 1, 1, 4, 4, 4, 4, 1, 1]",0,10,10,0
2604,"['decorrencia', 'positivar']","[1, 1]","['circular']","[1]",2,1,3,0
2605,"['apurar', 'comissao', 'crise', 'crise', 'infectar', 'infectar', 'inquerito', 'mandatario', 'transmissao']","[1, 1, 2, 2, 2, 2, 1, 1, 1]","['parir', 'parir', 'pelar', 'realment', 'sobrar', 'vezar']","[2, 2, 1, 1, 1, 1]",9,6,15,0
2607,"['privar', 'sigla']","[1, 1]","['circular', 'circular']","[2, 2]",2,2,4,0
2608,"['republico']","[1]","[]","[]",1,0,1,0
2611,"['infectar']","[1]","[]","[]",1,0,1,0
2613,"['facilitar']","[1]","['cbn', 'circular', 'incendio', 'incendio', 'motorista']","[1, 1, 2, 2, 1]",1,5,6,0
2619,"['queiroz', 'vieira']","[1, 1]","['assassinar', 'assassinar', 'circular', 'compartilhar']","[2, 2, 1, 1]",2,4,6,0
2620,"['alvaro', 'domingo', 'domingo', 'domingo', 'domingo', 'republico']","[1, 4, 4, 4, 4, 1]","[]","[]",6,0,6,0
2621,"['necessario', 'observar']","[1, 1]","['carbono', 'carbono', 'compartilhar', 'dioxido', 'dioxido', 'fotografia', 'postagen']","[2, 2, 1, 2, 2, 1, 1]",2,7,9,0
2623,"['crise', 'espanha', 'respostar']","[1, 1, 1]","['idioma', 'imagem', 'reverso']","[1, 1, 1]",3,3,6,0
2624,"['saudar']","[1]","['amplament', 'circular', 'compartilhar', 'desgracar', 'gravacao', 'legendar', 'minutar', 'postagen', 'visualizacao']","[1, 1, 1, 1, 1, 1, 1, 1, 1]",1,9,10,0
2626,"['amplo', 'republico']","[1, 1]","['camisa', 'camisa', 'circular', 'circular', 'compartilhar', 'legendar']","[2, 2, 2, 2, 1, 1]",2,6,8,0
2628,"['estatistico', 'oliveira']","[1, 1]","['imagem']","[1]",2,1,3,0
2629,"['congresso']","[1]","[]","[]",1,0,1,0
2630,"[]","[]","['drone']","[1]",0,1,1,0
2631,"[]","[]","['arvor', 'deitar', 'espalhar']","[1, 1, 1]",0,3,3,0
2632,"['desembarcar', 'exigencia', 'expectativa']","[1, 1, 1]","[]","[]",3,0,3,0
2635,"['administrativo', 'gabinet', 'queiroz']","[1, 1, 1]","['atribuir', 'circular', 'imagem']","[1, 1, 1]",3,3,6,0
2636,"[]","[]","[]","[]",0,0,0,0
2640,"[]","[]","['casamentar']","[1]",0,1,1,0
2642,"[]","[]","[]","[]",0,0,0,0
2646,"['colaborar', 'disseminacao']","[1, 1]","[]","[]",2,0,2,0
2648,"['machadar', 'saudar', 'saudar']","[1, 2, 2]","['circular', 'legendar', 'vazio', 'vazio']","[1, 1, 2, 2]",3,4,7,0
2651,"['autorizacao']","[1]","['cocaina', 'cocaina', 'cocaina', 'cocaina', 'cocaina', 'protestar', 'soldar', 'trafico']","[5, 5, 5, 5, 5, 1, 1, 1]",1,8,9,0
2652,"[]","[]","['desmentir', 'fraudar']","[1, 1]",0,2,2,0
2654,"['constituicao', 'constituicao', 'exministro', 'exministro', 'ministrar', 'supremo']","[2, 2, 2, 2, 1, 1]","['circular', 'imagem', 'imagem', 'imagem', 'imagem']","[1, 4, 4, 4, 4]",6,5,11,0
2657,"['anticorpo']","[1]","['compartilhar', 'nobel']","[1, 1]",1,2,3,0
2659,"[]","[]","['cocain', 'cocaina', 'cocaina', 'cocaina', 'cocaina', 'cocaina', 'crer', 'realment']","[1, 5, 5, 5, 5, 5, 1, 1]",0,8,8,0
2665,"[]","[]","['compartilhar', 'imagem']","[1, 1]",0,2,2,0
2666,"['alternativo', 'justicar']","[1, 1]","['canadens', 'catedr', 'catolico', 'catolico', 'catolico', 'estuprar', 'estuprar', 'secreto', 'torturar', 'trafico', 'trafico']","[1, 1, 3, 3, 3, 2, 2, 1, 1, 2, 2]",2,11,13,0
2667,"['aprovacao', 'constituicao', 'equivalent', 'mudanca']","[1, 1, 1, 1]","['circular', 'ganhar', 'ganhar']","[1, 2, 2]",4,3,7,0
2668,"['contabilizar', 'decorrent', 'decorrent', 'respiratorio', 'respiratorio', 'respiratorio', 'respiratorio']","[1, 2, 2, 4, 4, 4, 4]","['circular', 'espalhar']","[1, 1]",7,2,9,0
2669,"[]","[]","['bandeiro', 'bandeiro', 'bandeiro', 'circular', 'filmar', 'imagem']","[3, 3, 3, 1, 1, 1]",0,6,6,0
2671,"[]","[]","[]","[]",0,0,0,0
2673,"[]","[]","['usuario']","[1]",0,1,1,0
2674,"['argumentar', 'iniciativo']","[1, 1]","['barragem', 'barragem', 'rompimento', 'sacar']","[2, 2, 1, 1]",2,4,6,0
2675,"[]","[]","['boatar', 'idioma', 'imagem', 'legendar', 'legendar', 'legendar', 'versao']","[1, 1, 1, 3, 3, 3, 1]",0,7,7,0
2678,"['equipamento']","[1]","['circular', 'imagem', 'postagen', 'telegram', 'versao', 'viralizado']","[1, 1, 1, 1, 1, 1]",1,6,7,0
2679,"[]","[]","[]","[]",0,0,0,0
2680,"['desafiar']","[1]","['agredir', 'agredir', 'lixar', 'soldar', 'soldar', 'venezuelano', 'venezuelano']","[2, 2, 1, 2, 2, 2, 2]",1,7,8,0
2681,"[]","[]","[]","[]",0,0,0,0
2683,"['aumento', 'decisao', 'substituicao']","[1, 1, 1]","['circular', 'replicar']","[1, 1]",3,2,5,0
2686,"['atrasar', 'atrasar', 'boletim', 'normalment']","[2, 2, 1, 1]","['fraudar', 'secreto', 'secreto']","[1, 2, 2]",4,3,7,0
2689,"['planar']","[1]","['atribuir', 'atribuir', 'circular', 'enderecar', 'imagem', 'sequer', 'usuario']","[2, 2, 1, 1, 1, 1, 1]",1,7,8,0
2693,"['circulacao', 'estrategico', 'realizacao', 'saudar', 'sigla', 'suspeito', 'vigilancia']","[1, 1, 1, 1, 1, 1, 1]","['circular', 'desmentir']","[1, 1]",7,2,9,0
2695,"[]","[]","['camiseta', 'circular', 'compartilhar', 'compartilhar', 'imagem', 'soltura']","[1, 1, 2, 2, 1, 1]",0,6,6,0
2698,"['adotada', 'propagacao']","[1, 1]","['compartilhar', 'fotografia', 'imagem', 'legendar', 'reverso']","[1, 1, 1, 1, 1]",2,5,7,0
2699,"[]","[]","['desgracar', 'gleisi', 'gleisi', 'gleisi', 'vc', 'verdadeiro']","[1, 3, 3, 3, 1, 1]",0,6,6,0
2701,"[]","[]","['equador', 'equador', 'equador', 'equador', 'equador']","[5, 5, 5, 5, 5]",0,5,5,0
2703,"['positivar', 'positivar']","[2, 2]","[]","[]",2,0,2,0
2705,"[]","[]","[]","[]",0,0,0,0
2706,"['dificuldad', 'saudar', 'suportar']","[1, 1, 1]","['carbono', 'carbono', 'circular', 'dioxido', 'dioxido', 'humanar', 'imagem']","[2, 2, 1, 2, 2, 1, 1]",3,7,10,0
2708,"['especifico', 'funcionamento', 'infectar', 'mantido', 'preparacao', 'transferir', 'ufrj']","[1, 1, 1, 1, 1, 1, 1]","['circular', 'manipulacao']","[1, 1]",7,2,9,0
2709,"['arrecadacao', 'arrecadacao', 'destinar', 'previsao', 'resolucao', 'resolucao']","[2, 2, 1, 1, 2, 2]","['circular', 'inscricao', 'mencao']","[1, 1, 1]",6,3,9,0
2710,"['saudar']","[1]","['circular', 'compartilhar', 'desmentir']","[1, 1, 1]",1,3,4,0
2712,"['deteccao']","[1]","['circular', 'fraudar']","[1, 1]",1,2,3,0
2714,"['domingo', 'integrant', 'propagacao']","[1, 1, 1]","['circular', 'imagem', 'legendar', 'protestar', 'protestar']","[1, 1, 1, 2, 2]",3,5,8,0
2716,"['conservacao', 'instituto', 'pastar']","[1, 1, 1]","['incendio']","[1]",3,1,4,0
2717,"['anvisa', 'anvisa', 'decisao', 'importacao', 'posicionamento', 'sputnik']","[2, 2, 1, 1, 1, 1]","['atribuir']","[1]",6,1,7,0
2719,"['converso', 'infectar', 'internar', 'realizacao', 'saudar']","[1, 1, 1, 1, 1]","['circular', 'circular', 'imagem', 'legendar']","[2, 2, 1, 1]",5,4,9,0
2721,"[]","[]","['descricao']","[1]",0,1,1,0
2724,"['projeco']","[1]","['circular', 'circular', 'legendar', 'legendar']","[2, 2, 2, 2]",1,4,5,0
2726,"[]","[]","['botao', 'camiseta', 'camiseta', 'camiseta', 'camiseta', 'camiseta', 'camiseta', 'clicar', 'compartilhar', 'compartilhar', 'compartilhar', 'enderecar', 'questionario', 'selecionar']","[1, 6, 6, 6, 6, 6, 6, 1, 3, 3, 3, 1, 1, 1]",0,14,14,0
2728,"['exministro', 'exministro', 'justicar']","[2, 2, 1]","['atribuir', 'circular', 'falsar', 'usuario', 'usuario', 'verificacao']","[1, 1, 1, 2, 2, 1]",3,6,9,0
2729,"['necessario', 'orientacao', 'pastar', 'propagacao', 'saudar']","[1, 1, 1, 1, 1]","['circular', 'compartilhar', 'compartilhar']","[1, 2, 2]",5,3,8,0
2730,"[]","[]","['indignar']","[1]",0,1,1,0
2731,"[]","[]","['carbono', 'dioxido', 'humanar']","[1, 1, 1]",0,3,3,0
2733,"['quarentenar']","[1]","[]","[]",1,0,1,0
2737,"['obtido', 'ritmar']","[1, 1]","['capturar', 'compartilhar', 'gravacao', 'gravacao', 'legendar', 'postagen', 'reverso', 'visualizacao']","[1, 1, 2, 2, 1, 1, 1, 1]",2,8,10,0
2741,"[]","[]","['compartilhar']","[1]",0,1,1,0
2745,"['rocha']","[1]","['casamentar', 'parir', 'segundar']","[1, 1, 1]",1,3,4,0
2747,"[]","[]","['espalhar', 'quinzena']","[1, 1]",0,2,2,0
2750,"['autoridad', 'epidemiar', 'infectar', 'isolar']","[1, 1, 1, 1]","[]","[]",4,0,4,0
2756,"[]","[]","['espalhar']","[1]",0,1,1,0
2757,"['observar']","[1]","['vc', 'vc', 'verdadeiro']","[2, 2, 1]",1,3,4,0
2760,"['bolsonarista']","[1]","['agredir', 'facada', 'imagem']","[1, 1, 1]",1,3,4,0
2761,"['carat']","[1]","['basto', 'nasal']","[1, 1]",1,2,3,0
2762,"['calamidad', 'calamidad', 'fronteiro', 'fronteiro']","[2, 2, 2, 2]","[]","[]",4,0,4,0
2765,"['domingo']","[1]","['desligar']","[1]",1,1,2,0
2766,"[]","[]","['basto', 'compartilhar', 'compartilhar', 'ganhar', 'ganhar', 'preencher']","[1, 2, 2, 2, 2, 1]",0,6,6,0
2767,"['economia', 'escalar', 'quarentenar']","[1, 1, 1]","[]","[]",3,0,3,0
2768,"['acumular', 'acumular', 'avancar', 'circulacao', 'contagioso', 'economia', 'economia', 'especialment', 'estagio', 'infectar', 'isolar', 'liderar', 'obtido', 'possibilidad', 'possibilidad', 'preservar', 'pulmonar', 'recurso', 'regiao', 'respiratorio', 'risco', 'sancao', 'saudar']","[2, 2, 1, 1, 1, 2, 2, 1, 1, 1, 1, 1, 1, 2, 2, 1, 1, 1, 1, 1, 1, 1, 1]","['espalhar', 'parir']","[1, 1]",23,2,25,0
2769,"['globonew', 'sabado']","[1, 1]","['boatar', 'checar', 'circular', 'manchet']","[1, 1, 1, 1]",2,4,6,0
2773,"['infectar']","[1]","['imagem', 'pego']","[1, 1]",1,2,3,0
2774,"['constatar', 'coordenar', 'depoimento', 'necessario', 'painel']","[1, 1, 1, 1, 1]","['acidentar', 'motorista', 'motorista']","[1, 2, 2]",5,3,8,0
2775,"['domingo']","[1]","['assaltar', 'gasolina', 'gasolina', 'gasolina', 'gasolina', 'gasolina', 'gasolina', 'menino', 'menino']","[1, 6, 6, 6, 6, 6, 6, 2, 2]",1,9,10,0
2776,"['dosar', 'investigacao']","[1, 1]","['assassinar', 'cobaia']","[1, 1]",2,2,4,0
2779,"['gabinet', 'gabinet']","[2, 2]","['parir', 'parir', 'realment']","[2, 2, 1]",2,3,5,0
2781,"['conservacao', 'expansao', 'instituto', 'pastar', 'recurso']","[1, 1, 1, 1, 1]","['circular', 'imagem', 'incendio', 'incendio', 'postagen']","[1, 1, 2, 2, 1]",5,5,10,0
2782,"['atrair', 'justicar', 'parceria']","[1, 1, 1]","['arquivar', 'atribuir', 'parir', 'pelar', 'quantum']","[1, 1, 1, 1, 1]",3,5,8,0
2783,"['avancar']","[1]","['arquivar', 'circular', 'falsar', 'menino']","[1, 1, 1, 1]",1,4,5,0
2787,"['consequencia', 'destinar', 'interferencia', 'piorar', 'primario', 'vigilancia']","[1, 1, 1, 1, 1, 1]","['fraudar']","[1]",6,1,7,0
2788,"[]","[]","['compartilhar', 'ganhar', 'quinzena']","[1, 1, 1]",0,3,3,0
2792,"['argumentar']","[1]","['amplament', 'compartilhar', 'indignar', 'pelar', 'pelar']","[1, 1, 1, 2, 2]",1,5,6,0
2793,"[]","[]","['arvor', 'circular', 'ilustrar', 'imagem', 'imagem', 'imagem', 'imagem', 'imagem', 'logotipo', 'reverso']","[1, 1, 1, 5, 5, 5, 5, 5, 1, 1]",0,10,10,0
2794,"[]","[]","['assassinar', 'assassinar', 'lixar', 'lixar', 'parir']","[2, 2, 2, 2, 1]",0,5,5,0
2796,"[]","[]","['arquivar', 'arquivar', 'disseminar', 'pelar']","[2, 2, 1, 1]",0,4,4,0
2799,"[]","[]","['compartilhar']","[1]",0,1,1,0
2805,"['supremo']","[1]","['mesario']","[1]",1,1,2,0
2806,"['palacio', 'planalto']","[1, 1]","['circular']","[1]",2,1,3,0
2808,"['barroso', 'justicar', 'necessidad']","[1, 1, 1]","['fraudar', 'realment']","[1, 1]",3,2,5,0
2809,"['biliao']","[1]","['compartilhar', 'espalhar']","[1, 1]",1,2,3,0
2810,"['associacao', 'companhia', 'concessionario', 'fornecimento', 'manutencao', 'sabado']","[1, 1, 1, 1, 1, 1]","['circular', 'desmentir', 'libertador']","[1, 1, 1]",6,3,9,0
2811,"['esquema', 'estatistico', 'estatistico', 'saudar']","[1, 2, 2, 1]","['dorio']","[1]",4,1,5,0
2812,"['barroso', 'constatar', 'dificuldad', 'justicar', 'ministrar', 'ministrar']","[1, 1, 1, 1, 2, 2]","['enganar', 'enganar', 'narrativo', 'parir', 'parir']","[2, 2, 1, 2, 2]",6,5,11,0
2816,"[]","[]","[]","[]",0,0,0,0
2819,"['afp', 'afp', 'companhia', 'discussao', 'espanha', 'viagem']","[2, 2, 1, 1, 1, 1]","['compartilhar', 'compartilhar', 'idioma', 'parir', 'pelar', 'sobrar', 'usuario', 'vezar']","[2, 2, 1, 1, 1, 1, 1, 1]",6,8,14,0
2821,"['andrea', 'henriqu', 'quarentenar']","[1, 1, 1]","['ganhar', 'humanar', 'sobrar', 'sobrar', 'sobrar']","[1, 1, 3, 3, 3]",3,5,8,0
2826,"['ambientar', 'congresso', 'decisao', 'destacar', 'impulsionar']","[1, 1, 1, 1, 1]","[]","[]",5,0,5,0
2829,"[]","[]","['circular', 'circular', 'ilustrar', 'imagem', 'imagem', 'imagem', 'interaco']","[2, 2, 1, 3, 3, 3, 1]",0,7,7,0
2832,"[]","[]","['espalhar', 'imagem', 'quinzena']","[1, 1, 1]",0,3,3,0
2835,"['conflito', 'henriqu']","[1, 1]","['menino']","[1]",2,1,3,0
2837,"['disseminacao', 'estimativo']","[1, 1]","['circular', 'imagem', 'implantar']","[1, 1, 1]",2,3,5,0
2839,"['arrecadar', 'associacao', 'destinar', 'iniciativo', 'regiao']","[1, 1, 1, 1, 1]","['imenso', 'libertador', 'nordestino']","[1, 1, 1]",5,3,8,0
2840,"['previsto']","[1]","[]","[]",1,0,1,0
2841,"[]","[]","['casamentar', 'pelar', 'sobrar']","[1, 1, 1]",0,3,3,0
2845,"['augusto', 'heleno', 'liderar', 'ministrar']","[1, 1, 1, 1]","['circular', 'descricao', 'falsar', 'imagem', 'legendar']","[1, 1, 1, 1, 1]",4,5,9,0
2846,"['liderar']","[1]","['circular']","[1]",1,1,2,0
2848,"['funcao']","[1]","[]","[]",1,0,1,0
2850,"['metropolitano', 'regiao']","[1, 1]","['barragem', 'circular', 'postagen', 'rompimento', 'usuario']","[1, 1, 1, 1, 1]",2,5,7,0
2851,"['saudar']","[1]","[]","[]",1,0,1,0
2852,"['primario']","[1]","[]","[]",1,0,1,0
2854,"['alcolumbr', 'alcolumbr', 'alcolumbr', 'gabinet', 'gabinet', 'investigacao', 'palacio', 'palacio', 'planar', 'republico']","[3, 3, 3, 2, 2, 1, 2, 2, 1, 1]","['abortar', 'compartilhar', 'espalhar', 'implantar', 'invadir', 'mentiroso', 'vazar']","[1, 1, 1, 1, 1, 1, 1]",10,7,17,0
2855,"['aurelio', 'aurelio']","[2, 2]","['soltar', 'soltar']","[2, 2]",2,2,4,0
2857,"[]","[]","['disseminar', 'fraudar', 'ganhar']","[1, 1, 1]",0,3,3,0
2858,"[]","[]","[]","[]",0,0,0,0
2859,"['disseminacao', 'edson', 'fachin', 'infectar', 'ministrar', 'normalment', 'saudar', 'supremo']","[1, 1, 1, 1, 1, 1, 1, 1]","['boatar', 'checar', 'espalhar', 'parir', 'pelar', 'pelar', 'pelar']","[1, 1, 1, 1, 3, 3, 3]",8,7,15,0
2861,"[]","[]","[]","[]",0,0,0,0
2863,"[]","[]","[]","[]",0,0,0,0
2864,"[]","[]","[]","[]",0,0,0,0
2865,"['ambito', 'atuacao', 'lavagem', 'passageiro']","[1, 1, 1, 1]","['capturar', 'circular', 'compartilhar', 'espalhar', 'gravacao', 'intitular', 'legendar', 'pelar', 'reverso', 'vezar', 'visualizar']","[1, 1, 1, 1, 1, 1, 1, 1, 1, 1, 1]",4,11,15,0
2866,"['plano']","[1]","['vazar', 'vazar']","[2, 2]",1,2,3,0
2871,"['machadar']","[1]","[]","[]",1,0,1,0
2873,"['afastamento', 'prescricao', 'saudar', 'sindicato']","[1, 1, 1, 1]","['circular', 'imagem']","[1, 1]",4,2,6,0
2879,"['restritivo']","[1]","['circular', 'imagem', 'verdadeiro']","[1, 1, 1]",1,3,4,0
2880,"['decisao', 'decisao', 'decisao', 'resistencia']","[3, 3, 3, 1]","['circular', 'soltura', 'soltura']","[1, 2, 2]",4,3,7,0
2883,"[]","[]","['dorio', 'manipular', 'supostament']","[1, 1, 1]",0,3,3,0
2884,"[]","[]","[]","[]",0,0,0,0
2885,"[]","[]","[]","[]",0,0,0,0
2888,"['aprovacao', 'emendar', 'necessidad', 'necessidad', 'proposto']","[1, 1, 2, 2, 1]","[]","[]",5,0,5,0
2889,"[]","[]","[]","[]",0,0,0,0
2890,"['alteracao', 'equipamento', 'respiratorio']","[1, 1, 1]","['misturar', 'realment']","[1, 1]",3,2,5,0
2891,"[]","[]","['arquivar', 'usuario', 'visualizacao']","[1, 1, 1]",0,3,3,0
2893,"['andrew']","[1]","['compartilhar', 'verdadeiro']","[1, 1]",1,2,3,0
2894,"[]","[]","['versao']","[1]",0,1,1,0
2895,"[]","[]","['checar']","[1]",0,1,1,0
2896,"['ministrar', 'ministrar', 'ministrar']","[3, 3, 3]","['socialismo', 'socialismo', 'socialismo']","[3, 3, 3]",3,3,6,0
2897,"['investigacao']","[1]","['assassinar', 'circular', 'imagem', 'legendar', 'motorista', 'sequer']","[1, 1, 1, 1, 1, 1]",1,6,7,0
2900,"['converso', 'decorrent', 'defendido', 'posicionamento', 'posicionamento', 'possibilidad', 'pratico']","[1, 1, 1, 2, 2, 1, 1]","['enganoso']","[1]",7,1,8,0
2902,"[]","[]","['padrar', 'verdadeiro']","[1, 1]",0,2,2,0
2903,"['adversario', 'imunizacao', 'saudar']","[1, 1, 1]","['compartilhar', 'gravacao', 'parir', 'pelar', 'pelar', 'sobrar']","[1, 1, 1, 2, 2, 1]",3,6,9,0
2904,"['avancar']","[1]","['circular', 'descricao', 'enderecar', 'enderecar', 'falsar', 'verificar']","[1, 1, 2, 2, 1, 1]",1,6,7,0
2905,"['congresso', 'congresso', 'privilegiar', 'regrar', 'supremo']","[2, 2, 1, 1, 1]","['compartilhar', 'telejorn']","[1, 1]",5,2,7,0
2906,"['anuncio', 'economia', 'ministrar', 'reabrir', 'teich']","[1, 1, 1, 1, 1]","[]","[]",5,0,5,0
2911,"['reforcar']","[1]","['atribuir', 'cartaz', 'cartaz', 'circular', 'lixar']","[1, 2, 2, 1, 1]",1,5,6,0
2912,"['acordo', 'acordo', 'ambientar', 'ambientar', 'ambientar', 'autoridad', 'cupula', 'cupula', 'desenvolvimento', 'expectativa', 'expectativa', 'mudanca', 'necessario', 'necessario', 'reducao', 'regiao', 'significativo', 'significativo']","[2, 2, 3, 3, 3, 1, 2, 2, 1, 2, 2, 1, 2, 2, 1, 1, 2, 2]","['catolico']","[1]",18,1,19,0
2914,"[]","[]","['fraudar', 'fraudar', 'fraudar']","[3, 3, 3]",0,3,3,0
2915,"['decisao', 'especifico', 'posturar']","[1, 1, 1]","['amplament', 'compartilhar', 'imagem', 'realment', 'usuario']","[1, 1, 1, 1, 1]",3,5,8,0
2917,"['epidemiar', 'orientacao', 'preocupacao', 'propagacao', 'saudar']","[1, 1, 1, 1, 1]","[]","[]",5,0,5,0
2918,"[]","[]","['ganhar', 'imagem', 'replicar', 'transposicao', 'usuario', 'versao']","[1, 1, 1, 1, 1, 1]",0,6,6,0
2919,"[]","[]","['checar', 'numericament']","[1, 1]",0,2,2,0
2920,"[]","[]","['checar', 'numericament']","[1, 1]",0,2,2,0
2921,"[]","[]","['checar', 'numericament']","[1, 1]",0,2,2,0
2922,"[]","[]","['checar', 'disfarcar', 'numericament', 'parir']","[1, 1, 1, 1]",0,4,4,0
2923,"['orientacao']","[1]","['checar', 'numericament', 'parir']","[1, 1, 1]",1,3,4,0
2924,"['rocha', 'subordinar', 'subordinar', 'subordinar']","[1, 3, 3, 3]","['checar', 'numericament']","[1, 1]",4,2,6,0
2925,"['rocha']","[1]","['checar', 'numericament', 'parir']","[1, 1, 1]",1,3,4,0
2926,"[]","[]","['checar', 'inocentar', 'inocentar', 'numericament']","[1, 2, 2, 1]",0,4,4,0
2927,"['absoluto']","[1]","['checar', 'numericament']","[1, 1]",1,2,3,0
2933,"['afp', 'extensao', 'reuter']","[1, 1, 1]","['checar', 'circular', 'fotografia', 'fotografo', 'imagem', 'imagem', 'parir', 'parir', 'pelar', 'protestar', 'reverso', 'usuario', 'usuario']","[1, 1, 1, 1, 2, 2, 2, 2, 1, 1, 1, 2, 2]",3,13,16,0
2934,"['ambientar', 'colombio', 'desmatamento', 'desmatamento', 'regiao']","[1, 1, 2, 2, 1]","['gravacao', 'parir']","[1, 1]",5,2,7,0
2938,"[]","[]","['abusar', 'compartilhar', 'imagem', 'legendar', 'postagen', 'replicar']","[1, 1, 1, 1, 1, 1]",0,6,6,0
2940,"[]","[]","[]","[]",0,0,0,0
2942,"['adicionar', 'consecutivo', 'eventualment', 'fundamentar']","[1, 1, 1, 1]","['circular', 'misturar', 'suco']","[1, 1, 1]",4,3,7,0
2946,"[]","[]","['compartilhar']","[1]",0,1,1,0
2947,"[]","[]","['circular', 'imagem']","[1, 1]",0,2,2,0
2951,"['psicologo', 'temporariament']","[1, 1]","['circular', 'circular', 'wagner']","[2, 2, 1]",2,3,5,0
2952,"['situacao']","[1]","['compartilhar', 'desligar', 'espalhar', 'idioma', 'legendar', 'replicar', 'usuario']","[1, 1, 1, 1, 1, 1, 1]",1,7,8,0
2953,"['desenvolvimento', 'escalar', 'previsto', 'tendencia']","[1, 1, 1, 1]","['verdadeiro']","[1]",4,1,5,0
2955,"['carat', 'celso', 'celso', 'celso', 'condicao', 'conduta', 'magistrado', 'mello', 'mello', 'mello', 'ministrar', 'periodo', 'periodo', 'saudar', 'supremo', 'supremo']","[1, 3, 3, 3, 1, 1, 1, 3, 3, 3, 1, 2, 2, 1, 2, 2]","[]","[]",16,0,16,0
2957,"['epicentro', 'epidemiar', 'epidemiar', 'respiratorio', 'ufrj']","[1, 2, 2, 1, 1]","['circular', 'legendar', 'patrocinador']","[1, 1, 1]",5,3,8,0
2958,"['barroso', 'conduta', 'diminuicao', 'individuar', 'necessidad', 'privar']","[1, 1, 1, 1, 1, 1]","['abortar', 'anoso', 'compartilhar', 'dorio', 'realment', 'verdadeiro']","[1, 1, 1, 1, 1, 1]",6,6,12,0
2960,"['quarentenar']","[1]","[]","[]",1,0,1,0
2963,"['periodo']","[1]","[]","[]",1,0,1,0
2966,"['destacar', 'marilia', 'sessao']","[1, 1, 1]","['biblia', 'biblia', 'cristao', 'estampar', 'verificar']","[2, 2, 1, 1, 1]",3,5,8,0
2967,"['desenvolvimento', 'suportar', 'treinamento']","[1, 1, 1]","['secreto']","[1]",3,1,4,0
2968,"['subir']","[1]","['padrar', 'padrar']","[2, 2]",1,2,3,0
2969,"['internar', 'taxar']","[1, 1]","[]","[]",2,0,2,0
2971,"['carla']","[1]","['compartilhar', 'verdadeiro']","[1, 1]",1,2,3,0
2972,"[]","[]","['espalhar', 'quinzena']","[1, 1]",0,2,2,0
2974,"['concreto', 'punicao']","[1, 1]","['barragem', 'barragem', 'barragem', 'barragem', 'barragem', 'maldiz', 'rompimento', 'transposicao']","[5, 5, 5, 5, 5, 1, 1, 1]",2,8,10,0
2976,"['boletim', 'funcionamento', 'internar', 'saudar']","[1, 1, 1, 1]","['circular', 'filmar', 'invadir', 'legendar']","[1, 1, 1, 1]",4,4,8,0
2977,"[]","[]","['segundar']","[1]",0,1,1,0
2979,"['ambientar', 'autoridad', 'saudar']","[1, 1, 1]","[]","[]",3,0,3,0
2983,"[]","[]","['arvor']","[1]",0,1,1,0
2984,"['diplomata']","[1]","['acidentar', 'venezuelano']","[1, 1]",1,2,3,0
2985,"['biliao', 'biliao', 'biliao', 'biliao', 'biliao', 'biliao', 'despesa', 'destinar', 'destinar', 'infraestrutura', 'parcelar', 'pastar']","[6, 6, 6, 6, 6, 6, 1, 2, 2, 1, 1, 1]","['circular', 'protestar', 'verificar']","[1, 1, 1]",12,3,15,0
2987,"['capitar', 'decorrencia', 'demandar', 'sabado']","[1, 1, 1, 1]","['circular', 'compartilhar', 'legendar', 'parir', 'pelar', 'protestar']","[1, 1, 1, 1, 1, 1]",4,6,10,0
2990,"['cardiologista', 'conformar', 'imunizacao']","[1, 1, 1]","['amplament']","[1]",3,1,4,0
2991,"['decisao', 'decisao', 'edson', 'fluminens', 'fundacao', 'instituto', 'ministrar', 'oswaldo', 'quarentenar', 'quarentenar']","[2, 2, 1, 1, 1, 1, 1, 1, 2, 2]","['circular', 'legendar', 'sequer', 'trafico']","[1, 1, 1, 1]",10,4,14,0
2993,"['autoridad', 'federar', 'privilegiar', 'saudar']","[1, 1, 1, 1]","['indignacao', 'verdadeiro']","[1, 1]",4,2,6,0
2998,"['autorizacao', 'boletim', 'quadro']","[1, 1, 1]","['cbn', 'circular']","[1, 1]",3,2,5,0
2999,"['aurelio', 'ribeiro']","[1, 1]","[]","[]",2,0,2,0
3001,"[]","[]","['compartilhar', 'inocentar']","[1, 1]",0,2,2,0
3003,"[]","[]","['socialismo', 'socialismo', 'trafico', 'vc', 'vc']","[2, 2, 1, 2, 2]",0,5,5,0
3004,"[]","[]","[]","[]",0,0,0,0
3009,"[]","[]","['espalhar', 'quinzena', 'telejorn']","[1, 1, 1]",0,3,3,0
3012,"[]","[]","['transposicao']","[1]",0,1,1,0
3013,"['destinar', 'infeccioso', 'infectar', 'justificativo', 'mutacao', 'mutacao', 'preocupacao', 'respiratorio', 'saudar', 'suportar']","[1, 1, 1, 1, 2, 2, 1, 1, 1, 1]","['desgracar', 'enganir', 'escravo', 'parir', 'parir', 'parir', 'parir', 'terrorismo', 'terrorismo', 'vc', 'vc', 'vc', 'vc', 'vc']","[1, 1, 1, 4, 4, 4, 4, 2, 2, 5, 5, 5, 5, 5]",10,14,24,0
3014,"['conformar', 'domingo', 'integrant', 'sabado']","[1, 1, 1, 1]","['atirar', 'circular', 'gleis', 'gleisi', 'legendar']","[1, 1, 1, 1, 1]",4,5,9,0
3017,"['arrecadacao', 'regiao', 'regrar', 'regrar', 'situacao', 'situacao']","[1, 1, 2, 2, 2, 2]","[]","[]",6,0,6,0
3019,"['academiar', 'dosar', 'equivalent', 'observar', 'precisao', 'prever']","[1, 1, 1, 1, 1, 1]","['filmar', 'imagem', 'imagem', 'imagem', 'lembres', 'menino', 'verdadeiro']","[1, 3, 3, 3, 1, 1, 1]",6,7,13,0
3022,"['inicialment']","[1]","['circular', 'disseminar', 'parir', 'parir', 'versao']","[1, 1, 2, 2, 1]",1,5,6,0
3023,"[]","[]","['amplament', 'compartilhar', 'espalhar', 'inscricao', 'quinzena']","[1, 1, 1, 1, 1]",0,5,5,0
3024,"['descumprimento', 'regiao']","[1, 1]","['agredir', 'circular', 'desmentir']","[1, 1, 1]",2,3,5,0
3026,"['colegio', 'recurso', 'supremo', 'supremo']","[1, 1, 2, 2]","['compartilhar', 'compartilhar', 'compartilhar', 'imagem', 'postagen', 'usuario']","[3, 3, 3, 1, 1, 1]",4,6,10,0
3027,"['desenvolvido', 'fundamentar', 'saudar', 'ufrj']","[1, 1, 1, 1]","['circular', 'compartilhar', 'usuario']","[1, 1, 1]",4,3,7,0
3028,"['constituicao', 'decisao', 'supremo']","[1, 1, 1]","[]","[]",3,0,3,0
3029,"[]","[]","['arquivar']","[1]",0,1,1,0
3030,"[]","[]","['parir', 'pelar']","[1, 1]",0,2,2,0
3031,"[]","[]","['botao', 'clicar', 'compartilhar', 'compartilhar', 'compartilhar', 'compartilhar', 'implantar']","[1, 1, 4, 4, 4, 4, 1]",0,7,7,0
3032,"[]","[]","['circular', 'imagem', 'quinzena']","[1, 1, 1]",0,3,3,0
3035,"['domingo']","[1]","['circular', 'circular', 'renunciar']","[2, 2, 1]",1,3,4,0
3037,"['afetado', 'temporario']","[1, 1]","['circular', 'usuario']","[1, 1]",2,2,4,0
3040,"['concessionario', 'consultoria', 'equipamento', 'equipamento', 'equipamento', 'irregularidad', 'levantamento', 'recurso']","[1, 1, 3, 3, 3, 1, 1, 1]","['capturar', 'circular', 'circular', 'imagem']","[1, 2, 2, 1]",8,4,12,0
3041,"[]","[]","['escutar', 'escutar', 'vc']","[2, 2, 1]",0,3,3,0
3042,"['ministrar', 'ministrar', 'recurso', 'suspensao']","[2, 2, 1, 1]","[]","[]",4,0,4,0
3045,"[]","[]","['pelar']","[1]",0,1,1,0
3048,"['afp', 'anvisa', 'anvisa', 'anvisa', 'decorrencia', 'prioritario', 'saudar', 'saudar', 'vigilancia']","[1, 3, 3, 3, 1, 1, 2, 2, 1]","['checar', 'compartilhar', 'compartilhar', 'imagem', 'imagem', 'postagen', 'realment']","[1, 2, 2, 2, 2, 1, 1]",9,7,16,0
3049,"['treinamento']","[1]","['intitular', 'pelar']","[1, 1]",1,2,3,0
3051,"['internar']","[1]","[]","[]",1,0,1,0
3052,"['deteccao']","[1]","['compartilhar', 'imagem', 'vc']","[1, 1, 1]",1,3,4,0
3054,"['atrair', 'expectativa', 'organizador', 'publicoa']","[1, 1, 1, 1]","[]","[]",4,0,4,0
3055,"[]","[]","['compartilhar', 'pelar', 'segundar']","[1, 1, 1]",0,3,3,0
3056,"['bolsonarista', 'converso', 'decisao', 'decisao', 'flavio', 'gabinet', 'republico']","[1, 1, 2, 2, 1, 1, 1]","['ganhar']","[1]",7,1,8,0
3059,"['infectar', 'saudar']","[1, 1]","['enganir', 'pelar', 'postagen', 'segundar', 'vezar']","[1, 1, 1, 1, 1]",2,5,7,0
3060,"[]","[]","['expulsar']","[1]",0,1,1,0
3065,"[]","[]","['compartilhar', 'idioma', 'interaco']","[1, 1, 1]",0,3,3,0
3066,"[]","[]","['legendar', 'usuario']","[1, 1]",0,2,2,0
3071,"[]","[]","[]","[]",0,0,0,0
3073,"[]","[]","['basto', 'circular', 'rosario', 'rosario']","[1, 1, 2, 2]",0,4,4,0
3075,"['comportamento', 'mudanca', 'periodo']","[1, 1, 1]","['ilustrar', 'usuario']","[1, 1]",3,2,5,0
3077,"['adotada', 'apurar', 'conduta', 'inquerito', 'inquerito', 'instaurar', 'investigacao', 'justicar', 'machadar', 'regrar']","[1, 1, 1, 2, 2, 1, 1, 1, 1, 1]","['agredir', 'agredir', 'captar', 'circular', 'gravacao', 'imagem', 'imagem', 'postagen']","[2, 2, 1, 1, 1, 2, 2, 1]",10,8,18,0
3078,"['carat', 'diagnosticar', 'internar', 'pulmonar']","[1, 1, 1, 1]","['circular', 'fotografia', 'imagem', 'imagem', 'legendar', 'tampouco']","[1, 1, 2, 2, 1, 1]",4,6,10,0
3080,"[]","[]","['catolico', 'imagem']","[1, 1]",0,2,2,0
3081,"['conflito', 'respostar']","[1, 1]","['circular', 'compartilhar', 'estranhar', 'filmar', 'imagem', 'imagem', 'imagem', 'imagem']","[1, 1, 1, 1, 4, 4, 4, 4]",2,8,10,0
3083,"['anvisa', 'biliao', 'entregu', 'fundacao', 'interferencia']","[1, 1, 1, 1, 1]","['parabem', 'realment']","[1, 1]",5,2,7,0
3084,"[]","[]","['compartilhar', 'inscricao']","[1, 1]",0,2,2,0
3086,"['turma']","[1]","['clicar', 'compartilhar', 'ganhar', 'ganhar']","[1, 1, 2, 2]",1,4,5,0
3087,"['saudar', 'ufrj']","[1, 1]","[]","[]",2,0,2,0
3088,"['humanitario', 'justicar', 'ministrar', 'ministrar', 'palacio', 'planalto']","[1, 1, 2, 2, 1, 1]","['boatar', 'circular', 'cocaina', 'espalhar']","[1, 1, 1, 1]",6,4,10,0
3090,"['afp', 'europeu', 'regiao']","[1, 1, 1]","['checagem', 'compartilhar', 'fotografia', 'imagem', 'imagem', 'legendar', 'postagen', 'reverso', 'viralizada']","[1, 1, 1, 2, 2, 1, 1, 1, 1]",3,9,12,0
3091,"['acumular', 'agravar', 'complicacao', 'desenvolvimento', 'epidemiar', 'particularment', 'prescricao']","[1, 1, 1, 1, 1, 1, 1]","['parir', 'parir', 'parir', 'parir', 'pelar', 'pelar', 'pelar', 'pelar', 'supostament', 'usuario']","[4, 4, 4, 4, 4, 4, 4, 4, 1, 1]",7,10,17,0
3092,"['mergulhar', 'quarentenar']","[1, 1]","['circular', 'compartilhar', 'descricao', 'imagem', 'imagem', 'postagen', 'postagen', 'visualizacao']","[1, 1, 1, 2, 2, 2, 2, 1]",2,8,10,0
3093,"['biliao', 'observacao', 'pagamento', 'reuniao', 'vigilancia', 'visitant']","[1, 1, 1, 1, 1, 1]","[]","[]",6,0,6,0
3094,"['mergulhar']","[1]","['menino']","[1]",1,1,2,0
3096,"['palacio']","[1]","['parir', 'parir', 'pelar']","[2, 2, 1]",1,3,4,0
3098,"[]","[]","['espalhar', 'imagem', 'tumulo']","[1, 1, 1]",0,3,3,0
3099,"['associacao', 'dosar']","[1, 1]","['compartilhar', 'replicar']","[1, 1]",2,2,4,0
3100,"[]","[]","['compartilhar', 'manchet', 'motorista', 'quinzena']","[1, 1, 1, 1]",0,4,4,0
3101,"['apurar', 'argumentar', 'calheiro', 'calheiro', 'decisao', 'distrito', 'improbidad', 'justicar', 'obtido', 'segredar', 'sentenca', 'sentenca', 'supremo', 'suspensao', 'varar', 'varar', 'varar']","[1, 1, 2, 2, 1, 1, 1, 1, 1, 1, 2, 2, 1, 1, 3, 3, 3]","[]","[]",17,0,17,0
3104,"[]","[]","[]","[]",0,0,0,0
3106,"['decisao', 'prever']","[1, 1]","['circular', 'protestar']","[1, 1]",2,2,4,0
3107,"['portavoz']","[1]","['verificar']","[1]",1,1,2,0
3112,"[]","[]","['filmar']","[1]",0,1,1,0
3114,"[]","[]","[]","[]",0,0,0,0
3117,"['estagio']","[1]","['amplament', 'circular']","[1, 1]",1,2,3,0
3118,"['autorizacao', 'biliao', 'desenvolvido', 'desenvolvimento', 'desenvolvimento', 'saudar']","[1, 1, 1, 2, 2, 1]","['replicar', 'verificar']","[1, 1]",6,2,8,0
3128,"['associacao', 'quarentenar', 'substituicao']","[1, 1, 1]","['atribuir', 'atribuir', 'circular', 'imagem', 'sapato']","[2, 2, 1, 1, 1]",3,5,8,0
3133,"['ministrar']","[1]","['compartilhar', 'espalhar', 'humanar']","[1, 1, 1]",1,3,4,0
3134,"['planar', 'republico']","[1, 1]","['implantar', 'implantar', 'soldar']","[2, 2, 1]",2,3,5,0
3135,"['depoimento', 'integrant', 'periferia']","[1, 1, 1]","['circular', 'imagem', 'imagem']","[1, 2, 2]",3,3,6,0
3136,"['privar', 'regiao', 'turistico']","[1, 1, 1]","['circular']","[1]",3,1,4,0
3139,"['situacao']","[1]","['estranhar', 'vc', 'vc']","[1, 2, 2]",1,3,4,0
3142,"[]","[]","[]","[]",0,0,0,0
3143,"['prazo']","[1]","[]","[]",1,0,1,0
3145,"['processo']","[1]","[]","[]",1,0,1,0
3148,"['decorrencia', 'equipamento', 'funcionamento', 'impactar', 'pastar', 'recurso', 'recurso', 'saudar', 'saudar', 'saudar', 'saudar', 'saudar']","[1, 1, 1, 1, 1, 2, 2, 5, 5, 5, 5, 5]","['cbn', 'circular']","[1, 1]",12,2,14,0
3151,"['disseminac', 'planar', 'surtir', 'surto']","[1, 1, 1, 1]","['humanar', 'manipulacao', 'manipulacao']","[1, 2, 2]",4,3,7,0
3152,"['punicao']","[1]","['circular', 'compartilhar', 'postagen', 'realment']","[1, 1, 1, 1]",1,4,5,0
3153,"['decisao', 'domingo', 'justicar', 'martim', 'martim', 'recurso', 'regiao', 'regiao', 'rejeitar']","[1, 1, 1, 2, 2, 1, 2, 2, 1]","['circular']","[1]",9,1,10,0
3154,"['crise', 'epidemiar']","[1, 1]","['circular', 'compartilhar']","[1, 1]",2,2,4,0
3158,"['expressar', 'funcao']","[1, 1]","['sobrar']","[1]",2,1,3,0
3159,"['folhar', 'spaulo', 'supremo']","[1, 1, 1]","['atirar', 'expulsar']","[1, 1]",3,2,5,0
3162,"[]","[]","[]","[]",0,0,0,0
3164,"['infectar']","[1]","['verificar', 'verificar']","[2, 2]",1,2,3,0
3165,"['afetado', 'economia']","[1, 1]","['bonner', 'implantar', 'lixar']","[1, 1, 1]",2,3,5,0
3166,"['desempenhar', 'temporada', 'temporada']","[1, 2, 2]","['compartilhar', 'preencher', 'preencher']","[1, 2, 2]",3,3,6,0
3167,"['contemplar', 'instituto', 'parceria', 'parceria', 'quarentenar', 'quarentenar', 'souza', 'turma', 'turma', 'turma']","[1, 1, 2, 2, 2, 2, 1, 3, 3, 3]","['basto', 'ganhar', 'preencher']","[1, 1, 1]",10,3,13,0
3170,"['ambientar', 'ausencia', 'cardiologista', 'depoimento', 'depoimento', 'domingo', 'domingo', 'expectativa', 'gripezinha', 'internar', 'isolar', 'manutencao', 'pereira', 'regiao', 'rocha', 'rocha', 'rotina', 'rotina', 'rotina', 'rotina', 'saudad', 'saudad', 'taxar', 'tendencia', 'varga', 'velocidad', 'witzel', 'witzel', 'witzel']","[1, 1, 1, 2, 2, 2, 2, 1, 1, 1, 1, 1, 1, 1, 2, 2, 4, 4, 4, 4, 2, 2, 1, 1, 1, 1, 3, 3, 3]","['adorar', 'amigar', 'crer', 'crer', 'enganar', 'equador', 'equador', 'escutar', 'escutar', 'pego', 'replicar', 'vc', 'vc', 'verdadeiro']","[1, 1, 2, 2, 1, 2, 2, 2, 2, 1, 1, 2, 2, 1]",29,14,43,0
3171,"['balancar', 'espirito', 'instituto', 'instituto', 'instituto']","[1, 1, 3, 3, 3]","['circular', 'cocaina', 'imagem', 'legendar', 'lixar']","[1, 1, 1, 1, 1]",5,5,10,0
3174,"['adhanom', 'estrategia', 'tedro']","[1, 1, 1]","[]","[]",3,0,3,0
3175,"['apreensao', 'apreensao', 'apreensao', 'apreensao', 'deflagrar', 'deflagrar', 'recordar', 'recordar', 'recordar', 'taxar']","[4, 4, 4, 4, 2, 2, 3, 3, 3, 1]","['circular', 'cocaina', 'enganoso']","[1, 1, 1]",10,3,13,0
3178,"['complicacao']","[1]","['amigar']","[1]",1,1,2,0
3179,"['especializar', 'infectar', 'internar', 'internar', 'proposto', 'reuniao', 'transferir']","[1, 1, 2, 2, 1, 1, 1]","['circular']","[1]",7,1,8,0
3180,"['balancar', 'pastar', 'pastar', 'reuniao', 'rotina', 'saudar', 'segredar']","[1, 2, 2, 1, 1, 1, 1]","['enderecar']","[1]",7,1,8,0
3181,"[]","[]","[]","[]",0,0,0,0
3186,"['vigilancia']","[1]","['amigar']","[1]",1,1,2,0
3187,"['contrato', 'pagamento', 'pagamento', 'ricardo', 'ricardo', 'saudar', 'saudar', 'servidor', 'suspeito']","[1, 2, 2, 2, 2, 2, 2, 1, 1]","['parir', 'pelar', 'pelar', 'pelar', 'segundar', 'sobrar']","[1, 3, 3, 3, 1, 1]",9,6,15,0
3188,"['circulacao']","[1]","[]","[]",1,0,1,0
3190,"['desvio', 'equipamento', 'estatistico', 'investigacao', 'irregularidad', 'respirador', 'saudar', 'suspeito']","[1, 1, 1, 1, 1, 1, 1, 1]","['mentiroso', 'viralizado']","[1, 1]",8,2,10,0
3191,"[]","[]","['espalhar', 'parir']","[1, 1]",0,2,2,0
3196,"['especializar', 'manutencao', 'regiao']","[1, 1, 1]","['compartilhar', 'imagem', 'imagem', 'inscricao']","[1, 2, 2, 1]",3,4,7,0
3197,"['quedo']","[1]","['filmar', 'postagen', 'replicar', 'supostament', 'usuario']","[1, 1, 1, 1, 1]",1,5,6,0
3199,"['distrito', 'esquema', 'interlocutor', 'sessao']","[1, 1, 1, 1]","['cedula', 'circular', 'gravacao', 'imagem', 'legendar']","[1, 1, 1, 1, 1]",4,5,9,0
3200,"['alcolumbr', 'comissao', 'diretoria', 'esquema', 'exministro', 'inquerito', 'inquerito', 'inquerito', 'integrant', 'investigacao', 'journal', 'justicar', 'oficialment', 'pagamento', 'planar', 'pratico', 'presenca', 'ramagem', 'ramagem', 'reuniao', 'reuniao', 'reuniao', 'witzel']","[1, 1, 1, 1, 1, 3, 3, 3, 1, 1, 1, 1, 1, 1, 1, 1, 1, 2, 2, 3, 3, 3, 1]","['adelio', 'adelio', 'adelio', 'adelio', 'bispar', 'copiar', 'dorio', 'wagner']","[4, 4, 4, 4, 1, 1, 1, 1]",23,8,31,0
3202,"[]","[]","['disfarcar']","[1]",0,1,1,0
3204,"['sputnik']","[1]","[]","[]",1,0,1,0
3206,"['alteracao', 'consumidor', 'mudanca', 'reducao', 'significativo']","[1, 1, 1, 1, 1]","['parir', 'pelar', 'sobrar', 'verificar']","[1, 1, 1, 1]",5,4,9,0
3208,"[]","[]","['parir', 'parir']","[2, 2]",0,2,2,0
3213,"[]","[]","['amigar', 'escutar']","[1, 1]",0,2,2,0
3214,"['afastamento', 'alvaro', 'mexico']","[1, 1, 1]","['auditoria', 'circular', 'fraudar', 'imagem', 'imagem']","[1, 1, 1, 2, 2]",3,5,8,0
3217,"['ministrar']","[1]","['mentiroso', 'parir']","[1, 1]",1,2,3,0
3219,"[]","[]","[]","[]",0,0,0,0
3221,"['necessario', 'pagamento', 'parcelar', 'parcelar']","[1, 1, 2, 2]","['realment']","[1]",4,1,5,0
3223,"['inglaterra']","[1]","['catedr', 'catedr', 'cristao', 'incendio', 'incendio']","[2, 2, 1, 2, 2]",1,5,6,0
3224,"['especialment', 'forcatarefa', 'segredar']","[1, 1, 1]","['circular', 'circular', 'usuario', 'versao']","[2, 2, 1, 1]",3,4,7,0
3228,"['avancar', 'bruto', 'cenario', 'colunista', 'crescimento', 'destacar', 'expectativa', 'internar', 'perspectivo', 'pib', 'sabado']","[1, 1, 1, 1, 1, 1, 1, 1, 1, 1, 1]","[]","[]",11,0,11,0
3230,"[]","[]","['circular', 'imagem', 'imagem', 'imagem']","[1, 3, 3, 3]",0,4,4,0
3234,"['adotada', 'escalar', 'organizador', 'sabado']","[1, 1, 1, 1]","['protestar', 'verificar']","[1, 1]",4,2,6,0
3237,"['cessionario', 'comissao', 'europeu', 'instituto']","[1, 1, 1, 1]","['curioso']","[1]",4,1,5,0
3238,"['preservacao', 'recebido']","[1, 1]","[]","[]",2,0,2,0
3243,"['atuam', 'claudio', 'fabricio', 'flavio', 'flavio', 'funcao', 'investigacao', 'justicar', 'justicar', 'lavagem', 'ministrar', 'movimentacao', 'mprj', 'pslrj', 'queiroz', 'reuniao', 'subordinar']","[1, 1, 1, 2, 2, 1, 1, 2, 2, 1, 1, 1, 1, 1, 1, 1, 1]","['circular']","[1]",17,1,18,0
3245,"['henriqu', 'henriqu', 'milho']","[2, 2, 1]","['compartilhar', 'maldiz', 'parir']","[1, 1, 1]",3,3,6,0
3246,"['anvisa', 'aplicacao', 'autoridad', 'curvo', 'curvo', 'economia', 'esperancar', 'preliminar', 'recordar', 'respirador', 'respirador', 'saudar', 'sugestao', 'velocidad']","[1, 1, 1, 2, 2, 1, 1, 1, 1, 2, 2, 1, 1, 1]","['amigar', 'basto', 'cobaia', 'copiar', 'ganhar', 'instrucao', 'vc']","[1, 1, 1, 1, 1, 1, 1]",14,7,21,0
3247,"['destacar']","[1]","['acidentar']","[1]",1,1,2,0
3249,"[]","[]","['parir', 'segundar', 'sobrar']","[1, 1, 1]",0,3,3,0
3250,"['negativar', 'reforcar', 'saudar']","[1, 1, 1]","['circular', 'fingir']","[1, 1]",3,2,5,0
3251,"[]","[]","[]","[]",0,0,0,0
3253,"['oferecido']","[1]","['implantar', 'inscricao', 'inscricao']","[1, 2, 2]",1,3,4,0
3254,"[]","[]","[]","[]",0,0,0,0
3255,"['calendario', 'fase', 'periodo', 'saudar']","[1, 1, 1, 1]","[]","[]",4,0,4,0
3260,"[]","[]","['circular', 'fotografia']","[1, 1]",0,2,2,0
3262,"['adhanom', 'adhanom', 'economia', 'economia', 'economia', 'fronteiro', 'interpretar', 'michael', 'necessario', 'posicionamento', 'saudar', 'saudar', 'tedro']","[2, 2, 3, 3, 3, 1, 1, 1, 1, 1, 2, 2, 1]","['circular', 'compartilhar', 'compartilhar', 'desmentir']","[1, 2, 2, 1]",13,4,17,0
3265,"['elaborar', 'preocupacao', 'suportar']","[1, 1, 1]","['ganhar', 'incendio', 'incendio', 'incendio', 'supostament']","[1, 3, 3, 3, 1]",3,5,8,0
3266,"[]","[]","[]","[]",0,0,0,0
3268,"['cenario', 'constatar']","[1, 1]","['cbn', 'circular', 'imagem', 'imagem', 'viralizado']","[1, 1, 2, 2, 1]",2,5,7,0
3270,"[]","[]","[]","[]",0,0,0,0
3271,"['pslsp']","[1]","['assassinar', 'circular']","[1, 1]",1,2,3,0
3272,"['avancar']","[1]","['versao']","[1]",1,1,2,0
3273,"['internar', 'transferir']","[1, 1]","['espalhar']","[1]",2,1,3,0
3274,"['decorrencia']","[1]","['circular', 'compartilhar', 'sequer', 'soltar', 'verdadeiro']","[1, 1, 1, 1, 1]",1,5,6,0
3277,"[]","[]","['espalhar', 'imagem', 'quinzena']","[1, 1, 1]",0,3,3,0
3279,"['suspeito']","[1]","['circular']","[1]",1,1,2,0
3282,"['europeu']","[1]","['inscricao', 'parir', 'parir', 'parir', 'pelar', 'pelar', 'realment', 'sobrar']","[1, 3, 3, 3, 2, 2, 1, 1]",1,8,9,0
3284,"[]","[]","['atribuir']","[1]",0,1,1,0
3287,"['monitoramento']","[1]","['atribuir', 'circular', 'circular', 'desmentir', 'idioma', 'nobel', 'verificacao']","[1, 2, 2, 1, 1, 1, 1]",1,7,8,0
3288,"['client']","[1]","['filmar', 'sobrar']","[1, 1]",1,2,3,0
3289,"['interferencia']","[1]","['capturar', 'circular', 'compartilhar', 'imagem', 'imagem', 'postagen']","[1, 1, 1, 2, 2, 1]",1,6,7,0
3290,"[]","[]","['boicotar']","[1]",0,1,1,0
3292,"['fux', 'fux', 'fux', 'ministrar']","[3, 3, 3, 1]","['inocentar']","[1]",4,1,5,0
3293,"[]","[]","['checar']","[1]",0,1,1,0
3297,"['aplicacao', 'especializar', 'recebido', 'ribeiro']","[1, 1, 1, 1]","['vc']","[1]",4,1,5,0
3298,"[]","[]","['botao', 'cuspir', 'cuspir', 'espalhar', 'espalhar', 'espalhar', 'filmar', 'imagem']","[1, 2, 2, 3, 3, 3, 1, 1]",0,8,8,0
3299,"['domingo', 'sabado']","[1, 1]","['parir', 'pelar']","[1, 1]",2,2,4,0
3302,"['anticorpo', 'balancar', 'esperancar']","[1, 1, 1]","['nobel']","[1]",3,1,4,0
3303,"['gabinet', 'necessario', 'oliveira']","[1, 1, 1]","['adelio', 'adelio', 'assassinar', 'bispar', 'rosario', 'rosario']","[2, 2, 1, 1, 2, 2]",3,6,9,0
3304,"['economia', 'economia', 'saudar', 'vulneravel']","[2, 2, 1, 1]","['carrefour', 'carrefour', 'carrefour', 'carrefour', 'enfim', 'ganhar', 'manobrar', 'vc', 'vc', 'vc']","[4, 4, 4, 4, 1, 1, 1, 3, 3, 3]",4,10,14,0
3306,"['administrativo', 'aplicacao', 'atendido', 'autonomia', 'autoridad', 'calamidad', 'exercicio', 'integrant', 'internar', 'jurista', 'legislativo', 'legislativo', 'legislativo', 'orcamentaria', 'periodo', 'prazo', 'processo', 'punicao', 'republico', 'republico', 'republico', 'supremo', 'supremo']","[1, 1, 1, 1, 1, 1, 1, 1, 1, 1, 3, 3, 3, 1, 1, 1, 1, 1, 3, 3, 3, 2, 2]","['abusar', 'parabem', 'verdadeiro']","[1, 1, 1]",23,3,26,0
3309,"[]","[]","['adorar', 'espalhar', 'imagem', 'parir', 'quinzena']","[1, 1, 1, 1, 1]",0,5,5,0
3310,"['integrant', 'suspeito', 'suspeito']","[1, 2, 2]","['circular', 'imagem', 'imagem', 'legendar', 'parir', 'reverso']","[1, 2, 2, 1, 1, 1]",3,6,9,0
3311,"['celso']","[1]","['checar', 'numericament', 'parir', 'vazio']","[1, 1, 1, 1]",1,4,5,0
3312,"['celso']","[1]","['checar', 'imenso', 'numericament']","[1, 1, 1]",1,3,4,0
3313,"[]","[]","['checar', 'numericament']","[1, 1]",0,2,2,0
3314,"['atrair']","[1]","['checar', 'numericament', 'parir']","[1, 1, 1]",1,3,4,0
3315,"['biliao', 'taxar']","[1, 1]","['checar', 'numericament']","[1, 1]",2,2,4,0
3316,"[]","[]","['checar', 'numericament', 'parir']","[1, 1, 1]",0,3,3,0
3317,"['coletivo']","[1]","['checar', 'numericament']","[1, 1]",1,2,3,0
3318,"['balancar', 'biliao', 'suspeito']","[1, 1, 1]","['incendio', 'incendio', 'incendio', 'incendio', 'incendio']","[5, 5, 5, 5, 5]",3,5,8,0
3320,"['crise', 'demandar', 'impulsionar', 'plantao']","[1, 1, 1, 1]","['circular', 'compartilhar', 'imagem', 'imagem', 'imagem']","[1, 1, 3, 3, 3]",4,5,9,0
3321,"['conjuntar', 'impulsionar']","[1, 1]","['abencoar', 'amplament', 'capturar', 'circular', 'ilustrar']","[1, 1, 1, 1, 1]",2,5,7,0
3325,"['colegio']","[1]","['mesario', 'usuario']","[1, 1]",1,2,3,0
3327,"['quilometro']","[1]","['circular', 'compartilhar', 'imagem', 'imagem', 'incendio', 'incendio', 'legendar']","[1, 1, 2, 2, 2, 2, 1]",1,7,8,0
3328,"['client', 'conformar', 'disseminacao', 'epidemiar', 'exministro', 'regrar', 'regrar']","[1, 1, 1, 1, 1, 2, 2]","['compartilhar']","[1]",7,1,8,0
3330,"[]","[]","['ganhar', 'legendar', 'quinzena']","[1, 1, 1]",0,3,3,0
3331,"['campino', 'saudad', 'saudar']","[1, 1, 1]","[]","[]",3,0,3,0
3334,"['autorizacao', 'client', 'normalment']","[1, 1, 1]","['clicar', 'clicar', 'clicar', 'clicar', 'clicar', 'desligar', 'desligar', 'enganar', 'minutar', 'privacidad', 'privacidad', 'vagabundar']","[5, 5, 5, 5, 5, 2, 2, 1, 1, 2, 2, 1]",3,12,15,0
3335,"['prever', 'previsao', 'previsao']","[1, 2, 2]","['filmar', 'filmar', 'realment', 'sobrar', 'sobrar']","[2, 2, 1, 2, 2]",3,5,8,0
3336,"['desafiar', 'desafiar', 'desafiar', 'desafiar']","[4, 4, 4, 4]","['ganhar']","[1]",4,1,5,0
3337,"[]","[]","[]","[]",0,0,0,0
3340,"['preocupacao', 'realizacao', 'sabado']","[1, 1, 1]","['circular', 'deitar', 'desmaiar', 'legendar', 'logotipo', 'privacidad']","[1, 1, 1, 1, 1, 1]",3,6,9,0
3341,"[]","[]","['ilustrar', 'imagem']","[1, 1]",0,2,2,0
3344,"['almeida', 'almeida', 'jorg', 'justicar', 'sabado']","[2, 2, 1, 1, 1]","['atribuir', 'circular', 'imagem']","[1, 1, 1]",5,3,8,0
3345,"['habitant', 'transmissao']","[1, 1]","['circular', 'circular', 'desmentir', 'falsar']","[2, 2, 1, 1]",2,4,6,0
3346,"['inclusao']","[1]","[]","[]",1,0,1,0
3347,"['contabilizar']","[1]","['amplament', 'capturar', 'capturar', 'circular', 'compartilhar', 'compartilhar', 'fraudar', 'fraudar', 'postagen']","[1, 2, 2, 1, 2, 2, 2, 2, 1]",1,9,10,0
3350,"[]","[]","['enganar', 'expulsar', 'expulsar']","[1, 2, 2]",0,3,3,0
3353,"['justicar', 'ministrar', 'ministrar', 'mudanca']","[1, 2, 2, 1]","['acidentar', 'acidentar', 'circular', 'motorista', 'motorista', 'motorista']","[2, 2, 1, 3, 3, 3]",4,6,10,0
3358,"['adotada', 'bandeirant', 'fase', 'fornecimento', 'palacio']","[1, 1, 1, 1, 1]","['dorio']","[1]",5,1,6,0
3359,"[]","[]","['compartilhar', 'dorio', 'supostament', 'viralizado']","[1, 1, 1, 1]",0,4,4,0
3364,"['crescimento', 'economia', 'economia', 'pib', 'previsao', 'projeco']","[1, 2, 2, 1, 1, 1]","[]","[]",6,0,6,0
3365,"['flavio', 'opcao', 'queiroz']","[1, 1, 1]","['assassinar', 'legendar']","[1, 1]",3,2,5,0
3368,"[]","[]","['bandeiro', 'compartilhar', 'espalhar']","[1, 1, 1]",0,3,3,0
3369,"['colaboracao', 'colaboracao', 'comissao', 'esquema', 'esquema', 'facilitar', 'journal', 'pagamento', 'reuniao', 'sobretudo']","[2, 2, 1, 2, 2, 1, 1, 1, 1, 1]","[]","[]",10,0,10,0
3371,"['compromisso', 'planar', 'saudar']","[1, 1, 1]","['intitular', 'lupa']","[1, 1]",3,2,5,0
3374,"[]","[]","[]","[]",0,0,0,0
3376,"['desenvolvido', 'planar']","[1, 1]","[]","[]",2,0,2,0
3379,"[]","[]","['compartilhar', 'espalhar', 'imagem', 'quinzena']","[1, 1, 1, 1]",0,4,4,0
3380,"['sabado', 'sabado']","[2, 2]","['verdadeiro']","[1]",2,1,3,0
3383,"['argumentar', 'autoridad', 'transicao']","[1, 1, 1]","['compartilhar', 'soldar', 'supostament']","[1, 1, 1]",3,3,6,0
3384,"['folhar', 'impactar']","[1, 1]","['arquivar', 'disseminar']","[1, 1]",2,2,4,0
3386,"[]","[]","['circular', 'imagem', 'imagem']","[1, 2, 2]",0,3,3,0
3387,"['republico', 'saudar', 'saudar']","[1, 2, 2]","['abencoar', 'cobaia', 'cobaia', 'dorio', 'dorio', 'enganar', 'expulsar', 'ganhar', 'mafia', 'maldiz', 'menino', 'menino', 'menino', 'menino', 'menino', 'menino', 'realment']","[1, 2, 2, 2, 2, 1, 1, 1, 1, 1, 6, 6, 6, 6, 6, 6, 1]",3,17,20,0
3388,"['relaxar']","[1]","['limao', 'limao', 'limao', 'misturar']","[3, 3, 3, 1]",1,4,5,0
3389,"[]","[]","['camiseta']","[1]",0,1,1,0
3392,"['justicar']","[1]","[]","[]",1,0,1,0
3393,"['quilometro']","[1]","['checar', 'numericament']","[1, 1]",1,2,3,0
3394,"['investigacao', 'investigacao', 'pulmonar', 'respirador', 'respirador', 'saudar']","[2, 2, 1, 2, 2, 1]","['checar', 'numericament', 'sobrar']","[1, 1, 1]",6,3,9,0
3397,"['dedicar']","[1]","['circular', 'legendar', 'legendar']","[1, 2, 2]",1,3,4,0
3399,"['converso', 'estagio']","[1, 1]","['enganoso', 'realment', 'realment']","[1, 2, 2]",2,3,5,0
3405,"['autoridad', 'supremo', 'supremo', 'supremo']","[1, 3, 3, 3]","['bandeiro', 'cedula', 'circular', 'circular', 'circular', 'fraudar', 'imagem', 'insinuar', 'mesario', 'mesario', 'sequer']","[1, 1, 3, 3, 3, 1, 1, 1, 2, 2, 1]",4,11,15,0
3407,"['reuniao', 'saudar']","[1, 1]","['cbn', 'circular', 'circular', 'cobaia', 'imagem']","[1, 2, 2, 1, 1]",2,5,7,0
3408,"[]","[]","['escutar', 'tumulo']","[1, 1]",0,2,2,0
3410,"[]","[]","['ganhar', 'ganhar']","[2, 2]",0,2,2,0
3411,"['implementacao', 'implementar', 'inovacao', 'mudanca']","[1, 1, 1, 1]","['circular']","[1]",4,1,5,0
3412,"[]","[]","['assassinar']","[1]",0,1,1,0
3413,"['arrecadacao', 'arrecadar']","[1, 1]","['compartilhar', 'compartilhar', 'menino']","[2, 2, 1]",2,3,5,0
3415,"['domingo']","[1]","[]","[]",1,0,1,0
3416,"['anuncio', 'autoridad', 'saudar']","[1, 1, 1]","['cbn', 'circular']","[1, 1]",3,2,5,0
3417,"[]","[]","[]","[]",0,0,0,0
3418,"[]","[]","['compartilhar', 'despejar', 'imagem', 'imagem', 'parir']","[1, 1, 2, 2, 1]",0,5,5,0
3419,"['inquerito', 'pslrj', 'republico']","[1, 1, 1]","['circular', 'motorista']","[1, 1]",3,2,5,0
3423,"[]","[]","[]","[]",0,0,0,0
3425,"['saudar']","[1]","['circular', 'legendar']","[1, 1]",1,2,3,0
3426,"['coletivo', 'coletivo', 'passageiro', 'propagacao', 'subir']","[2, 2, 1, 1, 1]","['circular', 'imagem', 'imagem', 'imagem', 'legendar', 'motorista', 'reverso']","[1, 3, 3, 3, 1, 1, 1]",5,7,12,0
3429,"['necessario', 'reducao', 'republico']","[1, 1, 1]","['assassinar', 'parabem', 'vc', 'zincar']","[1, 1, 1, 1]",3,4,7,0
3431,"[]","[]","['circular']","[1]",0,1,1,0
3433,"['preocupacao']","[1]","['espalhar', 'misturar']","[1, 1]",1,2,3,0
3439,"[]","[]","['clicar', 'compartilhar', 'compartilhar', 'ganhar', 'ganhar', 'instrucao', 'instrucao', 'reivindicar', 'reivindicar', 'reivindicar']","[1, 2, 2, 2, 2, 2, 2, 3, 3, 3]",0,10,10,0
3441,"['augusto', 'impulsionar', 'sessao', 'sessao']","[1, 1, 2, 2]","['atribuir', 'circular', 'ilustrar', 'imagem', 'reverso']","[1, 1, 1, 1, 1]",4,5,9,0
3443,"['araujo', 'arthur', 'arthur']","[1, 2, 2]","['casamentar', 'compartilhar', 'menino']","[1, 1, 1]",3,3,6,0
3445,"['infectar']","[1]","['circular', 'compartilhar', 'usuario']","[1, 1, 1]",1,3,4,0
3447,"[]","[]","['espancar', 'espancar', 'facada', 'facada']","[2, 2, 2, 2]",0,4,4,0
3449,"['tcu', 'tcu', 'tcu']","[3, 3, 3]","['segundar']","[1]",3,1,4,0
3450,"[]","[]","[]","[]",0,0,0,0
3454,"[]","[]","[]","[]",0,0,0,0
3455,"['ministrar']","[1]","[]","[]",1,0,1,0
3457,"['preservacao', 'recebido', 'regiao', 'regiao']","[1, 1, 2, 2]","['arvor', 'circular', 'compartilhar', 'legendar', 'verificar']","[1, 1, 1, 1, 1]",4,5,9,0
3458,"[]","[]","['grupar', 'grupar', 'lixar', 'versao', 'versao']","[2, 2, 1, 2, 2]",0,5,5,0
3460,"['alternativo', 'equipamento', 'equipamento', 'equipamento', 'infectar', 'preparacao', 'situacao', 'situacao']","[1, 3, 3, 3, 1, 1, 2, 2]","['crer', 'crer', 'espalhar', 'espalhar', 'ganhar', 'ganhar', 'pego', 'pego', 'pego', 'pego', 'pego', 'pego']","[2, 2, 2, 2, 2, 2, 6, 6, 6, 6, 6, 6]",8,12,20,0
3463,"[]","[]","['checar', 'numericament']","[1, 1]",0,2,2,0
3464,"[]","[]","['checar', 'numericament']","[1, 1]",0,2,2,0
3466,"[]","[]","[]","[]",0,0,0,0
3467,"['apurar', 'concedido', 'gabinet', 'investigacao', 'privilegiar']","[1, 1, 1, 1, 1]","['circular', 'motorista']","[1, 1]",5,2,7,0
3468,"['carat', 'comissao', 'conflito', 'elaborar', 'funcao', 'palacio', 'planalto', 'republico', 'temporario', 'temporario', 'treinamento']","[1, 1, 1, 1, 1, 1, 1, 1, 2, 2, 1]","['circular', 'falsar', 'imagem', 'realment']","[1, 1, 1, 1]",11,4,15,0
3472,"[]","[]","['espalhar']","[1]",0,1,1,0
3474,"['destinar', 'suspeito']","[1, 1]","['circular', 'circular', 'clicar', 'clicar', 'enderecar']","[2, 2, 2, 2, 1]",2,5,7,0
3476,"['aglomeracao', 'aglomeracao', 'aglomeracao', 'aglomeracao', 'araujo', 'crise', 'crise', 'dialogo', 'dialogo', 'enfrentamento', 'enfrentamento', 'iniciativo', 'iniciativo', 'opcao', 'opcao', 'reducao', 'reducao', 'saudar', 'saudar', 'saudar', 'saudar', 'situacao', 'situacao']","[4, 4, 4, 4, 1, 2, 2, 2, 2, 2, 2, 2, 2, 2, 2, 2, 2, 4, 4, 4, 4, 2, 2]","['dorio']","[1]",23,1,24,0
3478,"['anteriorment', 'positivar', 'positivar', 'quarentenar']","[1, 2, 2, 1]","[]","[]",4,0,4,0
3480,"['aglomeracao', 'articulacao', 'especialment', 'periodo', 'respiratorio', 'taxar']","[1, 1, 1, 1, 1, 1]","['compartilhar', 'espalhar', 'espalhar', 'grupar', 'grupar', 'nasal', 'parir', 'parir', 'parir', 'parir', 'parir', 'pelar', 'vezar', 'vezar']","[1, 2, 2, 2, 2, 1, 5, 5, 5, 5, 5, 1, 2, 2]",6,14,20,0
3481,"['bbc', 'bbc', 'bbc', 'mergulhar']","[3, 3, 3, 1]","['assinalar', 'circular', 'compartilhar', 'imagem', 'intitular', 'postagen', 'replicar', 'reverso']","[1, 1, 1, 1, 1, 1, 1, 1]",4,8,12,0
3484,"['colleg', 'recordar']","[1, 1]","[]","[]",2,0,2,0
3485,"[]","[]","['acidentar', 'barragem']","[1, 1]",0,2,2,0
3487,"['afp', 'regiao']","[1, 1]","['incendio', 'pego', 'pego', 'verificar']","[1, 2, 2, 1]",2,4,6,0
3490,"['ambientar', 'comunitario', 'disseminacao', 'saudar', 'transmissao']","[1, 1, 1, 1, 1]","['cbn', 'circular']","[1, 1]",5,2,7,0
3491,"[]","[]","[]","[]",0,0,0,0
3493,"['anvisa']","[1]","['parir', 'pelar']","[1, 1]",1,2,3,0
3496,"['aplicacao', 'fase', 'parceria', 'positivar']","[1, 1, 1, 1]","['circular', 'imagem', 'legendar', 'verificar']","[1, 1, 1, 1]",4,4,8,0
3497,"['conflito', 'positivar', 'republico']","[1, 1, 1]","['nordestino']","[1]",3,1,4,0
3504,"['especialment']","[1]","['desmaiar', 'equador', 'verificar']","[1, 1, 1]",1,3,4,0
3510,"['comparacao', 'proporcao']","[1, 1]","['compartilhar', 'gretar', 'sequer']","[1, 1, 1]",2,3,5,0
3512,"['quarentenar', 'relaxar']","[1, 1]","['amigar', 'basto', 'compartilhar', 'ganhar', 'ganhar', 'ganhar', 'inscricao', 'parabem', 'preencher', 'secreto', 'secreto']","[1, 1, 1, 3, 3, 3, 1, 1, 1, 2, 2]",2,11,13,0
3515,"['constituicao', 'constituicao', 'justicar', 'mendonca', 'ministrar', 'ministrar', 'pastar', 'respostar']","[2, 2, 1, 1, 2, 2, 1, 1]","['atribuir', 'atribuir', 'biblia', 'biblia', 'biblia', 'circular', 'usuario', 'verificar']","[2, 2, 3, 3, 3, 1, 1, 1]",8,8,16,0
3516,"['afp', 'afp', 'dosar', 'moderno', 'proporcao', 'regiao', 'taxar', 'taxar']","[2, 2, 1, 1, 1, 1, 2, 2]","['atribuir', 'checagem', 'checar', 'circular', 'compartilhar', 'enganoso', 'enganoso', 'humanar', 'interaco', 'pelar', 'pelar', 'pelar', 'pelar', 'postagen', 'postagen', 'sobrar', 'vezar', 'vezar']","[1, 1, 1, 1, 1, 2, 2, 1, 1, 4, 4, 4, 4, 2, 2, 1, 2, 2]",8,18,26,0
3518,"['colaborar']","[1]","['circular', 'disseminar', 'gleisi', 'rosario', 'venezuelano', 'venezuelano']","[1, 1, 1, 1, 2, 2]",1,6,7,0
3520,"[]","[]","['imagem', 'motorista', 'parir', 'vezar']","[1, 1, 1, 1]",0,4,4,0
3524,"['alteracao', 'aplicacao', 'fabricacao', 'inglaterra', 'inglaterra', 'inglaterra']","[1, 1, 1, 3, 3, 3]","['circular', 'cobaia', 'manipular', 'sequer']","[1, 1, 1, 1]",6,4,10,0
3526,"['inglaterra', 'viagem']","[1, 1]","['catedr', 'versao']","[1, 1]",2,2,4,0
3530,"['autorizacao', 'mudanca', 'notificar', 'prazo', 'privar', 'regrar']","[1, 1, 1, 1, 1, 1]","['compartilhar', 'copiar', 'copiar', 'copiar', 'privacidad', 'privacidad', 'versao']","[1, 3, 3, 3, 2, 2, 1]",6,7,13,0
3533,"[]","[]","['amplament', 'circular', 'compartilhar', 'imagem', 'imagem', 'usuario']","[1, 1, 1, 2, 2, 1]",0,6,6,0
3534,"['levantamento', 'margem', 'possibilidad', 'previo', 'variacao']","[1, 1, 1, 1, 1]","['fraudar', 'realment', 'tampouco', 'verificacao']","[1, 1, 1, 1]",5,4,9,0
3535,"[]","[]","['compartilhar', 'compartilhar', 'compartilhar', 'ganhar']","[3, 3, 3, 1]",0,4,4,0
3536,"['iniciativo', 'privar']","[1, 1]","[]","[]",2,0,2,0
3537,"['necessidad', 'necessidad']","[2, 2]","['clicar', 'compartilhar', 'compartilhar', 'compartilhar']","[1, 3, 3, 3]",2,4,6,0
3546,"[]","[]","[]","[]",0,0,0,0
3547,"['desmatamento', 'desmatamento', 'discussao', 'economia', 'europeu', 'regiao', 'situacao']","[2, 2, 1, 1, 1, 1, 1]","['parir']","[1]",7,1,8,0
3548,"['crescimento', 'curvo', 'quarentenar', 'saudar']","[1, 1, 1, 1]","[]","[]",4,0,4,0
3550,"['oficialment', 'processo', 'saudar', 'supremo']","[1, 1, 1, 1]","[]","[]",4,0,4,0
3553,"['saudar']","[1]","['circular', 'falsar']","[1, 1]",1,2,3,0
3555,"['hospitalizacao', 'primeiroministro', 'reconhecimento', 'saudar']","[1, 1, 1, 1]","['circular', 'compartilhar', 'compartilhar', 'legendar', 'postagen', 'puro', 'telegram', 'usuario', 'verdadeiro', 'visualizar']","[1, 2, 2, 1, 1, 1, 1, 1, 1, 1]",4,10,14,0
3556,"['edson']","[1]","[]","[]",1,0,1,0
3561,"['biliao']","[1]","['indignar']","[1]",1,1,2,0
3566,"['ambientar', 'depoimento', 'ministrar', 'positivar', 'queiroga', 'saudar']","[1, 1, 1, 1, 1, 1]","['checar']","[1]",6,1,7,0
3567,"['efetividad', 'minimizar']","[1, 1]","['amplament', 'compartilhar', 'humanar', 'usuario']","[1, 1, 1, 1]",2,4,6,0
3568,"[]","[]","['vezar', 'visualizar']","[1, 1]",0,2,2,0
3574,"[]","[]","[]","[]",0,0,0,0
3575,"['autorizacao', 'autorizacao', 'autorizacao', 'fabricio', 'fabricio', 'flavio', 'flavio', 'gabinet', 'movimentacao', 'queiroz', 'queiroz', 'queiroz', 'queiroz', 'suspeito', 'suspeito']","[3, 3, 3, 2, 2, 2, 2, 1, 1, 4, 4, 4, 4, 2, 2]","[]","[]",15,0,15,0
3578,"['calculo', 'calendario', 'calendario', 'mudanca']","[1, 2, 2, 1]","[]","[]",4,0,4,0
3579,"['arrecadar', 'bancada', 'comparacao', 'despesa', 'estimativo', 'montant', 'planar', 'planar', 'planar', 'planar', 'previsto', 'saudar', 'saudar', 'saudar', 'supremo', 'supremo', 'supremo']","[1, 1, 1, 1, 1, 1, 4, 4, 4, 4, 1, 3, 3, 3, 3, 3, 3]","['usuario']","[1]",17,1,18,0
3580,"['gabinet', 'gabinet', 'supremo']","[2, 2, 1]","['circular', 'parir']","[1, 1]",3,2,5,0
3583,"['amplo', 'autoridad', 'desigualdad', 'dificuldad', 'enxergar', 'minoria', 'regrar', 'saneamento', 'saudar']","[1, 1, 1, 1, 1, 1, 1, 1, 1]","['compartilhar', 'enfim', 'menino', 'misturar', 'parir', 'sequer', 'verdadeiro']","[1, 1, 1, 1, 1, 1, 1]",9,7,16,0
3585,"['coreia', 'fronteiro', 'taxar']","[1, 1, 1]","['circular']","[1]",3,1,4,0
3586,"[]","[]","[]","[]",0,0,0,0
3587,"['previsto']","[1]","[]","[]",1,0,1,0
3589,"['dedicar', 'domingo', 'logistico', 'periodo', 'universitario']","[1, 1, 1, 1, 1]","['enganar', 'protestar']","[1, 1]",5,2,7,0
3590,"['domingo']","[1]","['assassinar', 'viralizado']","[1, 1]",1,2,3,0
3591,"['desenvolvimento', 'justicar']","[1, 1]","[]","[]",2,0,2,0
3593,"['positivar', 'positivar']","[2, 2]","['falsar']","[1]",2,1,3,0
3595,"['assintomatico', 'assintomatico', 'contagioso', 'infectar', 'planar', 'planar', 'planar', 'preventivo', 'respostar', 'saudar', 'saudar', 'saudar', 'sindicato']","[2, 2, 1, 1, 3, 3, 3, 1, 1, 3, 3, 3, 1]","['basto', 'dioxido', 'enganar', 'humanar', 'supostament', 'vitaminar', 'vitaminar', 'vitaminar', 'zincar']","[1, 1, 1, 1, 1, 3, 3, 3, 1]",13,9,22,0
3597,"['obtido']","[1]","['chorar', 'circular', 'fotografia', 'fotografo', 'imagem', 'imagem', 'imagem', 'legendar', 'manipular']","[1, 1, 1, 1, 3, 3, 3, 1, 1]",1,9,10,0
3598,"['distrito', 'fluminens']","[1, 1]","['assassinar', 'circular']","[1, 1]",2,2,4,0
3600,"['instituto', 'possibilidad', 'quadro']","[1, 1, 1]","['pelar']","[1]",3,1,4,0
3602,"[]","[]","['adelio', 'bispar', 'deitar']","[1, 1, 1]",0,3,3,0
3603,"['treinar']","[1]","[]","[]",1,0,1,0
3607,"[]","[]","[]","[]",0,0,0,0
3608,"['anvisa', 'saudar', 'saudar', 'vigilancia']","[1, 2, 2, 1]","['circular', 'compartilhar', 'desmentir']","[1, 1, 1]",4,3,7,0
3611,"[]","[]","['espalhar', 'grupar', 'quantum', 'telejorn']","[1, 1, 1, 1]",0,4,4,0
3612,"['edson', 'salao']","[1, 1]","['espalhar', 'menino']","[1, 1]",2,2,4,0
3613,"[]","[]","['cristao', 'cristao']","[2, 2]",0,2,2,0
3616,"['prazo']","[1]","['clicar', 'clicar', 'compartilhar', 'enderecar', 'sapato']","[2, 2, 1, 1, 1]",1,5,6,0
3617,"['justicar', 'orientacao', 'periodo', 'planar', 'resolucao']","[1, 1, 1, 1, 1]","['circular', 'verdadeiro']","[1, 1]",5,2,7,0
3621,"['dificuldad', 'justicar', 'necessario', 'preparacao']","[1, 1, 1, 1]","['realment']","[1]",4,1,5,0
3622,"['suspeito']","[1]","['insinuar']","[1]",1,1,2,0
3623,"['observar']","[1]","['agredir']","[1]",1,1,2,0
3624,"[]","[]","['dorio', 'dorio']","[2, 2]",0,2,2,0
3625,"['academico', 'adhanom', 'autoridad', 'californio', 'contagioso', 'esforco', 'infectar', 'inicialment', 'instalacao', 'instituto', 'preliminar', 'propagacao', 'saudar', 'surtir', 'surtir', 'tedro', 'transmissao', 'transmissao', 'umido', 'umido', 'umido', 'viagem', 'voo']","[1, 1, 1, 1, 1, 1, 1, 1, 1, 1, 1, 1, 1, 2, 2, 1, 2, 2, 3, 3, 3, 1, 1]","['minutar']","[1]",23,1,24,0
3626,"[]","[]","['agredir', 'compartilhar', 'gravacao', 'legendar']","[1, 1, 1, 1]",0,4,4,0
3628,"['normalment', 'toquio', 'toquio', 'velocidad']","[1, 2, 2, 1]","['circular', 'filmar', 'imagem', 'imagem', 'intitular', 'legendar', 'legendar', 'visualizacao']","[1, 1, 2, 2, 1, 2, 2, 1]",4,8,12,0
3629,"['concorrent', 'domingo', 'fluminens', 'marilia', 'motivacao']","[1, 1, 1, 1, 1]","['agredir', 'cbn', 'circular', 'legendar']","[1, 1, 1, 1]",5,4,9,0
3632,"['ministrar', 'supremo']","[1, 1]","['circular', 'compartilhar', 'expulsar', 'expulsar']","[1, 1, 2, 2]",2,4,6,0
3633,"['especifico', 'saudar', 'saudar']","[1, 2, 2]","['lupa']","[1]",3,1,4,0
3634,"[]","[]","['amplament', 'compartilhar', 'quinzena', 'segundar']","[1, 1, 1, 1]",0,4,4,0
3635,"['decisao', 'desenvolvido', 'exministro', 'henriqu', 'instituto', 'ministrar', 'nelson', 'parceria', 'saudar', 'teich']","[1, 1, 1, 1, 1, 1, 1, 1, 1, 1]","['cobaia']","[1]",10,1,11,0
3636,"['flavio', 'republicanosrj']","[1, 1]","['compartilhar', 'ilustrar', 'imagem', 'imagem', 'verdadeiro']","[1, 1, 2, 2, 1]",2,5,7,0
3638,"[]","[]","['compartilhar', 'imagem', 'postagen', 'protestar']","[1, 1, 1, 1]",0,4,4,0
3639,"['economia']","[1]","[]","[]",1,0,1,0
3641,"['administrativo']","[1]","['clicar', 'compartilhar', 'compartilhar', 'preencher', 'preencher']","[1, 2, 2, 2, 2]",1,5,6,0
3642,"[]","[]","['circular', 'desgracar', 'idioma', 'imagem', 'legendar', 'legendar', 'legendar', 'lixar']","[1, 1, 1, 1, 3, 3, 3, 1]",0,8,8,0
3646,"[]","[]","['compartilhar', 'parabem']","[1, 1]",0,2,2,0
3648,"['dosar', 'periodo', 'reducao', 'significativo']","[1, 1, 1, 1]","['realment', 'versao', 'versao']","[1, 2, 2]",4,3,7,0
3649,"['biliao', 'tesourar', 'transferencia']","[1, 1, 1]","['parabem', 'vc']","[1, 1]",3,2,5,0
3652,"[]","[]","['sobrar']","[1]",0,1,1,0
3653,"['afp', 'avancar', 'presenca']","[1, 1, 1]","[]","[]",3,0,3,0
3658,"['autorizacao', 'decisao', 'decisao', 'julgamento', 'ministrar', 'monitoramento', 'monitoramento', 'reforcar', 'relativo', 'respostar', 'suspenso', 'variacao']","[1, 2, 2, 1, 1, 2, 2, 1, 1, 1, 1, 1]","['boatar', 'checar', 'circular', 'circular']","[1, 1, 2, 2]",12,4,16,0
3659,"['exjuiz', 'exministro', 'investigacao', 'justicar', 'ministrar', 'republico']","[1, 1, 1, 1, 1, 1]","['capturar', 'compartilhar', 'legendar', 'postagen', 'supostament', 'usuario']","[1, 1, 1, 1, 1, 1]",6,6,12,0
3660,"[]","[]","['desfilar', 'desfilar', 'versao', 'versao']","[2, 2, 2, 2]",0,4,4,0
3661,"['fabricacao', 'positivar', 'positivar', 'positivar']","[1, 3, 3, 3]","['compartilhar', 'postagen']","[1, 1]",4,2,6,0
3663,"['imunizacao', 'previsao']","[1, 1]","[]","[]",2,0,2,0
3666,"['determinacao', 'reforcar', 'silveiro']","[1, 1, 1]","['circular', 'circular', 'imagem', 'imagem', 'imagem', 'manipulacao', 'reverso']","[2, 2, 3, 3, 3, 1, 1]",3,7,10,0
3669,"['imunizacao', 'possibilidad', 'previsto', 'prioritario', 'republico', 'tramitacao']","[1, 1, 1, 1, 1, 1]","[]","[]",6,0,6,0
3672,"['crise', 'decorrencia']","[1, 1]","['circular', 'compartilhar']","[1, 1]",2,2,4,0
3673,"['arthur', 'congresso', 'lira']","[1, 1, 1]","['parir', 'parir', 'parir', 'parir']","[4, 4, 4, 4]",3,4,7,0
3674,"['bruno', 'deteccao', 'jn', 'renata', 'renata']","[1, 1, 1, 2, 2]","['compartilhar', 'fotografia', 'imagem', 'imagem', 'reverso', 'viralizada']","[1, 1, 2, 2, 1, 1]",5,6,11,0
3679,"['argumentar']","[1]","[]","[]",1,0,1,0
3680,"['exministro', 'saudar', 'viagem']","[1, 1, 1]","['checagem', 'falsar', 'logotipo', 'verificar']","[1, 1, 1, 1]",3,4,7,0
3682,"['dosar', 'dosar', 'fase']","[2, 2, 1]","['cobaia', 'cobaia', 'versao', 'versao', 'versao']","[2, 2, 3, 3, 3]",3,5,8,0
3683,"[]","[]","['cristao', 'incendio']","[1, 1]",0,2,2,0
3684,"['conservacao', 'distrito', 'preservar', 'queiroz', 'regiao']","[1, 1, 1, 1, 1]","['ganhar', 'pelar']","[1, 1]",5,2,7,0
3685,"['crescimento', 'economia']","[1, 1]","['acidentar', 'chorar', 'realment']","[1, 1, 1]",2,3,5,0
3686,"['fornecimento', 'instituto', 'ministrar', 'saudar']","[1, 1, 1, 1]","['cbn']","[1]",4,1,5,0
3698,"[]","[]","['padrar', 'padrar']","[2, 2]",0,2,2,0
3699,"[]","[]","['compartilhar', 'compartilhar', 'imagem']","[2, 2, 1]",0,3,3,0
3700,"[]","[]","['compartilhar', 'copiar', 'realment']","[1, 1, 1]",0,3,3,0
3703,"[]","[]","['compartilhar', 'misericordia', 'postagen', 'usuario', 'viralizado']","[1, 1, 1, 1, 1]",0,5,5,0
3705,"[]","[]","['atribuir', 'compartilhar', 'espalhar']","[1, 1, 1]",0,3,3,0
3706,"['fase', 'saudar']","[1, 1]","['circular', 'enganir']","[1, 1]",2,2,4,0
3707,"['fundacao', 'fundacao', 'independentement', 'situacao']","[2, 2, 1, 1]","['atribuir', 'basto', 'circular', 'compartilhar', 'desmentir', 'idioma', 'parir']","[1, 1, 1, 1, 1, 1, 1]",4,7,11,0
3710,"['concedido', 'disseminacao', 'fundacao', 'infeccioso', 'institut', 'instituto']","[1, 1, 1, 1, 1, 1]","['circular', 'versao']","[1, 1]",6,2,8,0
3711,"['aprovacao', 'fase', 'paralelo']","[1, 1, 1]","['enganoso', 'nasal', 'parir', 'parir', 'pelar', 'postagen']","[1, 1, 2, 2, 1, 1]",3,6,9,0
3718,"[]","[]","['compartilhar', 'gravacao', 'imagem', 'postagen', 'usuario', 'verdadeiro', 'visualizar']","[1, 1, 1, 1, 1, 1, 1]",0,7,7,0
3719,"['dosar', 'imunizacao', 'lavagem', 'mantido']","[1, 1, 1, 1]","[]","[]",4,0,4,0
3721,"['manutencao', 'manutencao', 'transmissao']","[2, 2, 1]","[]","[]",3,0,3,0
3724,"['calculo']","[1]","[]","[]",1,0,1,0
3725,"[]","[]","[]","[]",0,0,0,0
3728,"['destacar', 'ministrar', 'supremo']","[1, 1, 1]","['compartilhar', 'disseminar', 'disseminar', 'mencao', 'postagen', 'postagen', 'usuario']","[1, 2, 2, 1, 2, 2, 1]",3,7,10,0
3729,"[]","[]","['desligar', 'vc', 'vc', 'vc', 'vc', 'vc']","[1, 5, 5, 5, 5, 5]",0,6,6,0
3733,"[]","[]","['circular', 'disfarcar', 'imagem', 'motorista']","[1, 1, 1, 1]",0,4,4,0
3734,"['desenvolvido', 'dosar', 'dosar', 'imunizacao', 'inglaterra']","[1, 2, 2, 1, 1]","['circular', 'falsar']","[1, 1]",5,2,7,0
3736,"['gued', 'ministrar']","[1, 1]","[]","[]",2,0,2,0
3737,"[]","[]","['filmar']","[1]",0,1,1,0
3741,"['orientacao', 'privar', 'propagacao', 'saudar', 'saudar', 'transmissao']","[1, 1, 1, 2, 2, 1]","['cbn', 'circular']","[1, 1]",6,2,8,0
3745,"[]","[]","[]","[]",0,0,0,0
3748,"['acumular', 'alergia', 'ambientar', 'infeccioso', 'necessidad', 'periodo', 'pratico', 'respiratorio']","[1, 1, 1, 1, 1, 1, 1, 1]","['compartilhar', 'espalhar', 'sapato', 'suco']","[1, 1, 1, 1]",8,4,12,0
3750,"['resistencia']","[1]","['imagem']","[1]",1,1,2,0
3752,"['distrito', 'interferencia', 'justicar']","[1, 1, 1]","['canadens']","[1]",3,1,4,0
3753,"[]","[]","[]","[]",0,0,0,0
3755,"['domingo', 'resolucao']","[1, 1]","['circular', 'desmentir', 'estampar', 'imagem', 'imagem', 'insinuar', 'legendar', 'viralizado']","[1, 1, 1, 2, 2, 1, 1, 1]",2,8,10,0
3756,"['decisao', 'necessidad', 'realizacao', 'recurso', 'recurso', 'saudar']","[1, 1, 1, 2, 2, 1]","['circular', 'espalhar', 'postagen']","[1, 1, 1]",6,3,9,0
3757,"[]","[]","['amplament', 'compartilhar', 'quinzena']","[1, 1, 1]",0,3,3,0
3762,"['risco']","[1]","['atribuir', 'circular', 'postagen']","[1, 1, 1]",1,3,4,0
3764,"['proximo']","[1]","['versao', 'versao']","[2, 2]",1,2,3,0
3770,"['contrato', 'defendido', 'totalizar']","[1, 1, 1]","[]","[]",3,0,3,0
3773,"[]","[]","[]","[]",0,0,0,0
3774,"['autoridad', 'conformar', 'decisao', 'desenvolvimento', 'estrategia', 'iniciativo', 'observar', 'proposto', 'temporariament']","[1, 1, 1, 1, 1, 1, 1, 1, 1]","['enderecar', 'supostament']","[1, 1]",9,2,11,0
3776,"[]","[]","['arquivar', 'curioso', 'ganhar', 'segundar']","[1, 1, 1, 1]",0,4,4,0
3777,"['comparacao']","[1]","[]","[]",1,0,1,0
3778,"['decisao', 'temporada']","[1, 1]","['ganhar', 'patrocinador', 'patrocinador', 'patrocinador', 'pelar', 'pelar']","[1, 3, 3, 3, 2, 2]",2,6,8,0
3779,"[]","[]","[]","[]",0,0,0,0
3781,"['antonio', 'carat', 'conjuntar', 'edson', 'treinamento', 'treinamento']","[1, 1, 1, 1, 2, 2]","['circular', 'secreto']","[1, 1]",6,2,8,0
3782,"[]","[]","['compartilhar', 'vazio', 'vc']","[1, 1, 1]",0,3,3,0
3784,"['dificuldad', 'especifico', 'fronteiro', 'importancia', 'respostar', 'respostar', 'subir']","[1, 1, 1, 1, 2, 2, 1]","['parir']","[1]",7,1,8,0
3786,"[]","[]","[]","[]",0,0,0,0
3787,"['importacao', 'iniciativo']","[1, 1]","['compartilhar', 'postagen']","[1, 1]",2,2,4,0
3788,"['apurar', 'curvo', 'situacao']","[1, 1, 1]","['assinalar', 'circular', 'fraudar', 'indignar', 'usuario']","[1, 1, 1, 1, 1]",3,5,8,0
3789,"['ambientar', 'ambientar', 'autonomia', 'esquema', 'folhar', 'mudanca', 'regrar', 'regrar', 'treinar']","[2, 2, 1, 1, 1, 1, 2, 2, 1]","['desfilar', 'idioma', 'menino', 'menino', 'menino']","[1, 1, 3, 3, 3]",9,5,14,0
3790,"['diariament', 'orientacao', 'pratico']","[1, 1, 1]","['cbn', 'compartilhar', 'vitaminar']","[1, 1, 1]",3,3,6,0
3791,"['autoridad', 'autoridad', 'constituicao', 'descumprir', 'distrito', 'guarulho', 'inquerito', 'instaurar', 'orientacao', 'prever', 'prever', 'prever', 'prever', 'prever', 'previsao', 'processo', 'temporariament']","[2, 2, 1, 1, 1, 1, 1, 1, 1, 5, 5, 5, 5, 5, 1, 1, 1]","['abusar', 'abusar', 'dorio']","[2, 2, 1]",17,3,20,0
3794,"['alerj', 'legislativo', 'regiao', 'regiao']","[1, 1, 2, 2]","['agredir', 'circular', 'compartilhar', 'falsar', 'protestar']","[1, 1, 1, 1, 1]",4,5,9,0
3795,"['palacio']","[1]","['imagem', 'protestar']","[1, 1]",1,2,3,0
3796,"['aplicacao', 'atrasar', 'fabricacao']","[1, 1, 1]","['compartilhar', 'dorio', 'postagen']","[1, 1, 1]",3,3,6,0
3798,"[]","[]","['compartilhar', 'falsar', 'grupar', 'imagem', 'verdadeiro']","[1, 1, 1, 1, 1]",0,5,5,0
3799,"['congresso', 'economia', 'economia', 'gued', 'improbidad', 'integrant', 'ministrar', 'ministrar', 'parceria', 'prazo', 'reducao', 'reducao']","[1, 2, 2, 1, 1, 1, 2, 2, 1, 1, 2, 2]","['gleisi']","[1]",12,1,13,0
3801,"['desenvolvimento', 'quarentenar']","[1, 1]","[]","[]",2,0,2,0
3803,"[]","[]","['parabem']","[1]",0,1,1,0
3805,"['delacao', 'ministrar']","[1, 1]","['mansao', 'mansao', 'vagabundar']","[2, 2, 1]",2,3,5,0
3806,"['journal']","[1]","['pelar']","[1]",1,1,2,0
3807,"[]","[]","[]","[]",0,0,0,0
3808,"['associacao', 'risco']","[1, 1]","['circular', 'misturar']","[1, 1]",2,2,4,0
3812,"[]","[]","[]","[]",0,0,0,0
3813,"['destinar']","[1]","['gravacao', 'postagen', 'versao', 'viralizado']","[1, 1, 1, 1]",1,4,5,0
3815,"['desenvolvimento', 'marinhar', 'ministrar']","[1, 1, 1]","['rompimento', 'rompimento']","[2, 2]",3,2,5,0
3818,"[]","[]","['falsar']","[1]",0,1,1,0
3819,"['afastament', 'afastamento', 'afastamento', 'antecipar', 'conjuntar', 'decisao', 'delacao', 'delacao', 'deltan', 'deltan', 'discussao', 'facilitar', 'fundacao', 'irregularidad', 'motivacao', 'privilegiar', 'republico']","[1, 2, 2, 1, 1, 1, 2, 2, 2, 2, 1, 1, 1, 1, 1, 1, 1]","['arquivar', 'copiar', 'parir', 'safar', 'vazar', 'vazar', 'vazar']","[1, 1, 1, 1, 3, 3, 3]",17,7,24,0
3820,"['gued', 'saneamento']","[1, 1]","['enfim']","[1]",2,1,3,0
3823,"['congresso', 'investigacao']","[1, 1]","['vagabundar']","[1]",2,1,3,0
3826,"[]","[]","['espalhar', 'imagem', 'parir']","[1, 1, 1]",0,3,3,0
3827,"['constatar', 'internacao']","[1, 1]","['espalhar']","[1]",2,1,3,0
3828,"['arrecadar', 'biliao', 'companhia']","[1, 1, 1]","['ilustrar', 'postagen', 'secreto']","[1, 1, 1]",3,3,6,0
3830,"['amplo', 'desenvolvido', 'saudar']","[1, 1, 1]","['atribuir', 'catolico', 'humanar']","[1, 1, 1]",3,3,6,0
3833,"['quota']","[1]","[]","[]",1,0,1,0
3834,"[]","[]","['inocentar', 'puro', 'realment', 'vagabundar', 'vagabundar']","[1, 1, 1, 2, 2]",0,5,5,0
3836,"['destacar']","[1]","[]","[]",1,0,1,0
3839,"['anuncio', 'previsao']","[1, 1]","['circular']","[1]",2,1,3,0
3842,"[]","[]","['imagem']","[1]",0,1,1,0
3843,"['dialogo', 'esperancar', 'plantao', 'sentenca']","[1, 1, 1, 1]","['arvor', 'lixar', 'parir', 'vc']","[1, 1, 1, 1]",4,4,8,0
3844,"['tambem']","[1]","['assassinar', 'parabem', 'parir', 'pelar', 'pelar']","[1, 1, 1, 2, 2]",1,5,6,0
3848,"['claudio', 'claudio']","[2, 2]","['amigar', 'caixao', 'caixao', 'circular', 'compartilhar', 'imagem', 'legendar', 'lixar']","[1, 2, 2, 1, 1, 1, 1, 1]",2,8,10,0
3850,"[]","[]","['atribuir', 'atribuir', 'circular', 'gleisi', 'gleisi', 'interaco']","[2, 2, 1, 2, 2, 1]",0,6,6,0
3852,"['afp', 'atuacao']","[1, 1]","['capturar', 'checar', 'chorar', 'compartilhar', 'postagen', 'protestar', 'trafico', 'verificacao', 'viralizada']","[1, 1, 1, 1, 1, 1, 1, 1, 1]",2,9,11,0
3853,"[]","[]","['atribuir', 'circular']","[1, 1]",0,2,2,0
3854,"['discussao', 'infectar', 'infectar', 'precedent', 'saudar', 'situacao']","[1, 2, 2, 1, 1, 1]","['enganir', 'manipulacao', 'manipulacao', 'manipulacao', 'verdadeiro']","[1, 3, 3, 3, 1]",6,5,11,0
3860,"[]","[]","['acidentar', 'espalhar', 'quinzena']","[1, 1, 1]",0,3,3,0
3863,"[]","[]","['circular', 'imagem', 'quinzena']","[1, 1, 1]",0,3,3,0
3864,"['destacar', 'saudar']","[1, 1]","['circular', 'compartilhar', 'compartilhar', 'imagem']","[1, 2, 2, 1]",2,4,6,0
3868,"[]","[]","['bonner', 'bonner']","[2, 2]",0,2,2,0
3870,"[]","[]","['compartilhar', 'pelar', 'usuario']","[1, 1, 1]",0,3,3,0
3872,"['diariament']","[1]","['compartilhar', 'postagen']","[1, 1]",1,2,3,0
3874,"['araujo', 'araujo', 'araujo', 'assintomatico', 'necessario', 'randolf']","[3, 3, 3, 1, 1, 1]","[]","[]",6,0,6,0
3875,"['anvisa', 'equivalent', 'oferecido', 'oferecido']","[1, 1, 2, 2]","['cobaia', 'cobaia', 'dorio', 'ganhar', 'safar', 'vagabundar']","[2, 2, 1, 1, 1, 1]",4,6,10,0
3876,"['calamidad', 'privar', 'temporario']","[1, 1, 1]","['compartilhar', 'protestar', 'vc', 'versao']","[1, 1, 1, 1]",3,4,7,0
3877,"['apurar', 'distant', 'habitant', 'instituto', 'pagamento', 'regrar', 'suspensao', 'suspensao']","[1, 1, 1, 1, 1, 1, 2, 2]","['compartilhar', 'enganoso', 'protestar', 'verificar']","[1, 1, 1, 1]",8,4,12,0
3878,"['sabado']","[1]","[]","[]",1,0,1,0
3879,"['afp', 'converso']","[1, 1]","['checagem', 'compartilhar', 'pelar', 'replicar', 'viralizada']","[1, 1, 1, 1, 1]",2,5,7,0
3882,"['biliao', 'resistencia']","[1, 1]","['circular']","[1]",2,1,3,0
3883,"[]","[]","['amplament', 'compartilhar', 'espalhar']","[1, 1, 1]",0,3,3,0
3884,"['isolar', 'situacao']","[1, 1]","['compartilhar']","[1]",2,1,3,0
3885,"['economia', 'enfermagem', 'estatistico', 'saudar', 'temporario', 'temporario']","[1, 1, 1, 1, 2, 2]","['catolico', 'inscricao']","[1, 1]",6,2,8,0
3888,"['alunar', 'colegio', 'colegio', 'ministrar', 'observacao']","[1, 2, 2, 1, 1]","['disfarcar', 'menino', 'menino', 'menino', 'menino', 'safar']","[1, 4, 4, 4, 4, 1]",5,6,11,0
3890,"['funcao', 'transferencia', 'transferir', 'transferir']","[1, 1, 2, 2]","['circular']","[1]",4,1,5,0
3892,"['comissao', 'equipamento', 'externo', 'tucano']","[1, 1, 1, 1]","['auditoria', 'auditoria', 'fraudar', 'fraudar', 'gravacao', 'parir', 'parir', 'parir', 'parir', 'parir', 'pelar', 'pelar', 'sobrar']","[2, 2, 2, 2, 1, 5, 5, 5, 5, 5, 2, 2, 1]",4,13,17,0
3893,"['anvisa']","[1]","[]","[]",1,0,1,0
3895,"['condenacao', 'decisao', 'decisao', 'justicar', 'supremo']","[1, 2, 2, 1, 1]","['circular', 'circular', 'ganhar', 'imagem', 'imagem', 'imagem', 'soltar', 'verdadeiro']","[2, 2, 1, 3, 3, 3, 1, 1]",5,8,13,0
3898,"['campino', 'crise', 'saudar', 'triagem']","[1, 1, 1, 1]","['filmar', 'imagem', 'realment']","[1, 1, 1]",4,3,7,0
3900,"['converso', 'descumprir', 'estrategia', 'exministro', 'henriqu', 'ministrar', 'reforcar', 'regrar', 'saudar', 'saudar']","[1, 1, 1, 1, 1, 1, 1, 1, 2, 2]","['compartilhar', 'fotografo', 'imagem', 'viralizado']","[1, 1, 1, 1]",10,4,14,0
3901,"['reforcar']","[1]","['circular', 'compartilhar', 'imagem', 'legendar']","[1, 1, 1, 1]",1,4,5,0
3902,"[]","[]","['espalhar', 'quinzena', 'soltar']","[1, 1, 1]",0,3,3,0
3903,"['condicao', 'necessario', 'necessario', 'regiao']","[1, 2, 2, 1]","['botao', 'clicar', 'compartilhar', 'compartilhar', 'motorista', 'preencher']","[1, 1, 2, 2, 1, 1]",4,6,10,0
3904,"[]","[]","['cnh', 'cnh']","[2, 2]",0,2,2,0
3907,"['apurar', 'presenca']","[1, 1]","['circular', 'compartilhar', 'quinzena', 'secreto']","[1, 1, 1, 1]",2,4,6,0
3908,"['desenvolvimento', 'pagamento', 'pagamento', 'parcelar', 'pratico', 'publicitario', 'publicitario']","[1, 2, 2, 1, 1, 2, 2]","[]","[]",7,0,7,0
3910,"['contemplar', 'economia', 'gued', 'ministrar', 'ministrar']","[1, 1, 1, 2, 2]","['circular', 'imagem', 'imagem', 'inscricao', 'supostament']","[1, 2, 2, 1, 1]",5,5,10,0
3912,"['ministrar', 'prazo', 'republico', 'supremo']","[1, 1, 1, 1]","['compartilhar']","[1]",4,1,5,0
3913,"['comissao', 'cooperacao', 'depoimento', 'inquerito']","[1, 1, 1, 1]","['pelar']","[1]",4,1,5,0
3916,"['aprovacao', 'aprovacao', 'atendido', 'conflito', 'exigencia', 'exigencia', 'gued', 'ministrar', 'necessidad', 'prazo', 'preservar', 'ricardo', 'substituicao']","[2, 2, 1, 1, 2, 2, 1, 1, 1, 1, 1, 1, 1]","['gasolina', 'renunciar']","[1, 1]",13,2,15,0
3917,"['positivar', 'saudar']","[1, 1]","['compartilhar', 'compartilhar', 'ilustrar', 'imagem', 'legendar', 'replicar', 'usuario']","[2, 2, 1, 1, 1, 1, 1]",2,7,9,0
3919,"['exportacao', 'periodo', 'quedo']","[1, 1, 1]","[]","[]",3,0,3,0
3920,"['alami', 'coletivo', 'reforcar']","[1, 1, 1]","['casamentar', 'casamentar', 'casamentar', 'circular', 'descricao', 'fotografo', 'imagem', 'imagem', 'imagem', 'imagem', 'imagem', 'imagem', 'inscricao', 'inscricao', 'inscricao', 'legendar', 'manipular']","[3, 3, 3, 1, 1, 1, 6, 6, 6, 6, 6, 6, 3, 3, 3, 1, 1]",3,17,20,0
3921,"['pagamento']","[1]","[]","[]",1,0,1,0
3922,"['martim', 'martim']","[2, 2]","['lixar', 'vc']","[1, 1]",2,2,4,0
3926,"[]","[]","['menino']","[1]",0,1,1,0
3928,"[]","[]","[]","[]",0,0,0,0
3929,"['biliao', 'servidor']","[1, 1]","[]","[]",2,0,2,0
3930,"[]","[]","['chorar', 'chorar']","[2, 2]",0,2,2,0
3931,"[]","[]","['compartilhar']","[1]",0,1,1,0
3932,"[]","[]","['efarsa', 'verificar']","[1, 1]",0,2,2,0
3934,"[]","[]","[]","[]",0,0,0,0
3935,"['agravar']","[1]","['circular', 'nobel', 'realment']","[1, 1, 1]",1,3,4,0
3937,"['primario']","[1]","['biblia', 'biblia', 'humanar', 'verdadeiro']","[2, 2, 1, 1]",1,4,5,0
3940,"[]","[]","['crer', 'usuario']","[1, 1]",0,2,2,0
3941,"[]","[]","['compartilhar']","[1]",0,1,1,0
3942,"['quarentenar']","[1]","['implantar']","[1]",1,1,2,0
3945,"['quarentenar']","[1]","['compartilhar', 'dorio', 'imagem', 'legendar', 'mansao', 'mansao', 'postagen', 'vagabundar']","[1, 1, 1, 1, 2, 2, 1, 1]",1,8,9,0
3948,"['gued', 'gued', 'gued', 'gued', 'investigacao', 'ministrar', 'ministrar', 'oficialment', 'privar', 'privar', 'recurso', 'tcu']","[4, 4, 4, 4, 1, 2, 2, 1, 2, 2, 1, 1]","['fraudar', 'fraudar']","[2, 2]",12,2,14,0
3949,"['ideologico']","[1]","['maldiz']","[1]",1,1,2,0
3950,"['positivar']","[1]","[]","[]",1,0,1,0
3951,"[]","[]","[]","[]",0,0,0,0
3952,"['depoimento']","[1]","[]","[]",1,0,1,0
3953,"['variacao']","[1]","['circular', 'supostament']","[1, 1]",1,2,3,0
3960,"[]","[]","[]","[]",0,0,0,0
3962,"[]","[]","['lazaro', 'pego', 'pego', 'pego', 'versao']","[1, 3, 3, 3, 1]",0,5,5,0
3963,"[]","[]","[]","[]",0,0,0,0
3964,"['antecipar', 'economia', 'equipamento', 'ministrar', 'quarentenar', 'saudar']","[1, 1, 1, 1, 1, 1]","['cuspir', 'misturar', 'vazio']","[1, 1, 1]",6,3,9,0
3966,"[]","[]","['sobrar']","[1]",0,1,1,0
3967,"['bancada', 'calheiro', 'calheiro', 'comportamento', 'congresso', 'congresso', 'economia', 'geraldo', 'necessario']","[1, 2, 2, 1, 2, 2, 1, 1, 1]","['manipular', 'menino', 'mentiroso', 'parir']","[1, 1, 1, 1]",9,4,13,0
3968,"['absoluto', 'afp', 'espanha', 'espanha']","[1, 1, 2, 2]","['compartilhar', 'imagem', 'realment', 'verificar']","[1, 1, 1, 1]",4,4,8,0
3969,"['saudar', 'saudar']","[2, 2]","[]","[]",2,0,2,0
3972,"['sorocaba']","[1]","['imagem']","[1]",1,1,2,0
3973,"['recordar', 'recordar', 'recordar']","[3, 3, 3]","['realment', 'realment']","[2, 2]",3,2,5,0
3975,"['favorito', 'globonew']","[1, 1]","['chorar', 'chorar', 'circular', 'compartilhar', 'gravacao', 'legendar', 'usuario']","[2, 2, 1, 1, 1, 1, 1]",2,7,9,0
3976,"[]","[]","['amplament', 'compartilhar', 'espalhar', 'lixar', 'sacar']","[1, 1, 1, 1, 1]",0,5,5,0
3980,"[]","[]","['gravacao', 'usuario', 'visualizar']","[1, 1, 1]",0,3,3,0
3981,"['quadro', 'turma']","[1, 1]","['espalhar', 'imagem', 'quinzena']","[1, 1, 1]",2,3,5,0
3983,"['abba', 'ambientar', 'aprovacao', 'avancar', 'economia', 'epidemiar', 'especialment', 'funcao', 'gued', 'gued', 'iniciativo', 'lorenzoni', 'ministrar', 'ministrar', 'ministrar', 'ministrar', 'onyx', 'presenca', 'presenca', 'provisorio', 'provisorio', 'quarentenar', 'reuniao', 'saudar', 'saudar']","[1, 1, 1, 1, 1, 1, 1, 1, 2, 2, 1, 1, 4, 4, 4, 4, 1, 2, 2, 2, 2, 1, 1, 2, 2]","[]","[]",25,0,25,0
3984,"['especifico', 'reforcar', 'saudar', 'saudar']","[1, 1, 2, 2]","['limao', 'verificar', 'vitaminar', 'vitaminar']","[1, 1, 2, 2]",4,4,8,0
3985,"[]","[]","[]","[]",0,0,0,0
3986,"['ideologico']","[1]","[]","[]",1,0,1,0
3987,"['antecipar', 'impactar', 'saudar']","[1, 1, 1]","['boatar', 'circular', 'circular', 'circular', 'intitular']","[1, 3, 3, 3, 1]",3,5,8,0
3988,"['celso', 'desigualdad', 'legislativo', 'mello', 'ministrar', 'republico']","[1, 1, 1, 1, 1, 1]","[]","[]",6,0,6,0
3991,"['decorrencia', 'diagnosticar', 'hospitalizar', 'situacao', 'situacao']","[1, 1, 1, 2, 2]","['circular', 'verdadeiro']","[1, 1]",5,2,7,0
3992,"[]","[]","['escutar', 'tumulo', 'tumulo', 'tumulo', 'tumulo']","[1, 4, 4, 4, 4]",0,5,5,0
3993,"[]","[]","['chorar', 'compartilhar']","[1, 1]",0,2,2,0
3994,"['anuncio', 'companhia', 'decisao', 'desafio', 'especialment', 'europeu', 'passageiro', 'passageiro', 'reducao', 'regiao']","[1, 1, 1, 1, 1, 1, 2, 2, 1, 1]","['capturar', 'compartilhar', 'ganhar']","[1, 1, 1]",10,3,13,0
3995,"['companhia', 'moderno', 'respiratorio']","[1, 1, 1]","['assinalar', 'circular', 'clicar', 'postagen', 'telegram', 'usuario', 'versao', 'viralizado', 'visualizar']","[1, 1, 1, 1, 1, 1, 1, 1, 1]",3,9,12,0
3998,"['decorrencia', 'regiao']","[1, 1]","['incendio']","[1]",2,1,3,0
3999,"[]","[]","['amplament', 'compartilhar', 'ganhar', 'usuario']","[1, 1, 1, 1]",0,4,4,0
4000,"['comparacao', 'periodo']","[1, 1]","['enganoso', 'imagem', 'parir', 'parir', 'pelar', 'postagen', 'transposicao']","[1, 1, 2, 2, 1, 1, 1]",2,7,9,0
4001,"['viagem']","[1]","[]","[]",1,0,1,0
4003,"['extensao']","[1]","['circular', 'compartilhar', 'transposicao', 'transposicao']","[1, 1, 2, 2]",1,4,5,0
4005,"['decisao', 'decisao', 'julgamento', 'possibilidad', 'supremo', 'supremo']","[2, 2, 1, 1, 2, 2]","['atribuir', 'checar', 'circular', 'estuprar', 'postagen', 'trafico']","[1, 1, 1, 1, 1, 1]",6,6,12,0
4006,"['suspeito']","[1]","['desmentir', 'fraudar', 'fraudar', 'sobrar']","[1, 2, 2, 1]",1,4,5,0
4007,"[]","[]","['espancar', 'espancar', 'estomago', 'indignacao']","[2, 2, 1, 1]",0,4,4,0
4009,"['alteracao', 'araujo', 'avancar', 'colombio', 'ernesto', 'fundacao', 'ministrar', 'parceria', 'processo', 'proposto', 'realizacao', 'reducao', 'risco']","[1, 1, 1, 1, 1, 1, 1, 1, 1, 1, 1, 1, 1]","[]","[]",13,0,13,0
4012,"[]","[]","['abortar', 'amigar', 'compartilhar', 'segundar']","[1, 1, 1, 1]",0,4,4,0
4015,"['fase']","[1]","['enganoso', 'parir', 'parir']","[1, 2, 2]",1,3,4,0
4016,"['pratico']","[1]","['parir', 'parir']","[2, 2]",1,2,3,0
4017,"[]","[]","['narrativo', 'padrar', 'padrar']","[1, 2, 2]",0,3,3,0
4022,"[]","[]","[]","[]",0,0,0,0
4025,"['adicionar']","[1]","['botao', 'clicar', 'compartilhar', 'compartilhar', 'compartilhar', 'enderecar']","[1, 1, 3, 3, 3, 1]",1,6,7,0
4026,"['determinacao', 'impactar']","[1, 1]","['circular', 'desmentir', 'fraudar', 'imagem']","[1, 1, 1, 1]",2,4,6,0
4028,"['obtido', 'sindicato', 'urbano']","[1, 1, 1]","['circular', 'imagem', 'imagem']","[1, 2, 2]",3,3,6,0
4031,"['reconhecimento']","[1]","[]","[]",1,0,1,0
4032,"['afp', 'monitoramento']","[1, 1]","['canadens', 'checar', 'circular', 'compartilhar', 'verificacao']","[1, 1, 1, 1, 1]",2,5,7,0
4033,"[]","[]","['efarsa', 'quinzen']","[1, 1]",0,2,2,0
4035,"['folhar', 'spaulo']","[1, 1]","['checar', 'lupa']","[1, 1]",2,2,4,0
4039,"['acumular', 'alvaro', 'apostar']","[1, 1, 1]","['curioso', 'enganar', 'fraudar', 'fraudar', 'sortear']","[1, 1, 2, 2, 1]",3,5,8,0
4041,"['infectar', 'ministrar', 'saudar']","[1, 1, 1]","['circular', 'fotografia', 'parir', 'sobrar', 'sobrar']","[1, 1, 1, 2, 2]",3,5,8,0
4044,"['transmissao', 'transmissao', 'transmissao']","[3, 3, 3]","[]","[]",3,0,3,0
4045,"['associacao']","[1]","[]","[]",1,0,1,0
4046,"['destinar', 'destinar', 'oferecido', 'rotina', 'rotina']","[2, 2, 1, 2, 2]","['instrucao', 'motorista', 'motorista']","[1, 2, 2]",5,3,8,0
4047,"[]","[]","['compartilhar']","[1]",0,1,1,0
4048,"['enfrentamento', 'reforcar', 'saudar']","[1, 1, 1]","[]","[]",3,0,3,0
4050,"['reafirmar']","[1]","[]","[]",1,0,1,0
4052,"['congresso', 'plenario']","[1, 1]","['invadir', 'invadir']","[2, 2]",2,2,4,0
4053,"['regiao']","[1]","['drone', 'imagem']","[1, 1]",1,2,3,0
4054,"[]","[]","['gravacao']","[1]",0,1,1,0
4056,"['antonio', 'delacao', 'exministro']","[1, 1, 1]","['circular', 'mansao', 'mansao', 'supostament', 'telejorn']","[1, 2, 2, 1, 1]",3,5,8,0
4057,"[]","[]","[]","[]",0,0,0,0
4059,"['coletivo', 'diariament', 'fase', 'fase', 'fase', 'folhar', 'necessidad']","[1, 1, 3, 3, 3, 1, 1]","['chorar', 'imenso', 'perdao', 'perdao']","[1, 1, 2, 2]",7,4,11,0
4060,"[]","[]","['imagem']","[1]",0,1,1,0
4061,"['medeiro', 'medeiro', 'propagacao']","[2, 2, 1]","['circular', 'compartilhar', 'imagem', 'legendar']","[1, 1, 1, 1]",3,4,7,0
4063,"[]","[]","[]","[]",0,0,0,0
4065,"[]","[]","['circular']","[1]",0,1,1,0
4067,"['cepa', 'cepa', 'fundacao', 'letalidad', 'planar', 'prorrogar', 'sigla']","[2, 2, 1, 1, 1, 1, 1]","['circular', 'logotipo', 'parir', 'postagen', 'segundar', 'vazar', 'vazar']","[1, 1, 1, 1, 1, 2, 2]",7,7,14,0
4068,"[]","[]","['compartilhar', 'faccao', 'fotografo', 'imagem', 'inscricao', 'manipular']","[1, 1, 1, 1, 1, 1]",0,6,6,0
4070,"['circulacao', 'circulacao', 'curso', 'equilibrio', 'observacao']","[2, 2, 1, 1, 1]","['circular']","[1]",5,1,6,0
4071,"['dificuldad', 'regiao', 'republico']","[1, 1, 1]","[]","[]",3,0,3,0
4073,"['imunizacao', 'infeccioso', 'investigacao']","[1, 1, 1]","['enganoso']","[1]",3,1,4,0
4076,"['restritivo']","[1]","['circular', 'compartilhar', 'imagem', 'pelar', 'pelar']","[1, 1, 1, 2, 2]",1,5,6,0
4077,"['calculo', 'espanha', 'indicador', 'taxar']","[1, 1, 1, 1]","['circular']","[1]",4,1,5,0
4078,"['funcionamento']","[1]","['parir', 'pelar', 'segundar', 'sobrar', 'transposicao', 'verificacao']","[1, 1, 1, 1, 1, 1]",1,6,7,0
4081,"['aurelio', 'avancar', 'avancar', 'celso', 'integro', 'lewandowski', 'mello', 'mello', 'ministrar', 'ricardo', 'supremo', 'supremo']","[1, 2, 2, 1, 1, 1, 2, 2, 1, 1, 2, 2]","['atribuir', 'circular', 'estuprar', 'falsar', 'imagem', 'sequer', 'trafico']","[1, 1, 1, 1, 1, 1, 1]",12,7,19,0
4085,"[]","[]","['circular', 'imagem', 'imagem', 'legendar', 'parir', 'reverso']","[1, 2, 2, 1, 1, 1]",0,6,6,0
4086,"['consequencia', 'crise']","[1, 1]","['circular']","[1]",2,1,3,0
4088,"['entregu', 'regrar', 'respostar']","[1, 1, 1]","['enderecar', 'ganhar', 'ganhar', 'ganhar', 'macho', 'parabem', 'parabem', 'parabem', 'questionario', 'selecionar', 'sobrar', 'sortir']","[1, 3, 3, 3, 1, 3, 3, 3, 1, 1, 1, 1]",3,12,15,0
4091,"['folhar', 'ricardo', 'saudar', 'servidor', 'servidor', 'spaulo', 'suspeito']","[1, 1, 1, 2, 2, 1, 1]","['falsar', 'parir', 'parir', 'pelar', 'segundar', 'sobrar']","[1, 2, 2, 1, 1, 1]",7,6,13,0
4095,"['depoimento', 'saudar', 'saudar']","[1, 2, 2]","['checar']","[1]",3,1,4,0
4096,"['depoimento', 'dosar', 'dosar', 'saudar']","[1, 2, 2, 1]","['checar', 'pelar', 'pelar', 'vezar']","[1, 2, 2, 1]",4,4,8,0
4097,"['depoimento', 'saudar']","[1, 1]","['checar']","[1]",2,1,3,0
4098,"['depoimento', 'saudar']","[1, 1]","['checar']","[1]",2,1,3,0
4099,"['depoimento', 'saudar']","[1, 1]","['checar']","[1]",2,1,3,0
4100,"['depoimento', 'saudar']","[1, 1]","['checar']","[1]",2,1,3,0
4103,"['comprometido', 'condicao', 'infectar', 'saudar', 'saudar']","[1, 1, 1, 2, 2]","[]","[]",5,0,5,0
4105,"['distant']","[1]","['circular', 'trafico']","[1, 1]",1,2,3,0
4107,"['aglomeracao', 'orientacao', 'relativo']","[1, 1, 1]","['suco', 'vitaminar']","[1, 1]",3,2,5,0
4110,"['domingo', 'fabricacao', 'fabricacao', 'fabricacao', 'regiao']","[1, 3, 3, 3, 1]","[]","[]",5,0,5,0
4111,"[]","[]","['filmar', 'torturar', 'torturar']","[1, 2, 2]",0,3,3,0
4114,"['companhia', 'desenvolvimento', 'discussao', 'possibilidad', 'saudar', 'voo']","[1, 1, 1, 1, 1, 1]","['amplament', 'circular', 'compartilhar', 'intitular', 'parir', 'parir', 'parir']","[1, 1, 1, 1, 3, 3, 3]",6,7,13,0
4115,"['periodo', 'quedo', 'quedo']","[1, 2, 2]","['chorar', 'chorar', 'chorar']","[3, 3, 3]",3,3,6,0
4119,"['avancar']","[1]","['basto', 'clicar', 'clicar', 'compartilhar', 'compartilhar', 'compartilhar', 'enderecar', 'enderecar', 'ganhar', 'ganhar', 'inscricao', 'preencher', 'selecionar']","[1, 2, 2, 3, 3, 3, 2, 2, 2, 2, 1, 1, 1]",1,13,14,0
4122,"[]","[]","['arquivar']","[1]",0,1,1,0
4123,"['epicentro', 'epidemiar']","[1, 1]","['amplament', 'circular', 'espalhar', 'gravacao', 'gravacao', 'imagem', 'visualizar']","[1, 1, 1, 2, 2, 1, 1]",2,7,9,0
4125,"['autoridad']","[1]","['parir', 'parir', 'parir', 'sobrar']","[3, 3, 3, 1]",1,4,5,0
4127,"['comportamento', 'impactar', 'internar', 'saudar']","[1, 1, 1, 1]","['ganhar', 'ganhar', 'lazaro', 'lazaro', 'lazaro', 'lazaro', 'lazaro', 'lazaro']","[2, 2, 6, 6, 6, 6, 6, 6]",4,8,12,0
4133,"['regiao', 'regiao']","[2, 2]","['circular', 'compartilhar', 'compartilhar', 'nordestino', 'verdadeiro']","[1, 2, 2, 1, 1]",2,5,7,0
4134,"['anuncio', 'pratico', 'prazo', 'resolucao', 'resolucao', 'suspensao', 'suspensao']","[1, 1, 1, 2, 2, 2, 2]","['cnh', 'cnh', 'espalhar']","[2, 2, 1]",7,3,10,0
4135,"['funcao']","[1]","['circular']","[1]",1,1,2,0
4138,"[]","[]","['disseminar', 'usuario']","[1, 1]",0,2,2,0
4139,"['republico']","[1]","['atribuir']","[1]",1,1,2,0
4140,"['florido']","[1]","['circular', 'imagem', 'imenso', 'manchet', 'usuario', 'viralizado', 'visualizacao']","[1, 1, 1, 1, 1, 1, 1]",1,7,8,0
4143,"['californio', 'californio', 'comorbidad', 'extensao', 'isolar', 'positivar', 'pulmonar']","[2, 2, 1, 1, 1, 1, 1]","['fraudar', 'fraudar', 'supostament']","[2, 2, 1]",7,3,10,0
4144,"['ambientar', 'ministrar', 'ricardo', 'sall', 'sall']","[1, 1, 1, 2, 2]","['atribuir', 'circular', 'falsar', 'falsar', 'imagem', 'imagem', 'visualizacao']","[1, 1, 2, 2, 2, 2, 1]",5,7,12,0
4145,"[]","[]","['ganhar', 'pego']","[1, 1]",0,2,2,0
4146,"['exministro', 'exministro', 'fux', 'ministrar', 'ministrar', 'ministrar', 'pacheco', 'pacheco', 'supremo', 'supremo']","[2, 2, 1, 3, 3, 3, 2, 2, 2, 2]","[]","[]",10,0,10,0
4148,"['compromisso']","[1]","['biblia']","[1]",1,1,2,0
4149,"[]","[]","['espalhar']","[1]",0,1,1,0
4150,"['converso']","[1]","['botao', 'clicar', 'clicar', 'compartilhar', 'compartilhar', 'compartilhar']","[1, 2, 2, 3, 3, 3]",1,6,7,0
4151,"['saudar']","[1]","['boicotar', 'vazio']","[1, 1]",1,2,3,0
4152,"['reforcar', 'saudar', 'saudar']","[1, 2, 2]","['circular', 'garganta']","[1, 1]",3,2,5,0
4153,"['crise']","[1]","['amigar', 'imagem', 'intitular', 'macho', 'nordestino', 'reverso', 'viralizada', 'viralizado']","[1, 1, 1, 1, 1, 1, 1, 1]",1,8,9,0
4154,"['bbc']","[1]","['espalhar', 'imagem']","[1, 1]",1,2,3,0
4156,"[]","[]","['menino']","[1]",0,1,1,0
4159,"['congresso', 'economia', 'economia', 'economia', 'gued', 'ministrar', 'prever', 'proposto', 'reuniao']","[1, 3, 3, 3, 1, 1, 1, 1, 1]","['realment']","[1]",9,1,10,0
4163,"[]","[]","[]","[]",0,0,0,0
4164,"['associacao', 'condicao', 'dificuldad', 'dificuldad', 'epidemiar', 'forcatarefa', 'infectar', 'necessario', 'saudar', 'situacao', 'transferir', 'transmissao']","[1, 1, 2, 2, 1, 1, 1, 1, 1, 1, 1, 1]","['copiar', 'garganta', 'garganta', 'garganta', 'garganta', 'nasal', 'parir', 'parir']","[1, 4, 4, 4, 4, 1, 2, 2]",12,8,20,0
4165,"[]","[]","[]","[]",0,0,0,0
4168,"['exigencia']","[1]","['agredir', 'checar', 'escutar', 'melancia', 'sacar']","[1, 1, 1, 1, 1]",1,5,6,0
4171,"['cepa', 'desenvolvimento', 'dialogo', 'positivar']","[1, 1, 1, 1]","['circular', 'espalhar']","[1, 1]",4,2,6,0
4172,"['fundacao', 'portavoz']","[1, 1]","['gretar', 'wylli']","[1, 1]",2,2,4,0
4173,"['infectar', 'infectar']","[2, 2]","['compartilhar', 'ganhar', 'postagen', 'replicar', 'usuario']","[1, 1, 1, 1, 1]",2,5,7,0
4175,"['margem']","[1]","['barragem', 'barragem']","[2, 2]",1,2,3,0
4176,"[]","[]","['camiseta', 'circular', 'espalhar', 'estampar']","[1, 1, 1, 1]",0,4,4,0
4177,"['atrasar', 'respostar']","[1, 1]","['bonner', 'lixar']","[1, 1]",2,2,4,0
4178,"['exjuiz', 'exministro', 'henriqu', 'instituto', 'instituto', 'instituto', 'justicar', 'oficialment']","[1, 1, 1, 3, 3, 3, 1, 1]","['cbn', 'imagem', 'imagem', 'sequer', 'viralizado']","[1, 2, 2, 1, 1]",8,5,13,0
4179,"['balancar', 'saudar']","[1, 1]","['compartilhar', 'espalhar']","[1, 1]",2,2,4,0
4180,"['conjuntar', 'treinamento']","[1, 1]","['circular', 'filmar', 'imagem', 'pego']","[1, 1, 1, 1]",2,4,6,0
4181,"['bruto', 'epidemiologico', 'imunizacao', 'imunizacao', 'modelo', 'necessario', 'painel', 'proporcao']","[1, 1, 2, 2, 1, 1, 1, 1]","['parir']","[1]",8,1,9,0
4182,"['quarentenar', 'tedro']","[1, 1]","['deitar']","[1]",2,1,3,0
4187,"['assistencia', 'biliao', 'comissao']","[1, 1, 1]","['checar']","[1]",3,1,4,0
4188,"['espirito']","[1]","['acidentar']","[1]",1,1,2,0
4190,"[]","[]","['caixao', 'circular', 'espalhar', 'imagem', 'quinzena']","[1, 1, 1, 1, 1]",0,5,5,0
4191,"[]","[]","['checar', 'numericament']","[1, 1]",0,2,2,0
4192,"['saudar', 'taxar']","[1, 1]","['compartilhar', 'enfim', 'sapato']","[1, 1, 1]",2,3,5,0
4193,"['articulacao', 'articulacao', 'carat', 'flavio']","[2, 2, 1, 1]","['camisa', 'desmentir', 'facada', 'facada', 'facada', 'facada', 'facada']","[1, 1, 5, 5, 5, 5, 5]",4,7,11,0
4195,"['crise', 'necessario', 'quedo']","[1, 1, 1]","['sacar']","[1]",3,1,4,0
4198,"['client', 'positivar']","[1, 1]","['circular', 'cuspir', 'cuspir', 'falsar', 'imagem', 'imagem', 'legendar']","[1, 2, 2, 1, 2, 2, 1]",2,7,9,0
4199,"['anuncio', 'aplicacao', 'fluxo', 'surtir']","[1, 1, 1, 1]","['misturar']","[1]",4,1,5,0
4203,"['destinar']","[1]","['soltar']","[1]",1,1,2,0
4205,"['antonio']","[1]","['carrefour', 'carrefour', 'carrefour', 'espancar', 'espancar', 'espancar', 'imagem', 'revoltar']","[3, 3, 3, 3, 3, 3, 1, 1]",1,8,9,0
4207,"[]","[]","['amigar', 'grupar', 'parir']","[1, 1, 1]",0,3,3,0
4209,"['iniciativo']","[1]","['parir', 'quinzena', 'realment', 'sacar']","[1, 1, 1, 1]",1,4,5,0
4212,"['araujo', 'diplomata', 'ernesto', 'itamarati', 'ministrar']","[1, 1, 1, 1, 1]","['circular']","[1]",5,1,6,0
4216,"[]","[]","['circular', 'legendar']","[1, 1]",0,2,2,0
4217,"['regrar', 'respostar']","[1, 1]","['enderecar', 'ganhar', 'ganhar', 'parabem', 'parabem', 'questionario', 'selecionar', 'sortir', 'sortir', 'sortir', 'vazio']","[1, 2, 2, 2, 2, 1, 1, 3, 3, 3, 1]",2,11,13,0
4221,"['assistencia']","[1]","['checar', 'numericament', 'parir']","[1, 1, 1]",1,3,4,0
4222,"['recordar']","[1]","['checar', 'numericament']","[1, 1]",1,2,3,0
4223,"['isolar']","[1]","['checar', 'numericament', 'segundar']","[1, 1, 1]",1,3,4,0
4224,"['celso']","[1]","['checar', 'numericament', 'parir']","[1, 1, 1]",1,3,4,0
4225,"['celso']","[1]","['checar', 'numericament']","[1, 1]",1,2,3,0
4226,"['subir']","[1]","['checar', 'numericament']","[1, 1]",1,2,3,0
4229,"['consequencia']","[1]","['cristao', 'menino']","[1, 1]",1,2,3,0
4231,"['aglomeracao']","[1]","['circular', 'clicar']","[1, 1]",1,2,3,0
4236,"['carat', 'cenario', 'decisao', 'economia', 'juro', 'magistrado', 'pib', 'posicionamento', 'quedo', 'situacao']","[1, 1, 1, 1, 1, 1, 1, 1, 1, 1]","['compartilhar', 'ideologia', 'ideologia']","[1, 2, 2]",10,3,13,0
4238,"['alteracao', 'possibilidad']","[1, 1]","[]","[]",2,0,2,0
4241,"['barroso', 'celso', 'esquema', 'ministrar', 'reuniao']","[1, 1, 1, 1, 1]","['circular']","[1]",5,1,6,0
4242,"['taxar']","[1]","['adorar', 'legendar', 'usuario']","[1, 1, 1]",1,3,4,0
4250,"['patamar']","[1]","['realment']","[1]",1,1,2,0
4251,"['viagem', 'viagem']","[2, 2]","['gleisi', 'gleisi', 'gleisi', 'gleisi', 'gleisi', 'terrorismo', 'terrorismo']","[5, 5, 5, 5, 5, 2, 2]",2,7,9,0
4252,"['adulto', 'quarentenar']","[1, 1]","['abortar', 'abortar', 'estranhar']","[2, 2, 1]",2,3,5,0
4255,"['client', 'client', 'client', 'client', 'extraordinario', 'suspeito']","[4, 4, 4, 4, 1, 1]","['humanar', 'secreto']","[1, 1]",6,2,8,0
4256,"['medeiro', 'nelson', 'resistencia']","[1, 1, 1]","[]","[]",3,0,3,0
4258,"['republico', 'vespera']","[1, 1]","['boatar', 'circular', 'circular', 'insinuar', 'invadir']","[1, 2, 2, 1, 1]",2,5,7,0
4260,"['californio', 'inedito', 'quedo']","[1, 1, 1]","['acidentar', 'acidentar', 'acidentar', 'imagem']","[3, 3, 3, 1]",3,4,7,0
4261,"[]","[]","[]","[]",0,0,0,0
4262,"['gripezinha', 'infectar', 'presenciar', 'santiago', 'santiago']","[1, 1, 1, 2, 2]","[]","[]",5,0,5,0
4263,"[]","[]","[]","[]",0,0,0,0
4264,"['condicao', 'emprestimo', 'marinhar', 'marinhar', 'marinhar']","[1, 1, 3, 3, 3]","[]","[]",5,0,5,0
4265,"[]","[]","[]","[]",0,0,0,0
4267,"['integrant', 'integrant', 'interpretar']","[2, 2, 1]","['circular', 'desfilar']","[1, 1]",3,2,5,0
4270,"['afetado', 'inicialment', 'parcelar', 'prorrogacao']","[1, 1, 1, 1]","['circular', 'compartilhar']","[1, 1]",4,2,6,0
4273,"[]","[]","['circular', 'imagem']","[1, 1]",0,2,2,0
4275,"['proposto']","[1]","['casamentar', 'casamentar', 'catolico', 'enganar', 'maldiz', 'padrar']","[2, 2, 1, 1, 1, 1]",1,6,7,0
4276,"[]","[]","['arquivar', 'arquivar']","[2, 2]",0,2,2,0
4278,"['congresso']","[1]","['circular', 'disfarcar', 'gravacao', 'imagem', 'invadir', 'legendar', 'postagen', 'protestar', 'reverso', 'visualizar']","[1, 1, 1, 1, 1, 1, 1, 1, 1, 1]",1,10,11,0
4279,"['cenario', 'correspondent', 'deteccao', 'globonew', 'planar']","[1, 1, 1, 1, 1]","['arvor', 'circular', 'imagem', 'imagem']","[1, 1, 2, 2]",5,4,9,0
4280,"['propagacao', 'reportar']","[1, 1]","['circular', 'compartilhar', 'imagem', 'imagem', 'imenso', 'sequer', 'soltar']","[1, 1, 2, 2, 1, 1, 1]",2,7,9,0
4283,"['ambientar', 'celso', 'proposto', 'rejeitar', 'saudar', 'sigla']","[1, 1, 1, 1, 1, 1]","['circular']","[1]",6,1,7,0
4286,"['almeida', 'ampliacao', 'jorg', 'machadar', 'marinhar', 'souza']","[1, 1, 1, 1, 1, 1]","[]","[]",6,0,6,0
4287,"[]","[]","['compartilhar', 'pelar']","[1, 1]",0,2,2,0
4288,"['afetado', 'triagem']","[1, 1]","['circular', 'invadir', 'legendar']","[1, 1, 1]",2,3,5,0
4290,"['anuncio', 'caxia', 'duqu', 'fluminens', 'proposto', 'ricardo', 'ricardo', 'ricardo', 'ricardo']","[1, 1, 1, 1, 1, 4, 4, 4, 4]","['amigar', 'libertador', 'libertador', 'libertador']","[1, 3, 3, 3]",9,4,13,0
4291,"['coletivo', 'fase', 'fase', 'fase', 'necessidad', 'planar']","[1, 3, 3, 3, 1, 1]","['chorar', 'imenso', 'perdao']","[1, 1, 1]",6,3,9,0
4292,"[]","[]","['circular', 'imagem', 'quinzena']","[1, 1, 1]",0,3,3,0
4295,"['investigacao', 'metropolitano', 'oliveira', 'regiao']","[1, 1, 1, 1]","['boatar', 'circular', 'compartilhar', 'fraudar', 'sacar', 'sacar']","[1, 1, 1, 1, 2, 2]",4,6,10,0
4296,"['comparacao']","[1]","['assinalar', 'replicar', 'verificar']","[1, 1, 1]",1,3,4,0
4298,"['academiar', 'antonio', 'depoimento', 'dificuldad', 'inicialment', 'lancamento', 'lancamento', 'sobretudo']","[1, 1, 1, 1, 1, 2, 2, 1]","['escutar', 'escutar', 'escutar', 'filmar', 'filmar', 'filmar', 'versao']","[3, 3, 3, 3, 3, 3, 1]",8,7,15,0
4301,"['integrant', 'reuniao', 'reuniao']","[1, 2, 2]","['assassinar', 'circular', 'inscricao', 'reivindicar', 'soltura']","[1, 1, 1, 1, 1]",3,5,8,0
4302,"['reuniao']","[1]","[]","[]",1,0,1,0
4305,"['gestant', 'gestant']","[2, 2]","['abortar', 'abortar', 'abortar', 'vc']","[3, 3, 3, 1]",2,4,6,0
4307,"['economia', 'segredar', 'situacao']","[1, 1, 1]","['gasolina', 'gasolina', 'gasolina', 'gasolina', 'misturar', 'misturar', 'parir', 'parir', 'parir', 'parir', 'parir']","[4, 4, 4, 4, 2, 2, 5, 5, 5, 5, 5]",3,11,14,0
4308,"['fundamentar', 'observar']","[1, 1]","['circular', 'circular', 'idioma', 'realment']","[2, 2, 1, 1]",2,4,6,0
4309,"[]","[]","['cedula']","[1]",0,1,1,0
4310,"['levantamento']","[1]","['circular']","[1]",1,1,2,0
4311,"['adversario', 'adversario', 'sabado']","[2, 2, 1]","['expulsar', 'expulsar', 'libertador', 'libertador']","[2, 2, 2, 2]",3,4,7,0
4314,"['regiao']","[1]","['imagem', 'invadir', 'protestar']","[1, 1, 1]",1,3,4,0
4315,"['previo']","[1]","['efarsa', 'facada', 'realment', 'verdadeiro']","[1, 1, 1, 1]",1,4,5,0
4319,"['campino', 'queiroz']","[1, 1]","['circular']","[1]",2,1,3,0
4321,"['associacao', 'conformar', 'consequencia', 'decorrent', 'estatistico', 'eventualment', 'federar', 'pratico', 'recurso', 'recurso', 'saudar', 'saudar', 'saudar', 'saudar', 'taxar', 'tcu', 'transferencia', 'transferir', 'variacao', 'variacao', 'variacao', 'variacao', 'variacao']","[1, 1, 1, 1, 1, 1, 1, 1, 2, 2, 4, 4, 4, 4, 1, 1, 1, 1, 5, 5, 5, 5, 5]","['parir', 'parir', 'parir', 'parir', 'parir', 'parir', 'pelar', 'pelar', 'pelar', 'pelar', 'pelar', 'segundar', 'sobrar']","[6, 6, 6, 6, 6, 6, 5, 5, 5, 5, 5, 1, 1]",23,13,36,0
4323,"[]","[]","['camiseta', 'camiseta', 'circular', 'imagem', 'imagem', 'usuario', 'verdadeiro']","[2, 2, 1, 2, 2, 1, 1]",0,7,7,0
4324,"['condicao', 'investigacao']","[1, 1]","['incendio', 'incendio']","[2, 2]",2,2,4,0
4327,"['domingo', 'domingo', 'domingo', 'domingo', 'domingo', 'investigacao']","[5, 5, 5, 5, 5, 1]","['assassinar', 'sapato']","[1, 1]",6,2,8,0
4333,"['privilegiar', 'propagacao', 'varga']","[1, 1, 1]","['compartilhar', 'compartilhar', 'imagem', 'usuario']","[2, 2, 1, 1]",3,4,7,0
4334,"['aspecto']","[1]","['espalhar', 'imagem']","[1, 1]",1,2,3,0
4335,"[]","[]","['verificar']","[1]",0,1,1,0
4337,"['infectar']","[1]","['estranhar', 'versao', 'versao', 'versao']","[1, 3, 3, 3]",1,4,5,0
4343,"['necessario', 'risco']","[1, 1]","['incendio']","[1]",2,1,3,0
4344,"['estagio', 'globonew', 'globonew', 'transmissao', 'transmissao']","[1, 2, 2, 2, 2]","['circular', 'imagem', 'imagem', 'legendar', 'legendar']","[1, 2, 2, 2, 2]",5,5,10,0
4348,"['opcao']","[1]","['clicar', 'clicar', 'clicar', 'compartilhar', 'compartilhar', 'preencher']","[3, 3, 3, 2, 2, 1]",1,6,7,0
4352,"[]","[]","[]","[]",0,0,0,0
4356,"['anvisa', 'anvisa', 'anvisa', 'anvisa', 'anvisa', 'vigilancia']","[5, 5, 5, 5, 5, 1]","['basto', 'circular', 'circular', 'falsar', 'logotipo']","[1, 2, 2, 1, 1]",6,5,11,0
4358,"[]","[]","['enfim', 'mafia', 'verdadeiro']","[1, 1, 1]",0,3,3,0
4361,"['conflito', 'conflito']","[2, 2]","['venezuelano']","[1]",2,1,3,0
4362,"['conflito', 'conflito']","[2, 2]","['compartilhar']","[1]",2,1,3,0
4363,"['conflito', 'conflito']","[2, 2]","[]","[]",2,0,2,0
4366,"['escalar', 'taxar']","[1, 1]","['assinalar', 'circular', 'compartilhar', 'gravacao', 'legendar', 'postagen', 'viralizada']","[1, 1, 1, 1, 1, 1, 1]",2,7,9,0
4367,"['adhanom', 'independentement', 'respostar', 'saudar', 'tedro']","[1, 1, 1, 1, 1]","['circular']","[1]",5,1,6,0
4369,"['client', 'esforco', 'etapa', 'reclamacao']","[1, 1, 1, 1]","[]","[]",4,0,4,0
4371,"['concorrent', 'constituicao', 'decisao', 'decisao', 'enfrentamento', 'mudanca', 'nomeacao', 'recurso', 'supremo', 'suspeito', 'suspensao']","[1, 1, 2, 2, 1, 1, 1, 1, 1, 1, 1]","[]","[]",11,0,11,0
4372,"['aliviar', 'alvorar', 'correspondent', 'distrito', 'distrito', 'funcionamento', 'palacio', 'possibilidad', 'rocha']","[1, 1, 1, 2, 2, 1, 1, 1, 1]","['cbn', 'circular', 'desmentir', 'verdadeiro']","[1, 1, 1, 1]",9,4,13,0
4374,"['estatistico', 'sabado', 'sabado', 'transferencia', 'transferencia']","[1, 2, 2, 2, 2]","['vc']","[1]",5,1,6,0
4378,"['federativo', 'pastar', 'pastar', 'piorar', 'republico', 'republico']","[1, 2, 2, 1, 2, 2]","['amigar', 'amigar', 'humanar', 'humanar', 'parabem', 'vagabundar']","[2, 2, 2, 2, 1, 1]",6,6,12,0
4383,"['adotada', 'inedito', 'presenca', 'transmissao']","[1, 1, 1, 1]","['circular', 'protestar', 'usuario']","[1, 1, 1]",4,3,7,0
4384,"['atuam', 'autorizacao', 'divergencia', 'estatistico', 'geografia', 'ibg', 'instituto', 'instituto', 'regiao']","[1, 1, 1, 1, 1, 1, 2, 2, 1]","['compartilhar', 'enganoso']","[1, 1]",9,2,11,0
4386,"['sabado', 'treinar']","[1, 1]","['cartaz']","[1]",2,1,3,0
4387,"['suportar']","[1]","[]","[]",1,0,1,0
4388,"['academiar', 'disseminacao', 'isolar', 'propagacao', 'suspeito', 'transmissao']","[1, 1, 1, 1, 1, 1]","['espalhar', 'espalhar', 'imagem', 'imagem', 'verificacao']","[2, 2, 2, 2, 1]",6,5,11,0
4389,"[]","[]","[]","[]",0,0,0,0
4391,"['regiao']","[1]","['circular', 'circular', 'despejar', 'incendio', 'incendio', 'legendar']","[2, 2, 1, 2, 2, 1]",1,6,7,0
4392,"['coordenar', 'regiao', 'urbano', 'volumar']","[1, 1, 1, 1]","['compartilhar', 'gravacao', 'imagem', 'motorista', 'motorista']","[1, 1, 1, 2, 2]",4,5,9,0
4393,"['afetado', 'comparacao', 'correspondent', 'hospitalizacao', 'hospitalizacao', 'intensivo', 'necessario', 'prever', 'quarentenar', 'situacao', 'ventilador']","[1, 1, 1, 2, 2, 1, 1, 1, 1, 1, 1]","['autopsia', 'autopsia', 'disseminar', 'disseminar', 'filmar', 'limao', 'minutar', 'suco']","[2, 2, 2, 2, 1, 1, 1, 1]",11,8,19,0
4394,"[]","[]","['espalhar', 'imagem']","[1, 1]",0,2,2,0
4395,"[]","[]","['greve', 'greve', 'greve']","[3, 3, 3]",0,3,3,0
4396,"['biliao']","[1]","['arquivar']","[1]",1,1,2,0
4397,"['pagamento', 'vencimento']","[1, 1]","['cadastramento', 'clicar', 'cnh', 'compartilhar', 'compartilhar', 'compartilhar', 'questionario', 'questionario']","[1, 1, 1, 3, 3, 3, 2, 2]",2,8,10,0
4399,"['infectar']","[1]","[]","[]",1,0,1,0
4400,"['autoridad', 'carat', 'integrant', 'integrant', 'justicar', 'ministrar', 'supremo', 'supremo']","[1, 1, 2, 2, 1, 1, 2, 2]","['atribuir', 'imagem', 'misturar']","[1, 1, 1]",8,3,11,0
4401,"[]","[]","['espalhar', 'imagem', 'quinzena']","[1, 1, 1]",0,3,3,0
4402,"['conjuntar']","[1]","[]","[]",1,0,1,0
4406,"['diariament', 'infectar', 'observar']","[1, 1, 1]","['garganta', 'garganta', 'limao', 'limao', 'limao', 'vitaminar', 'vitaminar']","[2, 2, 3, 3, 3, 2, 2]",3,7,10,0
4407,"['positivar']","[1]","['circular', 'compartilhar', 'compartilhar', 'falsar', 'idioma', 'versao']","[1, 2, 2, 1, 1, 1]",1,6,7,0
4408,"['negativar', 'respostar']","[1, 1]","['espalhar', 'terrorismo']","[1, 1]",2,2,4,0
4409,"[]","[]","['circular', 'falsar']","[1, 1]",0,2,2,0
4410,"[]","[]","[]","[]",0,0,0,0
4411,"['fluminens']","[1]","['agredir', 'espancar']","[1, 1]",1,2,3,0
4412,"['depoimento']","[1]","['estranhar', 'quinzena']","[1, 1]",1,2,3,0
4414,"[]","[]","['botao', 'camiseta', 'camiseta', 'camiseta', 'camiseta', 'clicar', 'compartilhar', 'compartilhar', 'compartilhar', 'compartilhar', 'compartilhar', 'enderecar', 'questionario']","[1, 4, 4, 4, 4, 1, 5, 5, 5, 5, 5, 1, 1]",0,13,13,0
4418,"[]","[]","['compartilhar', 'quinzena']","[1, 1]",0,2,2,0
4419,"['autoridad', 'comissao', 'reforcar', 'risco', 'saudar', 'sigla', 'superar']","[1, 1, 1, 1, 1, 1, 1]","['enganir']","[1]",7,1,8,0
4420,"[]","[]","['ganhar']","[1]",0,1,1,0
4421,"[]","[]","[]","[]",0,0,0,0
4422,"['mergulhar']","[1]","['circular', 'imagem', 'imagem', 'legendar', 'manipular', 'reverso']","[1, 2, 2, 1, 1, 1]",1,6,7,0
4424,"['ambito', 'despesa', 'destacar', 'levantamento', 'transmissao']","[1, 1, 1, 1, 1]","['replicar']","[1]",5,1,6,0
4429,"['decisao']","[1]","['circular', 'compartilhar', 'imagem', 'legendar', 'reverso']","[1, 1, 1, 1, 1]",1,5,6,0
4431,"['prazo', 'recurso', 'saudar']","[1, 1, 1]","[]","[]",3,0,3,0
4433,"[]","[]","['circular', 'cristao', 'cristao', 'fotografia', 'imagem', 'legendar', 'postagen', 'usuario']","[1, 2, 2, 1, 1, 1, 1, 1]",0,8,8,0
4434,"['internar', 'nelson', 'nelson']","[1, 2, 2]","['compartilhar', 'imagem', 'usuario']","[1, 1, 1]",3,3,6,0
4435,"['caxia', 'duqu']","[1, 1]","['implantar']","[1]",2,1,3,0
4439,"['bolsonarista', 'estrategia']","[1, 1]","['disfarcar']","[1]",2,1,3,0
4440,"['preocupacao']","[1]","['desgracar', 'enganar', 'enganar', 'enganar', 'filmar', 'fraudar', 'lixar', 'lixar', 'terrorismo', 'terrorismo', 'tumulo', 'versao', 'versao', 'versao', 'versao']","[1, 3, 3, 3, 1, 1, 2, 2, 2, 2, 1, 4, 4, 4, 4]",1,15,16,0
4442,"['aspecto', 'reconhecimento', 'saudar']","[1, 1, 1]","['assinalar', 'capturar', 'enganoso', 'espalhar', 'instrucao', 'intitular', 'replicar', 'usuario', 'usuario']","[1, 1, 1, 1, 1, 1, 1, 2, 2]",3,9,12,0
4443,"['instituto']","[1]","['circular']","[1]",1,1,2,0
4447,"['reducao']","[1]","['casamentar', 'circular', 'imagem', 'imagem', 'imagem', 'legendar', 'menino', 'menino', 'verificacao']","[1, 1, 3, 3, 3, 1, 2, 2, 1]",1,9,10,0
4448,"[]","[]","['efarsa', 'espalhar', 'falsar']","[1, 1, 1]",0,3,3,0
4451,"['aglomeracao']","[1]","['caixao', 'caixao', 'caixao', 'espalhar', 'filmar', 'filmar']","[3, 3, 3, 1, 2, 2]",1,6,7,0
4456,"['ernesto']","[1]","['parabem']","[1]",1,1,2,0
4461,"[]","[]","['imagem', 'soldar']","[1, 1]",0,2,2,0
4464,"[]","[]","['ganhar', 'quinzena']","[1, 1]",0,2,2,0
4465,"['facilitar']","[1]","['atribuir', 'atribuir', 'circular', 'circular', 'falsar', 'gleisi', 'gleisi', 'imagem', 'verificar']","[2, 2, 2, 2, 1, 2, 2, 1, 1]",1,9,10,0
4466,"['antonio', 'distant']","[1, 1]","['acidentar', 'compartilhar', 'descricao', 'descricao', 'enganoso', 'enganoso', 'imagem', 'legendar', 'verdadeiro']","[1, 1, 2, 2, 2, 2, 1, 1, 1]",2,9,11,0
4467,"['realizacao']","[1]","['atribuir', 'circular', 'gleisi', 'gleisi', 'gleisi', 'greve', 'imagem', 'imagem', 'mencao', 'motorista', 'usuario']","[1, 1, 3, 3, 3, 1, 2, 2, 1, 1, 1]",1,11,12,0
4473,"[]","[]","['estranhar']","[1]",0,1,1,0
4478,"['cenario', 'ministrar']","[1, 1]","['circular', 'imagem', 'imagem', 'legendar', 'obama', 'obama', 'obama', 'obama']","[1, 2, 2, 1, 4, 4, 4, 4]",2,8,10,0
4484,"['passageiro']","[1]","['circular', 'crer', 'cuspir', 'idioma', 'imagem', 'imagem', 'legendar', 'parir', 'parir', 'postagen', 'versao']","[1, 1, 1, 1, 2, 2, 1, 2, 2, 1, 1]",1,11,12,0
4485,"['afp', 'antonio', 'positivar', 'positivar', 'saudar', 'saudar']","[1, 1, 2, 2, 2, 2]","['checagem', 'compartilhar', 'compartilhar', 'legendar', 'usuario', 'viralizada']","[1, 2, 2, 1, 1, 1]",6,6,12,0
4488,"['randolf']","[1]","[]","[]",1,0,1,0
4489,"['arthur', 'justicar', 'lira']","[1, 1, 1]","['compartilhar', 'postagen']","[1, 1]",3,2,5,0
4490,"[]","[]","['catolico', 'catolico', 'catolico', 'estranhar', 'imagem', 'imagem']","[3, 3, 3, 1, 2, 2]",0,6,6,0
4491,"[]","[]","['atribuir', 'checagem', 'circular', 'imagem', 'imagem', 'imagem']","[1, 1, 1, 3, 3, 3]",0,6,6,0
4495,"[]","[]","['circular', 'fotografia', 'ganhar', 'imagem', 'legendar', 'viralizado']","[1, 1, 1, 1, 1, 1]",0,6,6,0
4500,"['etapa']","[1]","['botao', 'clicar', 'compartilhar', 'compartilhar', 'compartilhar', 'compartilhar', 'sacar', 'sacar', 'sacar', 'sacar', 'sacar', 'sacar', 'sacar', 'sacar']","[1, 1, 4, 4, 4, 4, 8, 8, 8, 8, 8, 8, 8, 8]",1,14,15,0
4505,"[]","[]","['compartilhar', 'gravacao', 'imagem', 'safar', 'versao']","[1, 1, 1, 1, 1]",0,5,5,0
4508,"['assistencia', 'justicar', 'justicar', 'parceria', 'pratico', 'situacao']","[1, 2, 2, 1, 1, 1]","['boatar', 'circular', 'circular', 'mesario', 'mesario']","[1, 2, 2, 2, 2]",6,5,11,0
4511,"['autoridad', 'autorizacao', 'etapa', 'fase', 'saudar']","[1, 1, 1, 1, 1]","['crer']","[1]",5,1,6,0
4512,"['cepa']","[1]","['sobrar']","[1]",1,1,2,0
4513,"['mantido', 'merkel', 'merkel', 'quarentenar', 'restritivo', 'saudar']","[1, 2, 2, 1, 1, 1]","['compartilhar', 'interaco', 'pego', 'postagen', 'viralizada']","[1, 1, 1, 1, 1]",6,5,11,0
4517,"['contencao', 'curvo', 'estrategia', 'impacto']","[1, 1, 1, 1]","[]","[]",4,0,4,0
4518,"[]","[]","[]","[]",0,0,0,0
4519,"[]","[]","['amplament', 'compartilhar', 'galaxi', 'quinzena']","[1, 1, 1, 1]",0,4,4,0
4521,"['espanha']","[1]","[]","[]",1,0,1,0
4522,"['constituicao', 'expressar', 'expressar', 'preocupacao', 'presidir', 'supremo', 'supremo']","[1, 2, 2, 1, 1, 2, 2]","['compartilhar', 'espalhar', 'garganta', 'invadir']","[1, 1, 1, 1]",7,4,11,0
4523,"[]","[]","[]","[]",0,0,0,0
4525,"['conduta', 'decisao', 'supremo', 'supremo', 'supremo']","[1, 1, 3, 3, 3]","['assaltar', 'compartilhar']","[1, 1]",5,2,7,0
4526,"['converso', 'henri', 'henri', 'justicar', 'medeiro']","[1, 2, 2, 1, 1]","['adelio', 'adelio', 'adelio', 'bispar', 'bispar', 'bispar', 'circular', 'menino', 'menino']","[3, 3, 3, 3, 3, 3, 1, 2, 2]",5,9,14,0
4527,"['cerimonia', 'cerimonia', 'folhar', 'spaulo', 'wilson']","[2, 2, 1, 1, 1]","['circular', 'falsar', 'fotografo', 'imagem', 'legendar']","[1, 1, 1, 1, 1]",5,5,10,0
4529,"['isolar']","[1]","[]","[]",1,0,1,0
4533,"['abordagem', 'domingo']","[1, 1]","['circular', 'legendar']","[1, 1]",2,2,4,0
4534,"['internar', 'surtir']","[1, 1]","[]","[]",2,0,2,0
4538,"['cenario', 'previsao', 'reabertura', 'saudar']","[1, 1, 1, 1]","['realment']","[1]",4,1,5,0
4539,"['preconceito']","[1]","[]","[]",1,0,1,0
4540,"['cometido', 'cometido']","[2, 2]","['lixar', 'parabem', 'pego']","[1, 1, 1]",2,3,5,0
4541,"[]","[]","[]","[]",0,0,0,0
4544,"[]","[]","['cartaz', 'espalhar', 'imagem']","[1, 1, 1]",0,3,3,0
4545,"['crescimento', 'necessario']","[1, 1]","[]","[]",2,0,2,0
4547,"['implementar', 'revogar']","[1, 1]","['enganir', 'sobrar']","[1, 1]",2,2,4,0
4548,"[]","[]","['espalhar', 'grupar', 'humanar', 'quinzena']","[1, 1, 1, 1]",0,4,4,0
4549,"['anuncio']","[1]","['espalhar', 'imagem']","[1, 1]",1,2,3,0
4551,"['tesourar']","[1]","['circular', 'legendar']","[1, 1]",1,2,3,0
4558,"[]","[]","['compartilhar']","[1]",0,1,1,0
4559,"[]","[]","['imagem']","[1]",0,1,1,0
4562,"['republico']","[1]","['adelio', 'adelio', 'bispar', 'compartilhar', 'gleisi', 'imagem']","[2, 2, 1, 1, 1, 1]",1,6,7,0
4565,"['investigacao', 'possibilidad']","[1, 1]","['boatar', 'circular', 'imagem', 'imagem', 'nordestino', 'verdadeiro', 'verificar']","[1, 1, 2, 2, 1, 1, 1]",2,7,9,0
4566,"[]","[]","['falsar', 'fraudar']","[1, 1]",0,2,2,0
4567,"['cenario', 'desafiar', 'enfrentamento', 'inedito', 'investigacao', 'posicionamento', 'precisao', 'proposto', 'saudar', 'velocidad']","[1, 1, 1, 1, 1, 1, 1, 1, 1, 1]","['circular']","[1]",10,1,11,0
4570,"[]","[]","['espalhar', 'minutar']","[1, 1]",0,2,2,0
4571,"['necessidad', 'proposto']","[1, 1]","[]","[]",2,0,2,0
4573,"[]","[]","['boatar', 'circular', 'incendio', 'protestar']","[1, 1, 1, 1]",0,4,4,0
4575,"['calculo', 'constituicao', 'economia', 'emendar', 'prever', 'proposto', 'recebido']","[1, 1, 1, 1, 1, 1, 1]","['verdadeiro', 'verificar']","[1, 1]",7,2,9,0
4576,"['aprovacao']","[1]","['ganhar']","[1]",1,1,2,0
4577,"['destinar', 'destinar', 'desvio', 'desvio', 'esquema', 'investigacao', 'investigacao', 'irregularidad', 'justicar', 'justicar']","[2, 2, 2, 2, 1, 2, 2, 1, 2, 2]","['falsar', 'wylli', 'wylli']","[1, 2, 2]",10,3,13,0
4581,"['instituto', 'opcao', 'quarentenar', 'souza', 'turma', 'turma']","[1, 1, 1, 1, 2, 2]","['basto', 'compartilhar', 'ganhar', 'ganhar', 'ganhar', 'inscricao', 'preencher']","[1, 1, 3, 3, 3, 1, 1]",6,7,13,0
4582,"[]","[]","['assassinar']","[1]",0,1,1,0
4583,"[]","[]","[]","[]",0,0,0,0
4584,"[]","[]","['circular']","[1]",0,1,1,0
4588,"['desenvolvimento', 'exministro', 'exministro', 'individuar', 'supremo']","[1, 2, 2, 1, 1]","['circular', 'imagem']","[1, 1]",5,2,7,0
4591,"['companhia']","[1]","['espalhar', 'quinzena']","[1, 1]",1,2,3,0
4592,"['expressar', 'precisao']","[1, 1]","['circular', 'compartilhar', 'espalhar', 'imagem', 'inscricao', 'legendar', 'legendar', 'missil', 'visualizacao']","[1, 1, 1, 1, 1, 2, 2, 1, 1]",2,9,11,0
4593,"['client', 'trafego']","[1, 1]","['circular', 'imagem', 'legendar', 'reverso']","[1, 1, 1, 1]",2,4,6,0
4594,"[]","[]","['compartilhar', 'ilustrar', 'postagen', 'postagen']","[1, 1, 2, 2]",0,4,4,0
4595,"[]","[]","['compartilhar', 'compartilhar']","[2, 2]",0,2,2,0
4596,"[]","[]","[]","[]",0,0,0,0
4598,"['comprometido', 'descumprir', 'descumprir']","[1, 2, 2]","['circular', 'gravacao', 'manipulacao']","[1, 1, 1]",3,3,6,0
4600,"[]","[]","['amplament', 'compartilhar', 'motorista', 'quinzena']","[1, 1, 1, 1]",0,4,4,0
4602,"[]","[]","['compartilhar', 'sobrar', 'socialismo', 'vezar']","[1, 1, 1, 1]",0,4,4,0
4604,"['dinamarca', 'dinamarca', 'dinamarca', 'estrategico']","[3, 3, 3, 1]","['vc']","[1]",4,1,5,0
4605,"[]","[]","[]","[]",0,0,0,0
4606,"['investigacao', 'justicar', 'justicar', 'ministrar', 'ministrar', 'ministrar', 'oficialment', 'reforcar']","[1, 2, 2, 3, 3, 3, 1, 1]","['cartaz', 'circular', 'circular']","[1, 2, 2]",8,3,11,0
4608,"['condicao', 'situacao', 'trafego']","[1, 1, 1]","['circular', 'gravacao', 'gravacao', 'imagem', 'imagem', 'verificar']","[1, 2, 2, 2, 2, 1]",3,6,9,0
4610,"[]","[]","['circular']","[1]",0,1,1,0
4611,"['fachin', 'ministrar']","[1, 1]","['gleisi']","[1]",2,1,3,0
4612,"['suportar']","[1]","['lixar', 'realment', 'sacar', 'venezuelano']","[1, 1, 1, 1]",1,4,5,0
4615,"['necessidad', 'quarentenar']","[1, 1]","['greve', 'greve', 'greve']","[3, 3, 3]",2,3,5,0
4616,"[]","[]","['versao']","[1]",0,1,1,0
4619,"['equipamento']","[1]","['circular', 'verdadeiro']","[1, 1]",1,2,3,0
4620,"[]","[]","['enderecar']","[1]",0,1,1,0
4621,"['observar']","[1]","['assinalar', 'circular', 'compartilhar', 'legendar']","[1, 1, 1, 1]",1,4,5,0
4625,"[]","[]","['efarsa', 'fotografia', 'realment', 'realment']","[1, 1, 2, 2]",0,4,4,0
4627,"['afp', 'autoridad', 'equipamento', 'humanitario', 'infeccioso', 'infectar', 'moderno', 'periodo', 'portavoz', 'saudar', 'transmissao']","[1, 1, 1, 1, 1, 1, 1, 1, 1, 1, 1]","['humanar', 'viralizada', 'visualizar']","[1, 1, 1]",11,3,14,0
4630,"['equipamento', 'justicar', 'respirador', 'respirador']","[1, 1, 2, 2]","[]","[]",4,0,4,0
4632,"['adesao']","[1]","['pelar', 'pelar']","[2, 2]",1,2,3,0
4633,"['agravar', 'avancar', 'saudar']","[1, 1, 1]","['espalhar']","[1]",3,1,4,0
4635,"['justicar']","[1]","[]","[]",1,0,1,0
4636,"['agravamento', 'agravar', 'internacao', 'intubacao', 'ribeiro', 'saudar', 'saudar', 'saudar', 'situacao']","[1, 1, 1, 1, 1, 3, 3, 3, 1]","['circular']","[1]",9,1,10,0
4637,"[]","[]","['disseminar', 'usuario']","[1, 1]",0,2,2,0
4638,"['instituto', 'necessario', 'oliveira', 'servidor']","[1, 1, 1, 1]","['circular', 'desmentir']","[1, 1]",4,2,6,0
4639,"[]","[]","['imagem', 'narrativo', 'narrativo', 'supostament', 'supostament']","[1, 2, 2, 2, 2]",0,5,5,0
4644,"['domingo', 'domingo', 'epidemiar', 'previsao', 'previsao', 'transmissao']","[2, 2, 1, 2, 2, 1]","['espalhar']","[1]",6,1,7,0
4652,"['apostar']","[1]","['lixar', 'protestar', 'protestar']","[1, 2, 2]",1,3,4,0
4655,"[]","[]","[]","[]",0,0,0,0
4656,"['antonio', 'augusto', 'cale', 'jurista', 'jurista', 'ministrar', 'ministrar', 'oliveira', 'privar', 'rejeicao', 'republico', 'republico', 'republico', 'republico', 'republico', 'subir', 'supremo', 'supremo', 'supremo']","[1, 1, 1, 2, 2, 2, 2, 1, 1, 1, 5, 5, 5, 5, 5, 1, 3, 3, 3]","['compartilhar', 'compartilhar', 'ilustrar', 'parir', 'parir', 'parir', 'pelar', 'pelar']","[2, 2, 1, 3, 3, 3, 2, 2]",19,8,27,0
4658,"['estimativo', 'estimativo', 'recordar', 'recordar']","[2, 2, 2, 2]","['versao']","[1]",4,1,5,0
4660,"['desembarcar', 'espanha']","[1, 1]","['cocaina']","[1]",2,1,3,0
4665,"['antecipar', 'anteontem', 'antonio', 'apurar', 'atuacao', 'colombio', 'congresso', 'crise', 'destacar', 'exportacao', 'exportacao', 'infraestrutura', 'reconhecimento', 'recuperacao', 'velocidad']","[1, 1, 1, 1, 1, 1, 1, 1, 1, 2, 2, 1, 1, 1, 1]","['barragem', 'barragem', 'rompimento', 'secreto', 'venezuelano', 'venezuelano', 'venezuelano']","[2, 2, 1, 1, 3, 3, 3]",15,7,22,0
4668,"['piorar', 'recebido']","[1, 1]","['carrefour', 'desmaiar', 'estuprar']","[1, 1, 1]",2,3,5,0
4669,"['suspenso']","[1]","['cnh', 'cnh', 'cnh', 'parabem', 'vc']","[3, 3, 3, 1, 1]",1,5,6,0
4671,"['ritmar']","[1]","[]","[]",1,0,1,0
4672,"['estatistico']","[1]","['caixao', 'circular', 'compartilhar', 'fingir', 'fingir', 'imagem', 'legendar', 'protestar', 'vazio']","[1, 1, 1, 2, 2, 1, 1, 1, 1]",1,9,10,0
4673,"['equipamento', 'isolar', 'justicar', 'necessario', 'saudar']","[1, 1, 1, 1, 1]","['insinuar']","[1]",5,1,6,0
4674,"[]","[]","['camisa', 'compartilhar', 'curioso', 'imagem']","[1, 1, 1, 1]",0,4,4,0
4681,"['taxar']","[1]","[]","[]",1,0,1,0
4682,"['geraldo', 'geraldo', 'geraldo']","[3, 3, 3]","['espalhar', 'imagem', 'imagem', 'quinzena']","[1, 2, 2, 1]",3,4,7,0
4688,"[]","[]","['bandeiro', 'circular', 'fotografo', 'imagem', 'imagem', 'imagem', 'imagem', 'inscricao', 'legendar']","[1, 1, 1, 4, 4, 4, 4, 1, 1]",0,9,9,0
4689,"['colaboracao', 'instituto', 'souza']","[1, 1, 1]","['adelio', 'adelio', 'atribuir', 'circular', 'facada', 'imagem', 'legendar', 'usuario', 'versao']","[2, 2, 1, 1, 1, 1, 1, 1, 1]",3,9,12,0
4690,"[]","[]","['imagem', 'legendar']","[1, 1]",0,2,2,0
4694,"['regrar', 'respostar']","[1, 1]","['clicar', 'clicar', 'compartilhar', 'compartilhar', 'enderecar', 'ganhar', 'ganhar', 'ganhar', 'ganhar', 'instrucao', 'macho', 'minutar', 'parabem', 'parabem', 'reivindicar', 'selecionar', 'sortir', 'usuario', 'usuario']","[2, 2, 2, 2, 1, 4, 4, 4, 4, 1, 1, 1, 2, 2, 1, 1, 1, 2, 2]",2,19,21,0
4697,"['decisao', 'piorar', 'pratico', 'sabado', 'saudar', 'viagem']","[1, 1, 1, 1, 1, 1]","['basto', 'boatar', 'espalhar', 'imagem', 'menino', 'menino', 'menino', 'menino', 'patrocinador', 'patrocinador', 'patrocinador']","[1, 1, 1, 1, 4, 4, 4, 4, 3, 3, 3]",6,11,17,0
4699,"['republico']","[1]","[]","[]",1,0,1,0
4701,"['confederacao', 'contrato', 'ministrar', 'ministrar', 'recurso', 'supremo']","[1, 1, 2, 2, 1, 1]","['arquivar', 'arquivar', 'arquivar', 'circular']","[3, 3, 3, 1]",6,4,10,0
4703,"[]","[]","['compartilhar']","[1]",0,1,1,0
4704,"['justicar']","[1]","['circular', 'fraudar', 'verdadeiro']","[1, 1, 1]",1,3,4,0
4705,"['anuncio', 'biliao', 'domingo', 'imunizacao', 'imunizacao', 'oficialment', 'parceria', 'previsao', 'saudar', 'saudar']","[1, 1, 1, 2, 2, 1, 1, 1, 2, 2]","['cristao']","[1]",10,1,11,0
4708,"[]","[]","['parabem', 'versao']","[1, 1]",0,2,2,0
4709,"[]","[]","['efarsa', 'pelar', 'pelar']","[1, 2, 2]",0,3,3,0
4711,"['aplicacao', 'diagnosticar', 'funcao', 'necessario']","[1, 1, 1, 1]","[]","[]",4,0,4,0
4712,"['afp', 'antecipar', 'anticorpo']","[1, 1, 1]","['amplament', 'checagem', 'circular', 'pelar', 'postagen', 'supostament', 'telegram', 'vezar', 'viralizada', 'visualizar']","[1, 1, 1, 1, 1, 1, 1, 1, 1, 1]",3,10,13,0
4713,"['exigencia', 'exigencia', 'saudar']","[2, 2, 1]","[]","[]",3,0,3,0
4715,"[]","[]","[]","[]",0,0,0,0
4716,"[]","[]","[]","[]",0,0,0,0
4722,"[]","[]","['amigar']","[1]",0,1,1,0
4723,"['boletim', 'boletim', 'regiao', 'regiao', 'ribeiro', 'ribeiro']","[2, 2, 2, 2, 2, 2]","['compartilhar', 'menino']","[1, 1]",6,2,8,0
4728,"['realizacao', 'realizacao', 'recurso', 'recurso', 'recurso']","[2, 2, 3, 3, 3]","['circular', 'rouanet', 'rouanet']","[1, 2, 2]",5,3,8,0
4729,"['ministrar', 'ministrar', 'sorocaba', 'supremo']","[2, 2, 1, 1]","['compartilhar', 'imagem', 'parir', 'segundar']","[1, 1, 1, 1]",4,4,8,0
4730,"['henri', 'hospitalizar', 'taxar']","[1, 1, 1]","[]","[]",3,0,3,0
4731,"['sabado', 'viagem']","[1, 1]","['bonner', 'bonner', 'bonner', 'bonner', 'bonner', 'circular', 'cnh', 'imagem', 'legendar']","[5, 5, 5, 5, 5, 1, 1, 1, 1]",2,9,11,0
4734,"['martim', 'martim', 'montant']","[2, 2, 1]","['circular', 'compartilhar', 'imagem']","[1, 1, 1]",3,3,6,0
4736,"['esquema', 'habito', 'liderar']","[1, 1, 1]","['adelio', 'ganhar']","[1, 1]",3,2,5,0
4740,"['regrar', 'respostar']","[1, 1]","['clicar', 'clicar', 'compartilhar', 'compartilhar', 'enderecar', 'galaxi', 'galaxi', 'galaxi', 'galaxi', 'galaxi', 'galaxi', 'galaxi', 'ganhar', 'ganhar', 'ganhar', 'ganhar', 'instrucao', 'macho', 'minutar', 'parabem', 'parabem', 'reivindicar', 'selecionar', 'sortir', 'usuario', 'usuario']","[2, 2, 2, 2, 1, 7, 7, 7, 7, 7, 7, 7, 4, 4, 4, 4, 1, 1, 1, 2, 2, 1, 1, 1, 2, 2]",2,26,28,0
4741,"[]","[]","[]","[]",0,0,0,0
4742,"['sabado']","[1]","['atirar', 'circular', 'imagem', 'imagem', 'legendar', 'sequer']","[1, 1, 2, 2, 1, 1]",1,6,7,0
4745,"['ministrar']","[1]","['compartilhar']","[1]",1,1,2,0
4749,"['anticorpo']","[1]","['circular', 'circular', 'idioma', 'telegram', 'viralizada']","[2, 2, 1, 1, 1]",1,5,6,0
4751,"[]","[]","['arquivar', 'legendar']","[1, 1]",0,2,2,0
4752,"['opcao', 'saudar', 'saudar']","[1, 2, 2]","['desligar', 'estranhar', 'questionario']","[1, 1, 1]",3,3,6,0
4753,"['comissao', 'comissao', 'conduta', 'magistrado', 'presidir', 'presidir', 'suprem', 'supremo', 'supremo']","[2, 2, 1, 1, 2, 2, 1, 2, 2]","['abusar', 'espancar', 'narrativo']","[1, 1, 1]",9,3,12,0
4754,"['rossi']","[1]","['fraudar', 'fraudar']","[2, 2]",1,2,3,0
4755,"['californio', 'circulacao', 'domingo', 'observar', 'quedo', 'quedo', 'quedo']","[1, 1, 1, 1, 3, 3, 3]","['acidentar', 'acidentar', 'circular', 'imagem', 'imagem', 'legendar']","[2, 2, 1, 2, 2, 1]",7,6,13,0
4758,"['martim']","[1]","['compartilhar']","[1]",1,1,2,0
4759,"[]","[]","['assassinar', 'catolico', 'catolico', 'compartilhar', 'verdadeiro', 'verdadeiro']","[1, 2, 2, 1, 2, 2]",0,6,6,0
4761,"['jornada']","[1]","[]","[]",1,0,1,0
4764,"[]","[]","['ganhar']","[1]",0,1,1,0
4765,"['transmissao', 'transmissao']","[2, 2]","['espalhar', 'grupar', 'grupar', 'imagem', 'quinzena']","[1, 2, 2, 1, 1]",2,5,7,0
4767,"[]","[]","['compartilhar', 'grupar', 'sobrar', 'sobrar', 'usuario']","[1, 1, 2, 2, 1]",0,5,5,0
4768,"['anteriorment', 'pfizerbiontech', 'respostar']","[1, 1, 1]","['circular', 'filmar', 'filmar', 'imagem', 'intitular', 'manipulacao']","[1, 2, 2, 1, 1, 1]",3,6,9,0
4770,"['afp']","[1]","['carbono', 'checar', 'compartilhar', 'dioxido', 'idioma', 'replicar', 'verificar']","[1, 1, 1, 1, 1, 1, 1]",1,7,8,0
4771,"['broadcast', 'carat']","[1, 1]","['mentiroso']","[1]",2,1,3,0
4773,"['esquema', 'infraestrutura', 'ministrar', 'pratico', 'prazo', 'resolucao', 'resolucao']","[1, 1, 1, 1, 1, 2, 2]","['cnh']","[1]",7,1,8,0
4775,"['colaboracao', 'economia', 'reforcar', 'surtir']","[1, 1, 1, 1]","['atribuir', 'circular', 'imagem']","[1, 1, 1]",4,3,7,0
4780,"[]","[]","['espalhar', 'quinzena']","[1, 1]",0,2,2,0
4781,"['instituto', 'instituto']","[2, 2]","['legendar', 'mentiroso', 'usuario', 'visualizar']","[1, 1, 1, 1]",2,4,6,0
4786,"['equipamento']","[1]","['circular', 'implantar', 'implantar', 'postagen', 'telejorn', 'viralizado']","[1, 2, 2, 1, 1, 1]",1,6,7,0
4789,"[]","[]","['arquivar', 'disseminar', 'visualizacao']","[1, 1, 1]",0,3,3,0
4791,"['interpretar', 'saudar']","[1, 1]","[]","[]",2,0,2,0
4792,"['possibilidad']","[1]","[]","[]",1,0,1,0
4795,"[]","[]","['acidentar', 'amplament', 'bonner', 'compartilhar', 'quinzena', 'versao']","[1, 1, 1, 1, 1, 1]",0,6,6,0
4800,"[]","[]","['desgracar', 'sobrar']","[1, 1]",0,2,2,0
4801,"['depoimento', 'situacao']","[1, 1]","['compartilhar', 'desgracar', 'ganhar', 'ganhar', 'realment', 'realment', 'realment', 'sortir', 'torrar']","[1, 1, 2, 2, 3, 3, 3, 1, 1]",2,9,11,0
4803,"['viagem']","[1]","['espalhar']","[1]",1,1,2,0
4805,"[]","[]","['arquivar', 'circular', 'imagem', 'verificar']","[1, 1, 1, 1]",0,4,4,0
4807,"['toquio']","[1]","['atribuir']","[1]",1,1,2,0
4811,"['autoridad', 'autoridad', 'mexico']","[2, 2, 1]","['amplament', 'circular', 'circular', 'facada', 'imagem', 'legendar', 'verdadeiro']","[1, 2, 2, 1, 1, 1, 1]",3,7,10,0
4812,"['decisao', 'expressar']","[1, 1]","[]","[]",2,0,2,0
4813,"['autoridad', 'autoridad', 'entregu', 'regiao', 'sabado']","[2, 2, 1, 1, 1]","['compartilhar', 'fingir', 'narrativo', 'narrativo', 'trafico', 'vc', 'versao', 'versao', 'versao', 'versao']","[1, 1, 2, 2, 1, 1, 4, 4, 4, 4]",5,10,15,0
4815,"[]","[]","['bandeiro', 'boatar', 'checar', 'circular', 'legendar']","[1, 1, 1, 1, 1]",0,5,5,0
4816,"['decisao', 'demandar', 'fase', 'pratico']","[1, 1, 1, 1]","['abortar', 'abortar', 'abortar', 'circular', 'compartilhar', 'idioma', 'postagen', 'postagen', 'viralizada']","[3, 3, 3, 1, 1, 1, 2, 2, 1]",4,9,13,0
4817,"[]","[]","['minutar']","[1]",0,1,1,0
4818,"[]","[]","['compartilhar', 'filmar', 'filmar', 'quinzena', 'vezar']","[1, 2, 2, 1, 1]",0,5,5,0
4819,"['aglomeracao', 'individuar']","[1, 1]","['enfim', 'invadir', 'parabem', 'parabem', 'versao']","[1, 1, 2, 2, 1]",2,5,7,0
4822,"['contemplar', 'republico']","[1, 1]","['circular', 'filmar', 'fotografo', 'imagem', 'imagem', 'imagem', 'imagem', 'imagem', 'imagem', 'legendar', 'narrativo']","[1, 1, 1, 6, 6, 6, 6, 6, 6, 1, 1]",2,11,13,0
4823,"[]","[]","[]","[]",0,0,0,0
4824,"[]","[]","['legendar']","[1]",0,1,1,0
4828,"['tesourar']","[1]","['abortar', 'circular', 'compartilhar', 'imagem', 'menino', 'postagen']","[1, 1, 1, 1, 1, 1]",1,6,7,0
4831,"[]","[]","['pelar', 'usuario']","[1, 1]",0,2,2,0
4834,"['regiao']","[1]","['compartilhar']","[1]",1,1,2,0
4835,"['piorar', 'situacao']","[1, 1]","['imenso', 'imenso', 'lixar', 'lixar', 'puro', 'realment']","[2, 2, 2, 2, 1, 1]",2,6,8,0
4837,"['administrativo']","[1]","['clicar']","[1]",1,1,2,0
4838,"['cenario', 'economia', 'internar', 'obesidad', 'proprio']","[1, 1, 1, 1, 1]","['ganhar', 'ganhar', 'ganhar']","[3, 3, 3]",5,3,8,0
4840,"['adulto', 'contabilizar', 'estrategia', 'regiao', 'situacao']","[1, 1, 1, 1, 1]","['enganar', 'enganoso', 'missil', 'missil', 'verdadeiro']","[1, 1, 2, 2, 1]",5,5,10,0
4841,"['complicacao', 'cronica', 'enfermagem', 'enfrentamento', 'especifico', 'temporada']","[1, 1, 1, 1, 1, 1]","['canadens', 'circular', 'inocentar']","[1, 1, 1]",6,3,9,0
4842,"['converso', 'domingo', 'domingo', 'especialment']","[1, 2, 2, 1]","['equador']","[1]",4,1,5,0
4849,"['investigacao']","[1]","['adelio', 'bispar', 'circular', 'renunciar', 'wylli', 'wylli', 'wylli']","[1, 1, 1, 1, 3, 3, 3]",1,7,8,0
4850,"['cirurgico', 'externo', 'testagem', 'testagem']","[1, 1, 2, 2]","['espalhar', 'realment', 'vezar', 'vezar']","[1, 1, 2, 2]",4,4,8,0
4852,"['atrasar', 'atrasar', 'equipamento', 'equipamento', 'manutencao', 'modelo', 'prever', 'prever', 'prever', 'reducao']","[2, 2, 2, 2, 1, 1, 3, 3, 3, 1]","[]","[]",10,0,10,0
4854,"['colombio', 'depoimento', 'justicar']","[1, 1, 1]","['desgracar']","[1]",3,1,4,0
4858,"['juro']","[1]","['basto', 'filmar', 'puro', 'verdadeiro']","[1, 1, 1, 1]",1,4,5,0
4863,"[]","[]","[]","[]",0,0,0,0
4865,"[]","[]","[]","[]",0,0,0,0
4866,"['autoridad', 'biliao', 'biliao', 'client', 'companhia', 'definitivo', 'estrategia', 'exministro', 'integrant', 'juro', 'publicitario']","[1, 2, 2, 1, 1, 1, 1, 1, 1, 1, 1]","['amigar', 'amigar', 'boicotar', 'boicotar', 'imagem', 'inocentar']","[2, 2, 2, 2, 1, 1]",11,6,17,0
4867,"[]","[]","['protestar']","[1]",0,1,1,0
4868,"[]","[]","['circular', 'circular', 'imagem', 'vazio']","[2, 2, 1, 1]",0,4,4,0
4870,"['investigacao']","[1]","[]","[]",1,0,1,0
4872,"[]","[]","['quinzena']","[1]",0,1,1,0
4873,"['contrato', 'decisao', 'decisao', 'destinar', 'destinar', 'flavio', 'folhar', 'globonew', 'republico']","[1, 2, 2, 2, 2, 1, 1, 1, 1]","['patrocinador']","[1]",9,1,10,0
4881,"[]","[]","['checar', 'numericament', 'parir']","[1, 1, 1]",0,3,3,0
4882,"[]","[]","['checar', 'numericament']","[1, 1]",0,2,2,0
4883,"['prtb']","[1]","['checar', 'numericament']","[1, 1]",1,2,3,0
4888,"[]","[]","['compartilhar', 'parir', 'pelar', 'sobrar']","[1, 1, 1, 1]",0,4,4,0
4890,"['congresso', 'congresso', 'congresso', 'presenca', 'presenca', 'presenca']","[3, 3, 3, 3, 3, 3]","['compartilhar']","[1]",6,1,7,0
4891,"['pacheco', 'suspeito']","[1, 1]","['manipulacao']","[1]",2,1,3,0
4894,"['converso', 'crise', 'economia', 'epidemiar', 'equipamento', 'escalar', 'paralisar', 'posicionamento', 'quedo', 'reforcar', 'volumar']","[1, 1, 1, 1, 1, 1, 1, 1, 1, 1, 1]","['disseminar']","[1]",11,1,12,0
4895,"[]","[]","[]","[]",0,0,0,0
4897,"['abba', 'autoridad', 'destinar', 'europeu', 'integrant', 'provisorio']","[1, 1, 1, 1, 1, 1]","['compartilhar', 'ilustrar']","[1, 1]",6,2,8,0
4898,"['espanha']","[1]","['bandeiro', 'bandeiro', 'cbn', 'circular', 'espalhar', 'estampar', 'legendar']","[2, 2, 1, 1, 1, 1, 1]",1,7,8,0
4901,"['integro', 'liderar']","[1, 1]","['catolico']","[1]",2,1,3,0
4902,"[]","[]","['atribuir', 'compartilhar', 'espalhar', 'imagem', 'quinzena', 'sobrar', 'supostament']","[1, 1, 1, 1, 1, 1, 1]",0,7,7,0
4905,"['ministrar', 'ministrar', 'ministrar', 'reuniao', 'ricardo', 'sall', 'sall']","[3, 3, 3, 1, 1, 2, 2]","['compartilhar', 'ilustrar', 'postagen']","[1, 1, 1]",7,3,10,0
4908,"['regiao']","[1]","['amigar', 'parir', 'parir', 'parir']","[1, 3, 3, 3]",1,4,5,0
4911,"['domingo', 'domingo', 'integrant', 'integrant', 'regrar', 'sindicato']","[2, 2, 2, 2, 1, 1]","['camisa', 'camiseta', 'protestar', 'viralizado']","[1, 1, 1, 1]",6,4,10,0
4918,"['investigacao', 'privar', 'revogar', 'supremo', 'turma']","[1, 1, 1, 1, 1]","['drone', 'parir', 'parir', 'parir', 'parir', 'parir', 'soltar', 'soltar', 'venezuelano']","[1, 5, 5, 5, 5, 5, 2, 2, 1]",5,9,14,0
4927,"['aliviar', 'cerimoni', 'equipamento', 'jantar', 'saudar']","[1, 1, 1, 1, 1]","['circular', 'legendar', 'legendar', 'verdadeiro']","[1, 2, 2, 1]",5,4,9,0
4929,"[]","[]","[]","[]",0,0,0,0
4934,"['especializar', 'presenca']","[1, 1]","[]","[]",2,0,2,0
4936,"[]","[]","['parir', 'parir', 'protestar']","[2, 2, 1]",0,3,3,0
4937,"['aprovacao', 'ccj']","[1, 1]","['rosario']","[1]",2,1,3,0
4938,"[]","[]","['quinzena']","[1]",0,1,1,0
4941,"['ambientar', 'imunizacao', 'velocidad']","[1, 1, 1]","['circular', 'garganta', 'garganta', 'garganta', 'garganta', 'humanar']","[1, 4, 4, 4, 4, 1]",3,6,9,0
4944,"['biliao', 'biliao']","[2, 2]","['secreto']","[1]",2,1,3,0
4945,"['heleno']","[1]","['facada', 'menino']","[1, 1]",1,2,3,0
4948,"['absoluto']","[1]","['cartaz', 'imagem', 'imagem', 'reivindicar']","[1, 2, 2, 1]",1,4,5,0
4951,"[]","[]","['safar', 'safar']","[2, 2]",0,2,2,0
4952,"['autonomia']","[1]","[]","[]",1,0,1,0
4953,"[]","[]","['grupar']","[1]",0,1,1,0
4956,"['conduta', 'conduta', 'iniciativo', 'republico', 'reuniao', 'reuniao']","[2, 2, 1, 1, 2, 2]","['crech', 'crech', 'parabem', 'verdadeiro', 'verdadeiro']","[2, 2, 1, 2, 2]",6,5,11,0
4957,"[]","[]","['espalhar', 'quinzena']","[1, 1]",0,2,2,0
4958,"['avancar', 'conjuntar', 'determinacao', 'flexibilizacao', 'prorrogacao', 'prorrogar', 'quarentenar', 'quarentenar', 'quarentenar', 'quarentenar']","[1, 1, 1, 1, 1, 1, 4, 4, 4, 4]","['versao']","[1]",10,1,11,0
4959,"['aplicacao']","[1]","[]","[]",1,0,1,0
4960,"['mexico']","[1]","['circular', 'facada', 'imagem', 'imagem']","[1, 1, 2, 2]",1,4,5,0
4962,"['aprovacao', 'constituicao', 'consumidor', 'funcao']","[1, 1, 1, 1]","['enganar', 'parir', 'parir', 'parir', 'parir', 'parir', 'sacar', 'versao', 'versao']","[1, 5, 5, 5, 5, 5, 1, 2, 2]",4,9,13,0
4963,"['escalar', 'michael', 'positivar', 'positivar', 'positivar', 'recurso', 'reuniao']","[1, 1, 3, 3, 3, 1, 1]","['imagem']","[1]",7,1,8,0
4964,"['aliviar', 'distant', 'kong', 'regiao', 'saudar', 'saudar', 'saudar', 'saudar']","[1, 1, 1, 1, 4, 4, 4, 4]","['espalhar']","[1]",8,1,9,0
4965,"['argumentar', 'atuam', 'folhar', 'preconceito', 'regiao', 'spaulo']","[1, 1, 1, 1, 1, 1]","['circular', 'insinuar', 'nordestino', 'nordestino']","[1, 1, 2, 2]",6,4,10,0
4967,"['delacao', 'orientacao']","[1, 1]","['amigar', 'realment']","[1, 1]",2,2,4,0
4968,"[]","[]","[]","[]",0,0,0,0
4969,"['disseminacao', 'realizacao', 'reforcar']","[1, 1, 1]","['boatar', 'circular', 'circular', 'imagem', 'imagem', 'imagem']","[1, 2, 2, 3, 3, 3]",3,6,9,0
4973,"['aprovacao', 'aprovacao', 'etapa', 'negativar', 'negativar']","[2, 2, 1, 2, 2]","['carrefour', 'compartilhar', 'compartilhar', 'preencher', 'preencher']","[1, 2, 2, 2, 2]",5,5,10,0
4974,"[]","[]","['espalhar', 'nordestino']","[1, 1]",0,2,2,0
4975,"[]","[]","['auditoria', 'auditoria']","[2, 2]",0,2,2,0
4976,"[]","[]","['desfilar', 'filmar', 'visualizacao']","[1, 1, 1]",0,3,3,0
4977,"['instituto', 'justificativo', 'presenca', 'saudar', 'sobretudo']","[1, 1, 1, 1, 1]","[]","[]",5,0,5,0
4980,"['barroso', 'condicao', 'investigacao', 'sabatino', 'vulneravel']","[1, 1, 1, 1, 1]","['fraudar', 'realment', 'supostament', 'verificacao', 'verificar']","[1, 1, 1, 1, 1]",5,5,10,0
4981,"['absoluto', 'aprovacao', 'aprovacao', 'aprovacao', 'desempenhar', 'folhar', 'levantamento', 'margem', 'recordar', 'spaulo']","[1, 3, 3, 3, 1, 1, 1, 1, 1, 1]","['ganhar']","[1]",10,1,11,0
4983,"[]","[]","['espalhar', 'imagem', 'quinzena']","[1, 1, 1]",0,3,3,0
4984,"['inquerito', 'investigacao', 'palacio', 'planalto']","[1, 1, 1, 1]","['adelio', 'adelio', 'adelio', 'bispar', 'bispar', 'circular', 'compartilhar', 'imagem', 'mencao']","[3, 3, 3, 2, 2, 1, 1, 1, 1]",4,9,13,0
4985,"['aplicacao', 'imunizacao', 'publicoalvo', 'saudar']","[1, 1, 1, 1]","['compartilhar', 'desmentir', 'imagem', 'parir', 'parir', 'parir', 'sobrar']","[1, 1, 1, 3, 3, 3, 1]",4,7,11,0
4988,"['epidemiar', 'prever']","[1, 1]","['circular', 'imagem', 'inscricao', 'misturar', 'verdadeiro', 'versao']","[1, 1, 1, 1, 1, 1]",2,6,8,0
4990,"[]","[]","['disseminar', 'verificar']","[1, 1]",0,2,2,0
4991,"['planar', 'planar', 'saudar', 'superar']","[2, 2, 1, 1]","['circular']","[1]",4,1,5,0
4992,"['aurelio', 'autoridad', 'lewandowski', 'mello', 'ricardo', 'supremo']","[1, 1, 1, 1, 1, 1]","['circular', 'imagem', 'imagem', 'legendar', 'manipular']","[1, 2, 2, 1, 1]",6,5,11,0
4993,"['compromisso', 'consequencia', 'descumprir', 'magistrado', 'marilia']","[1, 1, 1, 1, 1]","['assassinar', 'insinuar', 'trafico']","[1, 1, 1]",5,3,8,0
4995,"[]","[]","['arquivar']","[1]",0,1,1,0
4996,"['recebido']","[1]","['arquivar', 'disseminar']","[1, 1]",1,2,3,0
4997,"[]","[]","['enganar']","[1]",0,1,1,0
4999,"['atuacao', 'claudio', 'reforcar', 'saudar']","[1, 1, 1, 1]","['fraudar']","[1]",4,1,5,0
5000,"['parceria', 'privar']","[1, 1]","['capturar', 'checar', 'gravacao', 'imagem', 'imagem', 'legendar', 'postagen', 'usuario', 'viralizada']","[1, 1, 1, 2, 2, 1, 1, 1, 1]",2,9,11,0
5003,"[]","[]","['circular', 'misturar']","[1, 1]",0,2,2,0
5004,"[]","[]","['espalhar']","[1]",0,1,1,0
5005,"['ministrar', 'vieira']","[1, 1]","['circular', 'compartilhar', 'postagen']","[1, 1, 1]",2,3,5,0
5007,"[]","[]","['botao', 'clicar', 'compartilhar', 'compartilhar', 'compartilhar', 'enderecar', 'ganhar']","[1, 1, 3, 3, 3, 1, 1]",0,7,7,0
5008,"['possibilidad', 'surtir']","[1, 1]","['logotipo', 'versao']","[1, 1]",2,2,4,0
5009,"[]","[]","[]","[]",0,0,0,0
5010,"[]","[]","['venezuelano']","[1]",0,1,1,0
5014,"['fase']","[1]","['circular', 'cnh', 'cnh', 'cnh', 'inscricao', 'inscricao', 'motorista', 'verificar']","[1, 3, 3, 3, 2, 2, 1, 1]",1,8,9,0
5015,"[]","[]","['arquivar', 'compartilhar', 'usuario']","[1, 1, 1]",0,3,3,0
5022,"[]","[]","['atribuir']","[1]",0,1,1,0
5023,"['apreensao', 'internacao']","[1, 1]","['atirar', 'circular', 'invadir']","[1, 1, 1]",2,3,5,0
5026,"[]","[]","[]","[]",0,0,0,0
5029,"[]","[]","['compartilhar', 'ilustrar', 'imagem', 'postagen', 'replicar', 'usuario']","[1, 1, 1, 1, 1, 1]",0,6,6,0
5030,"['motivacao']","[1]","['efarsa', 'realment', 'verificar']","[1, 1, 1]",1,3,4,0
5035,"['estimular', 'estimular', 'impactar', 'impactar', 'transmissao', 'transmissao']","[2, 2, 2, 2, 2, 2]","['compartilhar', 'compartilhar', 'humanar', 'humanar']","[2, 2, 2, 2]",6,4,10,0
5037,"['desenvolvido', 'medeiro', 'saudar', 'saudar']","[1, 1, 2, 2]","['catolico', 'circular', 'limao', 'limao']","[1, 1, 2, 2]",4,4,8,0
5041,"[]","[]","['compartilhar', 'legendar', 'replicar', 'usuario']","[1, 1, 1, 1]",0,4,4,0
5042,"['consultoria', 'habito']","[1, 1]","['atribuir', 'botao', 'circular', 'fraudar']","[1, 1, 1, 1]",2,4,6,0
5045,"['alternativo', 'bbc', 'decisao', 'decisao', 'decisao', 'economia', 'facilitar', 'impactar', 'liderar', 'oficialment', 'pagamento', 'sancao']","[1, 1, 3, 3, 3, 1, 1, 1, 1, 1, 1, 1]","[]","[]",12,0,12,0
5046,"['planalto']","[1]","['imagem']","[1]",1,1,2,0
5047,"['decorrencia', 'exercicio', 'periodo']","[1, 1, 1]","['compartilhar', 'espalhar', 'parir', 'parir']","[1, 1, 2, 2]",3,4,7,0
5048,"[]","[]","[]","[]",0,0,0,0
5049,"[]","[]","['compartilhar']","[1]",0,1,1,0
5055,"[]","[]","[]","[]",0,0,0,0
5056,"['associacao', 'avancar', 'prever', 'recurso', 'sindicato']","[1, 1, 1, 1, 1]","['socialismo']","[1]",5,1,6,0
5062,"['especifico', 'reforcar', 'saudar', 'saudar', 'surtir']","[1, 1, 2, 2, 1]","['circular', 'compartilhar', 'vitaminar']","[1, 1, 1]",5,3,8,0
5064,"['estimativo', 'modelo']","[1, 1]","[]","[]",2,0,2,0
5065,"['aplicacao', 'ausencia', 'determinacao', 'previsto', 'punicao', 'regrar']","[1, 1, 1, 1, 1, 1]","[]","[]",6,0,6,0
5066,"[]","[]","['soltar', 'soltar']","[2, 2]",0,2,2,0
5067,"[]","[]","['circular', 'imagem', 'imagem', 'imagem', 'legendar']","[1, 3, 3, 3, 1]",0,5,5,0
5068,"['anticorpo', 'demandar', 'demandar', 'deteccao', 'impacto', 'imunizacao', 'presenca', 'saudar', 'testagem']","[1, 2, 2, 1, 1, 1, 1, 1, 1]","['cbn', 'circular']","[1, 1]",9,2,11,0
5069,"['desenvolvido', 'dosar']","[1, 1]","['circular', 'imagem', 'legendar']","[1, 1, 1]",2,3,5,0
5074,"['henriqu', 'substituicao']","[1, 1]","['compartilhar']","[1]",2,1,3,0
5075,"['autoridad', 'respiratorio', 'semestr', 'surtir', 'taxar']","[1, 1, 1, 1, 1]","['misericordia']","[1]",5,1,6,0
5076,"['aglomeracao', 'condicao', 'especifico', 'inicialment', 'mandatario', 'ministrar', 'necessario', 'saudar']","[1, 1, 1, 1, 1, 1, 1, 1]","['enganir', 'gravacao', 'legendar', 'parir', 'sobrar']","[1, 1, 1, 1, 1]",8,5,13,0
5078,"['biliao', 'bruno']","[1, 1]","['circular', 'compartilhar', 'ilustrar', 'imagem', 'postagen', 'rouanet', 'rouanet', 'torrar']","[1, 1, 1, 1, 1, 2, 2, 1]",2,8,10,0
5079,"['necessario']","[1]","['compartilhar', 'motorista', 'sortir', 'verificar']","[1, 1, 1, 1]",1,4,5,0
5081,"['republico']","[1]","['implantar', 'implantar']","[2, 2]",1,2,3,0
5083,"['acompanhamento', 'armazenamento', 'investigacao', 'suspeito']","[1, 1, 1, 1]","['circular', 'espalhar', 'legendar', 'manipular']","[1, 1, 1, 1]",4,4,8,0
5084,"[]","[]","[]","[]",0,0,0,0
5085,"['antonio']","[1]","['espalhar', 'quinzena']","[1, 1]",1,2,3,0
5086,"[]","[]","[]","[]",0,0,0,0
5089,"['forcatarefa', 'inquerito', 'instituto']","[1, 1, 1]","['basto', 'compartilhar', 'enderecar']","[1, 1, 1]",3,3,6,0
5090,"[]","[]","[]","[]",0,0,0,0
5091,"['bolsonarista', 'estimativo', 'sabado']","[1, 1, 1]","['parir', 'parir', 'pelar', 'pelar', 'segundar', 'sobrar', 'usuario']","[2, 2, 2, 2, 1, 1, 1]",3,7,10,0
5092,"['europeu', 'habitant', 'reflexo', 'republico', 'republico', 'republico', 'republico']","[1, 1, 1, 4, 4, 4, 4]","['agredir', 'catolico', 'cristao', 'cristao', 'cristao', 'cristao']","[1, 1, 4, 4, 4, 4]",7,6,13,0
5094,"[]","[]","['imagem', 'quinzena']","[1, 1]",0,2,2,0
5095,"['coordenar', 'decorrencia', 'henriqu', 'ministrar', 'privar', 'respostar', 'saudar', 'saudar', 'saudar']","[1, 1, 1, 1, 1, 1, 3, 3, 3]","['compartilhar']","[1]",9,1,10,0
5096,"['adotada', 'propagacao']","[1, 1]","['amplament', 'circular', 'compartilhar', 'imagem', 'postagen', 'reverso', 'viralizada']","[1, 1, 1, 1, 1, 1, 1]",2,7,9,0
5097,"['cirurgico', 'cirurgico', 'queixar']","[2, 2, 1]","['compartilhar', 'compartilhar', 'imagem']","[2, 2, 1]",3,3,6,0
5099,"['taxar']","[1]","[]","[]",1,0,1,0
5102,"['afetado', 'crise', 'crise', 'pagamento', 'prever', 'previsao', 'recurso']","[1, 2, 2, 1, 1, 1, 1]","['compartilhar', 'sacar', 'sacar']","[1, 2, 2]",7,3,10,0
5104,"[]","[]","['imenso']","[1]",0,1,1,0
5112,"['taxar']","[1]","['compartilhar', 'espalhar', 'espalhar', 'versao']","[1, 2, 2, 1]",1,4,5,0
5115,"['afastamento', 'airlin', 'alvaro', 'destinar', 'passageiro', 'passageiro']","[1, 1, 1, 1, 2, 2]","['auditoria', 'fraudar', 'gravacao', 'legendar']","[1, 1, 1, 1]",6,4,10,0
5123,"['suspeito', 'suspeito']","[2, 2]","['circular', 'imagem', 'imagem', 'legendar']","[1, 2, 2, 1]",2,4,6,0
5124,"[]","[]","[]","[]",0,0,0,0
5126,"['bolsonarista', 'gabinet', 'gabinet', 'gabinet', 'gabinet', 'pslrj', 'sabado', 'silveiro', 'silveiro', 'silveiro', 'silveiro']","[1, 4, 4, 4, 4, 1, 1, 4, 4, 4, 4]","['compartilhar', 'pelar', 'vazar', 'vazar', 'versao', 'versao', 'versao', 'versao']","[1, 1, 2, 2, 4, 4, 4, 4]",11,8,19,0
5131,"['apurar', 'internar', 'investigacao', 'plantao', 'saudar', 'saudar', 'saudar', 'vigilancia']","[1, 1, 1, 1, 3, 3, 3, 1]","['circular', 'legendar']","[1, 1]",8,2,10,0
5133,"['calendario', 'calendario', 'decisao', 'inclusao', 'proliferacao', 'vetar', 'vetar', 'vetar']","[2, 2, 1, 1, 1, 3, 3, 3]","['compartilhar', 'verdadeiro']","[1, 1]",8,2,10,0
5134,"['diagnosticar', 'precandidato']","[1, 1]","['boatar', 'insinuar']","[1, 1]",2,2,4,0
5135,"['almeida']","[1]","['circular', 'incendio']","[1, 1]",1,2,3,0
5138,"['acompanhamento', 'adotada', 'consorcio', 'decisao', 'decorrent', 'impactar', 'levantamento', 'relativo', 'saudar', 'saudar', 'tcu', 'tcu']","[1, 1, 1, 1, 1, 1, 1, 1, 2, 2, 2, 2]","['checar', 'parir', 'parir', 'pelar', 'pelar', 'segundar', 'sobrar']","[1, 2, 2, 2, 2, 1, 1]",12,7,19,0
5140,"[]","[]","[]","[]",0,0,0,0
5146,"['expressivo']","[1]","[]","[]",1,0,1,0
5147,"[]","[]","['parabem', 'parir', 'pelar']","[1, 1, 1]",0,3,3,0
5148,"[]","[]","['gleisi', 'parir', 'terrorismo']","[1, 1, 1]",0,3,3,0
5149,"['helen', 'prescricao', 'quadro']","[1, 1, 1]","['zincar']","[1]",3,1,4,0
5150,"['acumular', 'segredar']","[1, 1]","['circular', 'compartilhar', 'ilustrar', 'imagem']","[1, 1, 1, 1]",2,4,6,0
5153,"['abordagem', 'abordagem', 'adotada', 'ministrar', 'ministrar', 'ministrar', 'posturar', 'respostar', 'suspeito', 'transmissao']","[2, 2, 1, 3, 3, 3, 1, 1, 1, 1]","['circular', 'imagem', 'protestar', 'protestar']","[1, 1, 2, 2]",10,4,14,0
5157,"['congresso']","[1]","['padrar']","[1]",1,1,2,0
5158,"['particularment']","[1]","['obama', 'obama', 'obama', 'obama', 'privacidad', 'secreto']","[4, 4, 4, 4, 1, 1]",1,6,7,0
5160,"['anvisa', 'anvisa', 'vigilancia']","[2, 2, 1]","['compartilhar', 'parir', 'parir', 'parir', 'segundar', 'usuario']","[1, 3, 3, 3, 1, 1]",3,6,9,0
5161,"['anvisa', 'articulacao', 'concedido', 'destacar', 'saudar', 'saudar']","[1, 1, 1, 1, 2, 2]","['enganoso', 'versao', 'zincar', 'zincar']","[1, 1, 2, 2]",6,4,10,0
5162,"['ausencia', 'californio', 'quarentenar', 'turista']","[1, 1, 1, 1]","[]","[]",4,0,4,0
5163,"['aglomeracao', 'conformar', 'infectar', 'necessidad', 'presenca', 'propagacao', 'quarentenar', 'reforcar', 'saudar', 'suspensao']","[1, 1, 1, 1, 1, 1, 1, 1, 1, 1]","['desmentir', 'viralizado']","[1, 1]",10,2,12,0
5164,"[]","[]","[]","[]",0,0,0,0
5166,"['aglomeracao', 'autoridad']","[1, 1]","['circular', 'desmentir', 'legendar', 'verificar']","[1, 1, 1, 1]",2,4,6,0
5167,"['client', 'client', 'habito', 'jantar', 'normalment', 'reclamacao', 'reclamacao', 'reclamacao', 'reclamacao']","[2, 2, 1, 1, 1, 4, 4, 4, 4]","['curioso']","[1]",9,1,10,0
5176,"['folhar']","[1]","[]","[]",1,0,1,0
5177,"['funcao', 'funcao', 'rotina']","[2, 2, 1]","['compartilhar']","[1]",3,1,4,0
5182,"['economia', 'observacao']","[1, 1]","['disseminar', 'ganhar', 'nobel', 'nobel', 'nobel']","[1, 1, 3, 3, 3]",2,5,7,0
5185,"['gripezinha', 'implementar', 'propagacao']","[1, 1, 1]","[]","[]",3,0,3,0
5187,"['colombio', 'fronteiro', 'fronteiro', 'quedo', 'quilometro']","[1, 2, 2, 1, 1]","['acidentar', 'acidentar', 'circular', 'circular', 'legendar']","[2, 2, 2, 2, 1]",5,5,10,0
5188,"['julgamento', 'prazo', 'regrar']","[1, 1, 1]","['copiar', 'imagem', 'lembres', 'lembres', 'vc', 'vc']","[1, 1, 2, 2, 2, 2]",3,6,9,0
5189,"['quedo']","[1]","['supostament']","[1]",1,1,2,0
5190,"[]","[]","['compartilhar']","[1]",0,1,1,0
5191,"['aprovacao', 'juro', 'juro', 'juro', 'negativar', 'negativar', 'prazo']","[1, 3, 3, 3, 2, 2, 1]","['compartilhar', 'compartilhar', 'parabem', 'preencher']","[2, 2, 1, 1]",7,4,11,0
5194,"['destinar', 'internar', 'regiao']","[1, 1, 1]","['circular', 'enfim', 'vazio', 'vazio']","[1, 1, 2, 2]",3,4,7,0
5199,"['fundacao', 'fundacao', 'fundacao', 'fundacao']","[4, 4, 4, 4]","['chorar', 'chorar', 'compartilhar', 'compartilhar', 'menino', 'menino', 'pego', 'pego']","[2, 2, 2, 2, 2, 2, 2, 2]",4,8,12,0
5200,"['avancar', 'avancar', 'desenvolvimento', 'estagio', 'estagio', 'prazo', 'respostar']","[2, 2, 1, 2, 2, 1, 1]","['circular', 'circular', 'circular', 'compartilhar', 'compartilhar']","[3, 3, 3, 2, 2]",7,5,12,0
5201,"['comportamento', 'exprefeito', 'lavagem', 'pagamento', 'periodo', 'respostar', 'situacao', 'taxar', 'viagem']","[1, 1, 1, 1, 1, 1, 1, 1, 1]","['abusar', 'abusar', 'acidentar', 'acidentar', 'filmar', 'imagem', 'menino', 'menino', 'menino', 'obama', 'obama']","[2, 2, 2, 2, 1, 1, 3, 3, 3, 2, 2]",9,11,20,0
5208,"[]","[]","['circular', 'filmar', 'filmar', 'imagem', 'imagem', 'imagem', 'reverso', 'usuario']","[1, 2, 2, 3, 3, 3, 1, 1]",0,8,8,0
5209,"[]","[]","[]","[]",0,0,0,0
5210,"['relaxar']","[1]","['circular', 'dorio']","[1, 1]",1,2,3,0
5211,"['infectar', 'saudar', 'transmissao', 'transmissao', 'transmissao']","[1, 1, 3, 3, 3]","[]","[]",5,0,5,0
5212,"[]","[]","['espalhar', 'fraudar', 'quinzena']","[1, 1, 1]",0,3,3,0
5216,"['antonio', 'antonio', 'fundacao', 'queixar']","[2, 2, 1, 1]","['compartilhar']","[1]",4,1,5,0
5217,"[]","[]","['circular', 'expulsar', 'expulsar', 'imagem', 'legendar', 'soltar', 'visualizacao']","[1, 2, 2, 1, 1, 1, 1]",0,7,7,0
5221,"['volumar']","[1]","['gravacao', 'motorista']","[1, 1]",1,2,3,0
5223,"['consumidor']","[1]","['compartilhar', 'enganar']","[1, 1]",1,2,3,0
5225,"['isolar', 'margem']","[1, 1]","['arvor', 'invadir', 'privacidad']","[1, 1, 1]",2,3,5,0
5226,"['crise', 'europeu', 'exercicio', 'preparacao']","[1, 1, 1, 1]","['circular', 'imagem', 'imagem', 'legendar', 'parir', 'parir']","[1, 2, 2, 1, 2, 2]",4,6,10,0
5230,"['alvaro', 'constatar', 'consultoria', 'decisao', 'dificuldad', 'exministro', 'exministro', 'favorito', 'importancia', 'justicar', 'justicar', 'parceria', 'planalto', 'possibilidad', 'prtb', 'renata', 'republico', 'sigla']","[1, 1, 1, 1, 1, 2, 2, 1, 1, 2, 2, 1, 1, 1, 1, 1, 1, 1]","['circular', 'grupar', 'parir', 'parir', 'parir', 'parir', 'parir', 'parir', 'parir', 'pelar', 'pelar', 'pelar']","[1, 1, 7, 7, 7, 7, 7, 7, 7, 3, 3, 3]",18,12,30,0
5231,"['constituicao', 'inquerito', 'preocupacao', 'presidir', 'supremo', 'supremo']","[1, 1, 1, 1, 2, 2]","['garganta']","[1]",6,1,7,0
5234,"[]","[]","[]","[]",0,0,0,0
5235,"['expressar', 'folhar', 'folhar', 'folhar', 'republico', 'souza', 'supremo']","[1, 3, 3, 3, 1, 1, 1]","['espalhar', 'estampar']","[1, 1]",7,2,9,0
5236,"['republico']","[1]","['compartilhar']","[1]",1,1,2,0
5238,"['anteriorment', 'iniciativo', 'planar', 'privar', 'proposto', 'proposto']","[1, 1, 1, 1, 2, 2]","[]","[]",6,0,6,0
5239,"[]","[]","['filmar']","[1]",0,1,1,0
5241,"['cerimonia', 'palacio', 'planalto', 'republico', 'treinar']","[1, 1, 1, 1, 1]","['atribuir', 'circular', 'compartilhar', 'ganhar', 'imagem']","[1, 1, 1, 1, 1]",5,5,10,0
5244,"['condenacao', 'decisao', 'ministrar', 'ministrar', 'proferir', 'queiroz', 'supremo']","[1, 1, 2, 2, 1, 1, 1]","['circular', 'imagem', 'imagem']","[1, 2, 2]",7,3,10,0
5248,"['crise', 'plenario']","[1, 1]","['checar', 'circular', 'ganhar', 'minutar']","[1, 1, 1, 1]",2,4,6,0
5250,"['ansiedad']","[1]","['circular', 'fotografia', 'imagem', 'lembres', 'postagen']","[1, 1, 1, 1, 1]",1,5,6,0
5255,"['comissao', 'toquio']","[1, 1]","['quinzena']","[1]",2,1,3,0
5256,"['administrativo', 'constituicao', 'constituicao', 'constituicao', 'coordenar', 'decisao', 'desigualdad', 'federativo', 'funcionamento', 'fundamentar', 'integro', 'jurista', 'previsto', 'republico', 'republico', 'republico', 'republico', 'saudar', 'saudar', 'saudar', 'souza', 'supremo', 'supremo']","[1, 3, 3, 3, 1, 1, 1, 1, 1, 1, 1, 1, 1, 4, 4, 4, 4, 3, 3, 3, 1, 2, 2]","[]","[]",23,0,23,0
5258,"['atuacao']","[1]","['espalhar']","[1]",1,1,2,0
5259,"[]","[]","[]","[]",0,0,0,0
5260,"['alckmin', 'alckmin', 'alckmin']","[3, 3, 3]","[]","[]",3,0,3,0
5262,"[]","[]","['compartilhar', 'gravacao', 'limao', 'suco']","[1, 1, 1, 1]",0,4,4,0
5263,"['ministrar', 'nelson', 'recordar', 'teich']","[1, 1, 1, 1]","[]","[]",4,0,4,0
5264,"['europeu', 'plano']","[1, 1]","['circular', 'minutar', 'usuario', 'visualizacao']","[1, 1, 1, 1]",2,4,6,0
5266,"['acompanhamento', 'anticorpo', 'calamidad', 'cenario', 'comunitario', 'cronica', 'disseminacao', 'economia', 'epidemiar', 'epidemiar', 'epidemiar', 'epidemiar', 'epidemiar', 'epidemiar', 'epidemiar', 'epidemiar', 'epidemiar', 'exercicio', 'exercicio', 'imunizacao', 'imunizacao', 'internacao', 'isolar', 'isolar', 'necessario', 'normalment', 'orientacao', 'orientacao', 'particularment', 'pratico', 'reducao', 'reforcar', 'respirador', 'respostar', 'saudar', 'saudar', 'saudar', 'saudar', 'treinar']","[1, 1, 1, 1, 1, 1, 1, 1, 9, 9, 9, 9, 9, 9, 9, 9, 9, 2, 2, 2, 2, 1, 2, 2, 1, 1, 2, 2, 1, 1, 1, 1, 1, 1, 4, 4, 4, 4, 1]","['abencoar', 'enganar', 'enganar', 'puro', 'puro', 'vitaminar', 'vitaminar']","[1, 2, 2, 2, 2, 2, 2]",39,7,46,0
5267,"['bbc', 'diariament', 'palacio']","[1, 1, 1]","['casamentar']","[1]",3,1,4,0
5268,"[]","[]","['amigar', 'camiseta', 'camiseta', 'compartilhar', 'imagem', 'imagem']","[1, 2, 2, 1, 2, 2]",0,6,6,0
5270,"[]","[]","['ganhar']","[1]",0,1,1,0
5272,"['investigacao']","[1]","[]","[]",1,0,1,0
5273,"['fundacao', 'fundacao', 'quilometro']","[2, 2, 1]","['abusar', 'abusar']","[2, 2]",3,2,5,0
5275,"['infectar']","[1]","['zincar']","[1]",1,1,2,0
5276,"['ernesto', 'especialment', 'gripezinha', 'parceiro', 'respiratorio', 'saudar']","[1, 1, 1, 1, 1, 1]","['basto', 'compartilhar', 'ganhar', 'pego']","[1, 1, 1, 1]",6,4,10,0
5277,"['deteccao', 'espanha', 'quarentenar', 'situacao']","[1, 1, 1, 1]","['amplament', 'circular', 'compartilhar', 'filmar', 'postagen', 'replicar', 'versao']","[1, 1, 1, 1, 1, 1, 1]",4,7,11,0
5278,"['decisao', 'decisao', 'turma']","[2, 2, 1]","['circular', 'compartilhar', 'indignacao', 'postagen', 'soltar', 'soltar', 'verdadeiro', 'viralizada']","[1, 1, 1, 1, 2, 2, 1, 1]",3,8,11,0
5279,"['arrecadar', 'biliao', 'biliao', 'desafiar', 'desenvolvimento', 'emprestimo', 'queiroz', 'republico']","[1, 2, 2, 1, 1, 1, 1, 1]","['barragem', 'compartilhar', 'enfim', 'revoltar']","[1, 1, 1, 1]",8,4,12,0
5280,"['argumentar', 'dosar', 'europeu', 'ritmar']","[1, 1, 1, 1]","['parir']","[1]",4,1,5,0
5281,"[]","[]","[]","[]",0,0,0,0
5284,"['carat', 'circulacao', 'conformar', 'exercicio', 'flavio', 'integrant', 'justicar', 'pslrj']","[1, 1, 1, 1, 1, 1, 1, 1]","['camiseta', 'circular', 'imagem', 'imagem', 'realment']","[1, 1, 2, 2, 1]",8,5,13,0
5285,"['cerimonia']","[1]","['atirar', 'caixao', 'caixao', 'compartilhar', 'disseminar', 'gravacao', 'imagem', 'imagem', 'postagen', 'sacar', 'verdadeiro']","[1, 2, 2, 1, 1, 1, 2, 2, 1, 1, 1]",1,11,12,0
5286,"[]","[]","['compartilhar']","[1]",0,1,1,0
5288,"['descumprir', 'preocupacao', 'quarentenar', 'reforcar']","[1, 1, 1, 1]","['imagem', 'postagen', 'postagen']","[1, 2, 2]",4,3,7,0
5289,"['airlin', 'preventivo', 'preventivo']","[1, 2, 2]","[]","[]",3,0,3,0
5291,"['constatar', 'imunizacao', 'reducao']","[1, 1, 1]","['circular', 'circular', 'manchet', 'parir', 'parir', 'parir', 'pelar', 'pelar', 'usuario', 'usuario']","[2, 2, 1, 3, 3, 3, 2, 2, 2, 2]",3,10,13,0
5292,"['aurelio', 'bastidor', 'bastidor', 'celso', 'diagnosticar', 'ministrar', 'ministrar', 'ministrar', 'ministrar', 'ministrar', 'supremo']","[1, 2, 2, 1, 1, 5, 5, 5, 5, 5, 1]","['realment']","[1]",11,1,12,0
5294,"[]","[]","['realment']","[1]",0,1,1,0
5295,"[]","[]","['abusar', 'circular']","[1, 1]",0,2,2,0
5296,"[]","[]","['assassinar']","[1]",0,1,1,0
5297,"['quarentenar']","[1]","['circular']","[1]",1,1,2,0
5298,"['desenvolvimento', 'suportar', 'treinamento']","[1, 1, 1]","['secreto']","[1]",3,1,4,0
5299,"['bandeirant']","[1]","['parir']","[1]",1,1,2,0
5303,"['saudar']","[1]","[]","[]",1,0,1,0
5306,"['airlin', 'capitar', 'companhia', 'condicao', 'prazo', 'sigla']","[1, 1, 1, 1, 1, 1]","[]","[]",6,0,6,0
5307,"[]","[]","['enganir', 'fraudar', 'parir', 'pelar', 'pelar', 'sobrar', 'sobrar', 'verdadeiro']","[1, 1, 1, 2, 2, 2, 2, 1]",0,8,8,0
5308,"[]","[]","['indignacao']","[1]",0,1,1,0
5309,"['associacao', 'associacao', 'associacao', 'associacao', 'congresso', 'constituicao', 'constituicao', 'constituicao', 'decisao', 'exportacao']","[4, 4, 4, 4, 1, 3, 3, 3, 1, 1]","['grupar', 'parir', 'parir', 'parir', 'parir', 'parir', 'parir', 'parir', 'sobrar']","[1, 7, 7, 7, 7, 7, 7, 7, 1]",10,9,19,0
5312,"['anvisa', 'anvisa', 'internar']","[2, 2, 1]","[]","[]",3,0,3,0
5314,"[]","[]","['quinzena', 'vezar']","[1, 1]",0,2,2,0
5316,"['periodo']","[1]","['vc']","[1]",1,1,2,0
5317,"['constituicao']","[1]","[]","[]",1,0,1,0
5319,"['apurar', 'parceiro']","[1, 1]","[]","[]",2,0,2,0
5321,"['justificativo']","[1]","[]","[]",1,0,1,0
5322,"['pratico', 'sabado']","[1, 1]","['circular', 'greve', 'greve', 'greve']","[1, 3, 3, 3]",2,4,6,0
5324,"[]","[]","['checar', 'gasolina', 'pelar', 'sobrar']","[1, 1, 1, 1]",0,4,4,0
5326,"['internar', 'internar', 'internar', 'necessario']","[3, 3, 3, 1]","['circular', 'desmentir', 'desmentir', 'falsar']","[1, 2, 2, 1]",4,4,8,0
5327,"[]","[]","[]","[]",0,0,0,0
5329,"['alteracao', 'reforcar']","[1, 1]","['desmentir']","[1]",2,1,3,0
5332,"[]","[]","['compartilhar', 'compartilhar', 'inscricao']","[2, 2, 1]",0,3,3,0
5334,"[]","[]","['casamentar', 'casamentar', 'casamentar', 'casamentar', 'versao', 'versao', 'versao', 'versao']","[4, 4, 4, 4, 4, 4, 4, 4]",0,8,8,0
5342,"['economia', 'pagamento']","[1, 1]","['circular', 'sacar', 'sacar', 'usuario', 'verificar']","[1, 2, 2, 1, 1]",2,5,7,0
5343,"['previo']","[1]","['imagem']","[1]",1,1,2,0
5344,"['prazo']","[1]","[]","[]",1,0,1,0
5345,"['armazenamento', 'avancar', 'avancar', 'lancamento']","[1, 2, 2, 1]","[]","[]",4,0,4,0
5346,"['reuniao']","[1]","['circular', 'fotografia', 'imagem', 'imagem']","[1, 1, 2, 2]",1,4,5,0
5349,"['argumentar', 'atuacao', 'ccj', 'comissao', 'condenacao', 'constituicao', 'discussao', 'importancia', 'julgamento', 'justicar', 'justicar', 'ministrar', 'sessao', 'sessao', 'suspeicao']","[1, 1, 1, 1, 1, 1, 1, 1, 1, 2, 2, 1, 2, 2, 1]","['amigar', 'humanar']","[1, 1]",15,2,17,0
5351,"[]","[]","['drone', 'minutar', 'quinzena', 'visualizacao']","[1, 1, 1, 1]",0,4,4,0
5352,"['adversario', 'biliao', 'infectar', 'instituto', 'irregularidad', 'liderar', 'saudar', 'suspeito']","[1, 1, 1, 1, 1, 1, 1, 1]","['checar', 'parir', 'parir', 'parir', 'pelar', 'sobrar', 'sobrar']","[1, 3, 3, 3, 1, 2, 2]",8,7,15,0
5353,"[]","[]","['estranhar', 'imagem']","[1, 1]",0,2,2,0
5355,"['biliao', 'importacao']","[1, 1]","[]","[]",2,0,2,0
5356,"['autoridad', 'destinar', 'enfatizar', 'reducao', 'risco']","[1, 1, 1, 1, 1]","['atribuir', 'circular']","[1, 1]",5,2,7,0
5357,"['discussao', 'imunizacao']","[1, 1]","['imagem', 'inscricao', 'logotipo']","[1, 1, 1]",2,3,5,0
5359,"['decisao']","[1]","['amplament', 'cocaina', 'compartilhar', 'espalhar', 'postagen']","[1, 1, 1, 1, 1]",1,5,6,0
5361,"['esperancar', 'justicar', 'ministrar', 'ministrar', 'saudar']","[1, 1, 2, 2, 1]","['circular', 'imagem', 'imagem', 'manchet', 'parir', 'renunciar', 'viralizada', 'viralizado']","[1, 2, 2, 1, 1, 1, 1, 1]",5,8,13,0
5362,"['atrasar', 'funcao', 'irregularidad']","[1, 1, 1]","['checagem', 'parir']","[1, 1]",3,2,5,0
5365,"['estrategia', 'prever']","[1, 1]","[]","[]",2,0,2,0
5368,"['acompanhamento', 'anvisa', 'anvisa', 'painel', 'painel', 'suspeito', 'suspeito']","[1, 2, 2, 2, 2, 2, 2]","['checar', 'compartilhar', 'manchet', 'pelar', 'vezar']","[1, 1, 1, 1, 1]",7,5,12,0
5369,"['companhia', 'estatistico', 'geografia', 'ibg', 'iniciativo', 'instituto', 'parceria', 'privar', 'viagem']","[1, 1, 1, 1, 1, 1, 1, 1, 1]","['circular']","[1]",9,1,10,0
5370,"[]","[]","[]","[]",0,0,0,0
5373,"['adotada', 'iniciativo', 'prever', 'republico']","[1, 1, 1, 1]","[]","[]",4,0,4,0
5374,"['congresso', 'congresso', 'congresso', 'congresso', 'congresso', 'congresso', 'constituicao', 'constituicao', 'constituicao', 'emendar', 'emendar', 'emendar', 'emendar', 'iniciativo', 'iniciativo', 'prazo', 'proposto', 'proposto', 'recordar', 'sessao', 'sessao']","[6, 6, 6, 6, 6, 6, 3, 3, 3, 4, 4, 4, 4, 2, 2, 1, 2, 2, 1, 2, 2]","['basto', 'circular', 'realment', 'secreto', 'vc']","[1, 1, 1, 1, 1]",21,5,26,0
5375,"['domingo']","[1]","['bandeiro', 'imagem']","[1, 1]",1,2,3,0
5376,"[]","[]","['circular', 'desmaiar', 'imagem', 'legendar', 'legendar', 'reverso']","[1, 1, 1, 2, 2, 1]",0,6,6,0
5378,"[]","[]","['fingir']","[1]",0,1,1,0
5379,"['especializar', 'normalment', 'pagamento', 'pagamento']","[1, 1, 2, 2]","['fraudar', 'verificar', 'verificar']","[1, 2, 2]",4,3,7,0
5380,"['antonio', 'exgovernador', 'exprefeito', 'exprefeito', 'redondo']","[1, 1, 2, 2, 1]","['circular', 'imagem', 'legendar']","[1, 1, 1]",5,3,8,0
5382,"['situacao', 'surtir']","[1, 1]","['circular', 'imagem']","[1, 1]",2,2,4,0
5384,"[]","[]","['compartilhar', 'imagem', 'postagen', 'usuario']","[1, 1, 1, 1]",0,4,4,0
5386,"['positivar', 'primeiroministro', 'reuniao']","[1, 1, 1]","['espalhar']","[1]",3,1,4,0
5387,"[]","[]","['imagem', 'pelar', 'quinzena']","[1, 1, 1]",0,3,3,0
5388,"['realizacao']","[1]","[]","[]",1,0,1,0
5389,"['epidemiar', 'escassez']","[1, 1]","['garganta', 'vitaminar']","[1, 1]",2,2,4,0
5390,"['periodo']","[1]","['cbn', 'circular']","[1, 1]",1,2,3,0
5391,"['avancar', 'inovacao']","[1, 1]","['parir', 'parir', 'sobrar', 'sobrar', 'usuario']","[2, 2, 2, 2, 1]",2,5,7,0
5393,"['regrar', 'respostar']","[1, 1]","['clicar', 'clicar', 'compartilhar', 'compartilhar', 'enderecar', 'galaxi', 'galaxi', 'galaxi', 'galaxi', 'galaxi', 'galaxi', 'galaxi', 'ganhar', 'ganhar', 'ganhar', 'ganhar', 'instrucao', 'macho', 'minutar', 'parabem', 'parabem', 'parabem', 'parabem', 'reivindicar', 'selecionar', 'sortir', 'sortir', 'usuario', 'usuario', 'vazio']","[2, 2, 2, 2, 1, 7, 7, 7, 7, 7, 7, 7, 4, 4, 4, 4, 1, 1, 1, 4, 4, 4, 4, 1, 1, 2, 2, 2, 2, 1]",2,30,32,0
5398,"['legislativo', 'quedo']","[1, 1]","['imagem', 'telegram', 'usuario', 'usuario']","[1, 1, 2, 2]",2,4,6,0
5399,"[]","[]","['compartilhar', 'filmar', 'ganhar', 'imagem', 'menino']","[1, 1, 1, 1, 1]",0,5,5,0
5401,"[]","[]","['espalhar', 'espancar', 'grupar', 'quinzena']","[1, 1, 1, 1]",0,4,4,0
5404,"[]","[]","['camisa', 'camisa', 'circular', 'imagem', 'legendar']","[2, 2, 1, 1, 1]",0,5,5,0
5405,"['apreensao']","[1]","['cocaina', 'motorista', 'motorista', 'motorista', 'parabem', 'parabem', 'parabem', 'parabem', 'realment', 'sortir']","[1, 3, 3, 3, 4, 4, 4, 4, 1, 1]",1,10,11,0
5410,"['administrativo', 'avancar', 'domingo', 'europeu', 'metropolitano']","[1, 1, 1, 1, 1]","['catedr', 'catolico', 'cristao', 'cristao', 'cristao', 'cristao', 'cristao']","[1, 1, 5, 5, 5, 5, 5]",5,7,12,0
5412,"['infectar', 'infectar', 'planar', 'resistencia']","[2, 2, 1, 1]","[]","[]",4,0,4,0
5416,"['autoridad', 'fabricacao', 'fabricacao', 'sancao', 'saudar']","[1, 2, 2, 1, 1]","['espalhar']","[1]",5,1,6,0
5417,"['conformar', 'despesa', 'instituto', 'instituto']","[1, 1, 2, 2]","[]","[]",4,0,4,0
5420,"['autoridad', 'autoridad', 'avancar', 'instituto', 'saudar']","[2, 2, 1, 1, 1]","[]","[]",5,0,5,0
5422,"['consecutivo']","[1]","['gretar']","[1]",1,1,2,0
5423,"['dedicar', 'plantao']","[1, 1]","[]","[]",2,0,2,0
5425,"[]","[]","['despejar']","[1]",0,1,1,0
5428,"['constituicao', 'legislativo', 'prever']","[1, 1, 1]","[]","[]",3,0,3,0
5429,"['anuncio']","[1]","['parir', 'renunciar', 'wylli']","[1, 1, 1]",1,3,4,0
5431,"['estimular']","[1]","['replicar', 'usuario', 'versao', 'visualizacao']","[1, 1, 1, 1]",1,4,5,0
5433,"['apreensao', 'claudio']","[1, 1]","['crech']","[1]",2,1,3,0
5434,"['arthur', 'claudio', 'internar', 'surtir']","[1, 1, 1, 1]","['desmaiar', 'padrar', 'vc']","[1, 1, 1]",4,3,7,0
5440,"[]","[]","[]","[]",0,0,0,0
5441,"['autonomia', 'conformar', 'converso', 'imunizacao', 'imunizacao', 'operacionalizacao', 'pastar', 'planar', 'previo', 'previsao', 'prioritario', 'saudar', 'saudar']","[1, 1, 1, 2, 2, 1, 1, 1, 1, 1, 1, 2, 2]","['atribuir', 'circular', 'falsar']","[1, 1, 1]",13,3,16,0
5445,"[]","[]","['tumulo']","[1]",0,1,1,0
5446,"['avancar', 'estagio', 'hospitalizar', 'necessario']","[1, 1, 1, 1]","[]","[]",4,0,4,0
5447,"['investigacao']","[1]","['camiseta', 'imagem']","[1, 1]",1,2,3,0
5449,"['biliao', 'cenario', 'observar', 'piorar', 'preocupacao', 'taxar', 'taxar', 'taxar', 'tesourar']","[1, 1, 1, 1, 1, 3, 3, 3, 1]","['compartilhar', 'ganhar', 'postagen', 'vitaminar']","[1, 1, 1, 1]",9,4,13,0
5451,"['antecipar', 'condicao', 'crescimento', 'infectar', 'iniciativo', 'internar', 'periodo', 'prazo', 'prazo', 'prazo', 'prazo', 'previsao', 'proposto', 'proposto', 'reuniao', 'reuniao', 'risco', 'saudar', 'situacao', 'situacao', 'situacao', 'situacao', 'situacao', 'situacao', 'situacao', 'situacao', 'transferir', 'ventilador', 'ventilador']","[1, 1, 1, 1, 1, 1, 1, 4, 4, 4, 4, 1, 2, 2, 2, 2, 1, 1, 8, 8, 8, 8, 8, 8, 8, 8, 1, 2, 2]","['amigar', 'compartilhar', 'compartilhar', 'realment', 'soltar', 'soltar']","[1, 2, 2, 1, 2, 2]",29,6,35,0
5452,"['dificuldad', 'dosar', 'dosar', 'imunizacao']","[1, 2, 2, 1]","['circular', 'segundar']","[1, 1]",4,2,6,0
5454,"['bancada', 'privar', 'recurso']","[1, 1, 1]","['parir', 'pelar', 'pelar', 'rouanet', 'sobrar']","[1, 2, 2, 1, 1]",3,5,8,0
5455,"['epidemiar', 'folhar', 'folhar', 'folhar', 'folhar', 'folhar', 'imunizacao', 'mutacao', 'mutacao', 'mutacao']","[1, 5, 5, 5, 5, 5, 1, 3, 3, 3]","['catolico', 'desligar']","[1, 1]",10,2,12,0
5457,"['confederacao', 'pagamento', 'palacio', 'palacio', 'planalto', 'planalto', 'republico', 'treinar', 'treinar']","[1, 1, 2, 2, 2, 2, 1, 2, 2]","['ganhar', 'parabem', 'pelar', 'sacar']","[1, 1, 1, 1]",9,4,13,0
5459,"['acompanhamento', 'apurar', 'decisao', 'ideologico', 'investigacao', 'magistrado', 'ministrar', 'parceiro', 'supremo', 'supremo', 'suspenso']","[1, 1, 1, 1, 1, 1, 1, 1, 2, 2, 1]","['boatar', 'expulsar', 'lupa']","[1, 1, 1]",11,3,14,0
5462,"['milho', 'ministrar']","[1, 1]","['vagabundar', 'versao', 'versao', 'versao']","[1, 3, 3, 3]",2,4,6,0
5463,"['federar']","[1]","['soldar']","[1]",1,1,2,0
5465,"['converso', 'fundamentar']","[1, 1]","[]","[]",2,0,2,0
5466,"['decisao', 'esquema', 'lavagem']","[1, 1, 1]","['libertador']","[1]",3,1,4,0
5467,"[]","[]","[]","[]",0,0,0,0
5468,"['decorrencia']","[1]","[]","[]",1,0,1,0
5470,"[]","[]","[]","[]",0,0,0,0
5471,"['ministrar']","[1]","[]","[]",1,0,1,0
5475,"['viagem']","[1]","[]","[]",1,0,1,0
5476,"['consolidar', 'patamar', 'preliminar']","[1, 1, 1]","['verificar']","[1]",3,1,4,0
5477,"['disseminacao', 'iniciativo', 'proposto', 'respostar', 'saudar']","[1, 1, 1, 1, 1]","['atirar', 'circular', 'imagem', 'legendar', 'protestar', 'reverso']","[1, 1, 1, 1, 1, 1]",5,6,11,0
5478,"['adiamento', 'comissao', 'cooperacao', 'decisao', 'desenvolvimento', 'entendimento', 'supremo']","[1, 1, 1, 1, 1, 1, 1]","['parabem']","[1]",7,1,8,0
5480,"['discussao', 'implementacao']","[1, 1]","['parir', 'sobrar']","[1, 1]",2,2,4,0
5483,"[]","[]","['botao', 'clicar', 'compartilhar', 'compartilhar', 'compartilhar', 'compartilhar', 'ganhar', 'ganhar', 'ganhar']","[1, 1, 4, 4, 4, 4, 3, 3, 3]",0,9,9,0
5484,"['instituto', 'intervalar', 'levantamento', 'rejeicao', 'rejeicao', 'rejeitar', 'rejeitar']","[1, 1, 1, 2, 2, 2, 2]","['circular', 'circular', 'compartilhar', 'imagem', 'postagen', 'postagen', 'tampouco']","[2, 2, 1, 1, 2, 2, 1]",7,7,14,0
5485,"[]","[]","['imagem']","[1]",0,1,1,0
5488,"['aplicacao', 'planar']","[1, 1]","['espalhar', 'quinzena']","[1, 1]",2,2,4,0
5489,"['deteccao', 'ideologico', 'infectar', 'levantamento', 'saudar', 'saudar', 'saudar']","[1, 1, 1, 1, 3, 3, 3]","['circular', 'circular', 'compartilhar', 'fingir', 'imagem', 'imagem', 'intitular', 'questionario', 'tampouco']","[2, 2, 1, 1, 2, 2, 1, 1, 1]",7,9,16,0
5491,"['dondo']","[1]","['abortar', 'cocaina', 'cocaina', 'filmar', 'filmar', 'protestar', 'protestar']","[1, 2, 2, 2, 2, 2, 2]",1,7,8,0
5492,"['instituto', 'insuficient', 'molecular']","[1, 1, 1]","['enganoso', 'parir', 'parir', 'parir', 'pelar']","[1, 3, 3, 3, 1]",3,5,8,0
5494,"['dosar', 'prioritario', 'sigla']","[1, 1, 1]","['compartilhar', 'desmaiar', 'desmaiar']","[1, 2, 2]",3,3,6,0
5497,"['julgamento', 'julgamento', 'minimizar', 'negativar', 'positivar', 'possibilidad', 'restritivo', 'supremo']","[2, 2, 1, 1, 1, 1, 1, 1]","['checar', 'enganoso']","[1, 1]",8,2,10,0
5502,"['alteracao']","[1]","['circular', 'clicar', 'imagem', 'privacidad', 'privacidad', 'privacidad', 'realment', 'usuario', 'verdadeiro']","[1, 1, 1, 3, 3, 3, 1, 1, 1]",1,9,10,0
5507,"[]","[]","['boatar', 'cartaz', 'circular']","[1, 1, 1]",0,3,3,0
5512,"[]","[]","[]","[]",0,0,0,0
5514,"['decisao', 'integrant', 'republico']","[1, 1, 1]","['cartaz', 'cartaz', 'circular', 'imagem', 'manchet']","[2, 2, 1, 1, 1]",3,5,8,0
5515,"[]","[]","['realment']","[1]",0,1,1,0
5518,"['converso']","[1]","['faccao']","[1]",1,1,2,0
5520,"[]","[]","['mafia', 'mafia']","[2, 2]",0,2,2,0
5521,"[]","[]","['circular', 'imagem']","[1, 1]",0,2,2,0
5522,"['epidemiar']","[1]","['verdadeiro', 'verificar']","[1, 1]",1,2,3,0
5524,"['converso', 'converso', 'notificar']","[2, 2, 1]","['usuario', 'usuario']","[2, 2]",3,2,5,0
5526,"['afetado']","[1]","['compartilhar', 'compartilhar', 'fingir', 'fingir', 'imagem', 'imagem', 'imagem', 'imagem', 'incendio', 'viralizada']","[2, 2, 2, 2, 4, 4, 4, 4, 1, 1]",1,10,11,0
5527,"[]","[]","['clicar', 'compartilhar', 'ganhar', 'ganhar', 'ganhar', 'questionario', 'sortear']","[1, 1, 3, 3, 3, 1, 1]",0,7,7,0
5530,"['bbc', 'biliao']","[1, 1]","['amigar', 'checagem', 'checagem', 'circular', 'cristao', 'legendar']","[1, 2, 2, 1, 1, 1]",2,6,8,0
5534,"['desvio', 'economia', 'economia', 'especialment', 'periodo', 'sabado']","[1, 2, 2, 1, 1, 1]","['parir', 'parir', 'parir', 'venezuelano']","[3, 3, 3, 1]",6,4,10,0
5538,"[]","[]","['ilustrar', 'mentiroso', 'replicar', 'soldar', 'torturar', 'torturar']","[1, 1, 1, 1, 2, 2]",0,6,6,0
5541,"['colegio', 'fluminens', 'opcao']","[1, 1, 1]","['mesario']","[1]",3,1,4,0
5542,"['republico']","[1]","['circular', 'circular', 'compartilhar', 'desmentir', 'estampar', 'imagem', 'legendar']","[2, 2, 1, 1, 1, 1, 1]",1,7,8,0
5549,"['externo', 'hospitalizar', 'observar', 'taxar']","[1, 1, 1, 1]","['sortear', 'verdadeiro']","[1, 1]",4,2,6,0
5550,"[]","[]","['amplament', 'compartilhar', 'espalhar', 'padrar', 'quinzena']","[1, 1, 1, 1, 1]",0,5,5,0
5553,"['converso', 'mexico']","[1, 1]","['ganhar']","[1]",2,1,3,0
5557,"[]","[]","[]","[]",0,0,0,0
5558,"['antonio']","[1]","['imagem']","[1]",1,1,2,0
5561,"['taxar']","[1]","['checar', 'circular', 'circular', 'estomago', 'estomago', 'falsar', 'idioma', 'versao']","[1, 2, 2, 2, 2, 1, 1, 1]",1,8,9,0
5563,"['autoridad']","[1]","['vazar']","[1]",1,1,2,0
5564,"['dificuldad']","[1]","['estomago', 'garganta', 'garganta', 'garganta', 'suco']","[1, 3, 3, 3, 1]",1,5,6,0
5565,"['comorbidad']","[1]","['realment']","[1]",1,1,2,0
5566,"['espirito', 'internacao', 'internar']","[1, 1, 1]","['boatar', 'cbn', 'circular', 'versao']","[1, 1, 1, 1]",3,4,7,0
5569,"['afetado', 'regiao']","[1, 1]","['boatar', 'imagem', 'incendio', 'postagen', 'sobrar', 'verificar']","[1, 1, 1, 1, 1, 1]",2,6,8,0
5570,"['afetado', 'regiao']","[1, 1]","['boatar', 'imagem', 'incendio', 'parir', 'postagen', 'sobrar', 'verificar']","[1, 1, 1, 1, 1, 1, 1]",2,7,9,0
5571,"['afetado', 'regiao']","[1, 1]","['boatar', 'chorar', 'compartilhar', 'incendio', 'incendio', 'parir', 'postagen', 'protestar', 'sobrar', 'verificar']","[1, 1, 1, 2, 2, 1, 1, 1, 1, 1]",2,10,12,0
5572,"['afetado', 'regiao']","[1, 1]","['boatar', 'incendio', 'incendio', 'postagen', 'sobrar', 'sobrar', 'verificar']","[1, 2, 2, 1, 2, 2, 1]",2,7,9,0
5577,"['impactar', 'previsto', 'rastreamento', 'regiao']","[1, 1, 1, 1]","['circular', 'cristao', 'cristao']","[1, 2, 2]",4,3,7,0
5578,"['planar', 'situacao']","[1, 1]","['bandeiro', 'fraudar', 'fraudar', 'fraudar']","[1, 3, 3, 3]",2,4,6,0
5579,"[]","[]","[]","[]",0,0,0,0
5581,"['afp', 'crescimento', 'instituto', 'preocupacao', 'subir']","[1, 1, 1, 1, 1]","['circular', 'compartilhar', 'pelar', 'segundar', 'segundar', 'vezar']","[1, 1, 1, 2, 2, 1]",5,6,11,0
5582,"['economia', 'gued', 'ministrar', 'ministrar', 'respostar', 'supremo', 'supremo']","[1, 1, 2, 2, 1, 2, 2]","['replicar']","[1]",7,1,8,0
5585,"['queiroz', 'queiroz', 'queiroz']","[3, 3, 3]","['assassinar', 'assassinar', 'camisa', 'camiseta', 'camiseta', 'circular', 'expulsar', 'imagem', 'imagem', 'imagem', 'imagem', 'imagem', 'motorista']","[2, 2, 1, 2, 2, 1, 1, 5, 5, 5, 5, 5, 1]",3,13,16,0
5586,"['celebrar']","[1]","['circular', 'desfilar', 'desfilar', 'gravacao', 'legendar', 'legendar']","[1, 2, 2, 1, 2, 2]",1,6,7,0
5592,"['anticorpo', 'instituto']","[1, 1]","[]","[]",2,0,2,0
5595,"[]","[]","['circular', 'circular', 'legendar']","[2, 2, 1]",0,3,3,0
5597,"[]","[]","['clicar', 'compartilhar', 'compartilhar', 'compartilhar', 'inscricao', 'inscricao', 'questionario', 'questionario', 'sacar', 'sacar', 'sacar']","[1, 3, 3, 3, 2, 2, 2, 2, 3, 3, 3]",0,11,11,0
5599,"[]","[]","['arquivar', 'circular', 'disseminar', 'imagem']","[1, 1, 1, 1]",0,4,4,0
5606,"['assistencia', 'parcelar', 'parcelar', 'parceria', 'parceria', 'privar', 'privar', 'realizacao']","[1, 2, 2, 2, 2, 2, 2, 1]","['basto', 'cadastramento', 'cadastramento', 'enderecar', 'inscricao', 'preencher', 'sacar']","[1, 2, 2, 1, 1, 1, 1]",8,7,15,0
5607,"[]","[]","['verdadeiro']","[1]",0,1,1,0
5608,"['desafiar', 'pratico']","[1, 1]","['estuprar']","[1]",2,1,3,0
5609,"[]","[]","[]","[]",0,0,0,0
5612,"['consequencia', 'economia', 'necessidad', 'preocupacao', 'surtir']","[1, 1, 1, 1, 1]","['falsar', 'realment']","[1, 1]",5,2,7,0
5614,"[]","[]","['amplament', 'disseminar', 'usuario', 'visualizacao']","[1, 1, 1, 1]",0,4,4,0
5615,"['anvisa', 'higienizacao', 'liderar', 'preventivo', 'viagem', 'vigilancia']","[1, 1, 1, 1, 1, 1]","['desmentir', 'sequer']","[1, 1]",6,2,8,0
5616,"['contemplar', 'parcelar', 'parceria']","[1, 1, 1]","['basto', 'compartilhar', 'inscricao', 'preencher']","[1, 1, 1, 1]",3,4,7,0
5618,"['autoridad', 'economia', 'federar']","[1, 1, 1]","[]","[]",3,0,3,0
5620,"[]","[]","[]","[]",0,0,0,0
5621,"['julgamento']","[1]","['biblia', 'boicotar', 'imagem', 'lixar', 'lixar', 'puro']","[1, 1, 1, 2, 2, 1]",1,6,7,0
5623,"[]","[]","[]","[]",0,0,0,0
5629,"['quarentenar']","[1]","[]","[]",1,0,1,0
5630,"['justicar', 'palacio', 'quedo', 'vespera', 'wilson', 'wilson', 'witzel', 'witzel']","[1, 1, 1, 1, 2, 2, 2, 2]","['checar']","[1]",8,1,9,0
5631,"[]","[]","['atribuir']","[1]",0,1,1,0
5633,"[]","[]","['barragem', 'barragem', 'espalhar', 'parir', 'rompimento', 'venezuelano']","[2, 2, 1, 1, 1, 1]",0,6,6,0
5634,"['internar']","[1]","['adelio', 'adelio']","[2, 2]",1,2,3,0
5636,"['abordagem', 'autoridad', 'autoridad', 'conjuntar', 'desafiar', 'europeu', 'infancia', 'pratico', 'saudar', 'saudar', 'saudar', 'saudar', 'taxar']","[1, 2, 2, 1, 1, 1, 1, 1, 4, 4, 4, 4, 1]","['circular']","[1]",13,1,14,0
5637,"[]","[]","['compartilhar', 'espalhar', 'imagem']","[1, 1, 1]",0,3,3,0
5639,"['previsto', 'previsto']","[2, 2]","['greve', 'greve', 'greve', 'greve', 'greve', 'greve', 'greve']","[7, 7, 7, 7, 7, 7, 7]",2,7,9,0
5641,"['prazo', 'prazo', 'realizacao']","[2, 2, 1]","['circular']","[1]",3,1,4,0
5642,"['ambientar', 'comunitario', 'disseminacao', 'infectar', 'orientacao', 'periodo', 'saudar', 'transmissao']","[1, 1, 1, 1, 1, 1, 1, 1]","['circular', 'parir']","[1, 1]",8,2,10,0
5643,"['flavio', 'flavio']","[2, 2]","[]","[]",2,0,2,0
5646,"['crise', 'palacio', 'planalto']","[1, 1, 1]","['enfim', 'renunciar', 'renunciar', 'renunciar', 'renunciar', 'renunciar', 'renunciar', 'versao', 'versao', 'versao']","[1, 6, 6, 6, 6, 6, 6, 3, 3, 3]",3,10,13,0
5647,"[]","[]","['circular', 'falsar', 'imagem', 'imagem', 'missil', 'missil', 'versao']","[1, 1, 2, 2, 2, 2, 1]",0,7,7,0
5650,"['aplicacao']","[1]","['filmar', 'vazio']","[1, 1]",1,2,3,0
5652,"[]","[]","['efarsa', 'espalhar']","[1, 1]",0,2,2,0
5653,"['afp', 'necessario', 'risco']","[1, 1, 1]","['compartilhar']","[1]",3,1,4,0
5654,"[]","[]","['atribuir', 'compartilhar', 'espalhar']","[1, 1, 1]",0,3,3,0
5658,"[]","[]","['garganta']","[1]",0,1,1,0
5660,"['comportamento', 'contemplar', 'convencao', 'equivalent', 'importancia', 'individuar', 'julgamento', 'plenario', 'resolucao', 'sentenca', 'sessao', 'unanimidad', 'unanimidad']","[1, 1, 1, 1, 1, 1, 1, 1, 1, 1, 1, 2, 2]","['bandeiro', 'casamentar', 'casamentar', 'casamentar', 'casamentar', 'casamentar', 'casamentar']","[1, 6, 6, 6, 6, 6, 6]",13,7,20,0
5662,"[]","[]","['circular', 'equador', 'imagem', 'legendar']","[1, 1, 1, 1]",0,4,4,0
5663,"['dialogo', 'economia']","[1, 1]","[]","[]",2,0,2,0
5664,"['apurar', 'comissao', 'contabilizar']","[1, 1, 1]","['circular']","[1]",3,1,4,0
5666,"[]","[]","['limao']","[1]",0,1,1,0
5670,"['bolsonarista', 'calculo', 'contabilizar', 'sabado']","[1, 1, 1, 1]","['imagem', 'imagem', 'parir', 'parir', 'parir', 'pelar', 'sobrar', 'verdadeiro']","[2, 2, 3, 3, 3, 1, 1, 1]",4,8,12,0
5671,"[]","[]","[]","[]",0,0,0,0
5673,"['folhar']","[1]","['barragem', 'crech', 'parabem']","[1, 1, 1]",1,3,4,0
5674,"[]","[]","['compartilhar', 'estampar', 'imagem']","[1, 1, 1]",0,3,3,0
5677,"[]","[]","['pelar', 'quinzena']","[1, 1]",0,2,2,0
5682,"['anvisa', 'decisao', 'especifico', 'fornecimento', 'julgamento', 'justicar', 'supremo', 'vigilancia']","[1, 1, 1, 1, 1, 1, 1, 1]","['compartilhar']","[1]",8,1,9,0
5683,"['presenca']","[1]","['atribuir', 'canadens']","[1, 1]",1,2,3,0
5684,"[]","[]","['enganar']","[1]",0,1,1,0
5685,"['internar', 'surtir', 'surtir', 'surtir', 'turistico']","[1, 3, 3, 3, 1]","['circular']","[1]",5,1,6,0
5686,"['respostar']","[1]","['circular', 'desmaiar', 'fotografo', 'fotografo', 'fotografo', 'fotografo', 'usuario', 'usuario']","[1, 1, 4, 4, 4, 4, 2, 2]",1,8,9,0
5688,"['quarentenar']","[1]","[]","[]",1,0,1,0
5689,"['jorg', 'jorg']","[2, 2]","['boatar']","[1]",2,1,3,0
5690,"['escalar', 'suspeito']","[1, 1]","[]","[]",2,0,2,0
5691,"['colombio', 'crise']","[1, 1]","['filmar', 'filmar', 'wagner', 'wagner', 'wagner', 'wagner']","[2, 2, 4, 4, 4, 4]",2,6,8,0
5693,"[]","[]","['compartilhar']","[1]",0,1,1,0
5697,"['adotada', 'avancar', 'fase', 'fase', 'fornecimento', 'funcionamento', 'quarentenar', 'realizacao', 'regrar']","[1, 1, 2, 2, 1, 1, 1, 1, 1]","['circular']","[1]",9,1,10,0
5698,"['manutencao', 'pslrj', 'sessao', 'silveiro']","[1, 1, 1, 1]","['circular', 'imagem']","[1, 1]",4,2,6,0
5701,"['arthur', 'domingo', 'domingo', 'enfrentamento', 'ministrar', 'ministrar', 'ministrar', 'nelson', 'saudar', 'saudar', 'saudar', 'teich', 'wilson']","[1, 2, 2, 1, 3, 3, 3, 1, 3, 3, 3, 1, 1]","['boatar', 'circular', 'verdadeiro']","[1, 1, 1]",13,3,16,0
5702,"['internar']","[1]","['parir']","[1]",1,1,2,0
5703,"['exministro', 'exministro', 'justicar', 'nomeacao', 'nomeacao', 'ramagem', 'ramagem', 'suspenso']","[2, 2, 1, 2, 2, 2, 2, 1]","['atribuir', 'chorar', 'circular', 'sequer', 'verificacao']","[1, 1, 1, 1, 1]",8,5,13,0
5706,"[]","[]","['arquivar', 'legendar', 'pego']","[1, 1, 1]",0,3,3,0
5707,"['afp']","[1]","['checar', 'circular', 'circular', 'pelar', 'telegram', 'verificar', 'versao']","[1, 2, 2, 1, 1, 1, 1]",1,7,8,0
5708,"['dinamarca']","[1]","['circular', 'compartilhar', 'imagem', 'imagem', 'imagem', 'imagem', 'imagem']","[1, 1, 5, 5, 5, 5, 5]",1,7,8,0
5712,"['academico', 'comissao', 'proporcao']","[1, 1, 1]","['amplament', 'circular', 'fraudar', 'fraudar', 'fraudar', 'fraudar', 'legendar', 'narrativo', 'postagen', 'visualizar']","[1, 1, 4, 4, 4, 4, 1, 1, 1, 1]",3,10,13,0
5713,"['congresso', 'justicar', 'lesao', 'mantido', 'mprj', 'quadro', 'sabado']","[1, 1, 1, 1, 1, 1, 1]","['assaltar', 'compartilhar', 'rosario']","[1, 1, 1]",7,3,10,0
5714,"['cronica', 'nelson']","[1, 1]","['circular', 'intitular', 'legendar']","[1, 1, 1]",2,3,5,0
5715,"['saudar', 'saudar', 'vetar', 'vetar', 'vetar']","[2, 2, 3, 3, 3]","['lixar']","[1]",5,1,6,0
5716,"['associacao', 'autorizacao', 'consenso', 'efetividad', 'pratico', 'proposto']","[1, 1, 1, 1, 1, 1]","['misturar']","[1]",6,1,7,0
5718,"['notificar', 'saudar', 'submetido']","[1, 1, 1]","['circular', 'estuprar', 'estuprar', 'mencao']","[1, 2, 2, 1]",3,4,7,0
5720,"['concorrent', 'flavio', 'sobretudo']","[1, 1, 1]","['quinzena']","[1]",3,1,4,0
5725,"['cenario', 'extraordinario', 'extraordinario', 'fluxo', 'fluxo', 'mantido', 'mantido', 'periferia', 'universitario', 'universitario', 'universitario', 'universitario']","[1, 2, 2, 2, 2, 2, 2, 1, 4, 4, 4, 4]","['narrativo', 'narrativo', 'narrativo', 'narrativo', 'sobrar', 'sobrar', 'sobrar', 'sobrar', 'vazio', 'vazio', 'verdadeiro', 'verdadeiro']","[4, 4, 4, 4, 4, 4, 4, 4, 2, 2, 2, 2]",12,12,24,0
5730,"['parceria']","[1]","['basto', 'enderecar', 'inscricao', 'inscricao', 'inscricao', 'preencher', 'preencher']","[1, 1, 3, 3, 3, 2, 2]",1,7,8,0
5732,"['geografia', 'necessario']","[1, 1]","['vc']","[1]",2,1,3,0
5733,"[]","[]","['basto', 'preencher', 'vc']","[1, 1, 1]",0,3,3,0
5737,"['estagio', 'etapa']","[1, 1]","[]","[]",2,0,2,0
5738,"['boletim', 'conformar', 'decorrencia', 'saudar', 'subir']","[1, 1, 1, 1, 1]","['cbn', 'circular', 'sequer']","[1, 1, 1]",5,3,8,0
5742,"['flavio', 'flavio', 'flavio', 'investigacao', 'justicar', 'justicar', 'ministrar', 'ministrar', 'pslrj']","[3, 3, 3, 1, 2, 2, 2, 2, 1]","['circular', 'compartilhar', 'usuario']","[1, 1, 1]",9,3,12,0
5745,"['coordenar', 'desenvolvido', 'fase', 'imunizacao', 'infectar', 'infectar', 'infectar', 'instituto', 'necessario', 'positivar', 'saudar']","[1, 1, 1, 1, 3, 3, 3, 1, 1, 1, 1]","['intitular']","[1]",11,1,12,0
5746,"['lancamento']","[1]","['cedula', 'cedula', 'cedula', 'cedula', 'cedula', 'circular', 'circular']","[5, 5, 5, 5, 5, 2, 2]",1,7,8,0
5747,"['domingo']","[1]","['bandeiro', 'bandeiro', 'camisa', 'circular', 'inscricao', 'protestar']","[2, 2, 1, 1, 1, 1]",1,6,7,0
5749,"[]","[]","['verificar']","[1]",0,1,1,0
5750,"['superar', 'superar', 'taxar']","[2, 2, 1]","[]","[]",3,0,3,0
5752,"['regiao']","[1]","['compartilhar', 'inscricao', 'parir', 'parir', 'parir', 'preencher']","[1, 1, 3, 3, 3, 1]",1,6,7,0
5753,"[]","[]","['clicar']","[1]",0,1,1,0
5754,"['ministrar']","[1]","['disseminar', 'filmar', 'humanar', 'visualizacao']","[1, 1, 1, 1]",1,4,5,0
5756,"['entregu']","[1]","['cedula', 'cedula', 'circular', 'fraudar', 'imagem', 'legendar', 'postagen', 'versao']","[2, 2, 1, 1, 1, 1, 1, 1]",1,8,9,0
5757,"[]","[]","['casamentar', 'circular', 'circular', 'fotografia', 'idioma', 'imagem', 'legendar', 'menino', 'postagen']","[1, 2, 2, 1, 1, 1, 1, 1, 1]",0,9,9,0
5758,"['alteracao', 'condicao', 'desafiar', 'funcionamento', 'mudanca', 'mudanca', 'mudanca', 'mudanca', 'mudanca', 'plantao']","[1, 1, 1, 1, 5, 5, 5, 5, 5, 1]","['enfim']","[1]",10,1,11,0
5759,"[]","[]","[]","[]",0,0,0,0
5761,"['araujo', 'araujo', 'destacar', 'dialogo', 'ernesto', 'extraordinario', 'ministrar']","[2, 2, 1, 1, 1, 1, 1]","['imagem', 'protestar', 'protestar']","[1, 2, 2]",7,3,10,0
5763,"['quarentenar']","[1]","['circular', 'circular', 'imagem', 'legendar', 'verificar']","[2, 2, 1, 1, 1]",1,5,6,0
5765,"['prever']","[1]","[]","[]",1,0,1,0
5767,"['instituto', 'molecular']","[1, 1]","['enganoso', 'parir', 'pelar']","[1, 1, 1]",2,3,5,0
5771,"['witzel', 'witzel']","[2, 2]","[]","[]",2,0,2,0
5775,"[]","[]","[]","[]",0,0,0,0
5776,"[]","[]","[]","[]",0,0,0,0
5777,"['adicionar', 'mudanca', 'prazo', 'privar', 'processo', 'regrar']","[1, 1, 1, 1, 1, 1]","['clicar', 'clicar', 'compartilhar', 'copiar', 'copiar', 'copiar', 'copiar', 'copiar', 'lembres', 'privacidad', 'privacidad', 'versao']","[2, 2, 1, 5, 5, 5, 5, 5, 1, 2, 2, 1]",6,12,18,0
5778,"['client', 'consumidor', 'saudar']","[1, 1, 1]","['humanar', 'imenso']","[1, 1]",3,2,5,0
5779,"[]","[]","['compartilhar']","[1]",0,1,1,0
5783,"['interrupcao', 'quedo']","[1, 1]","[]","[]",2,0,2,0
5784,"['preced']","[1]","['enganoso', 'parir', 'postagen']","[1, 1, 1]",1,3,4,0
5785,"[]","[]","['vezar']","[1]",0,1,1,0
5788,"['michael', 'michael']","[2, 2]","[]","[]",2,0,2,0
5791,"[]","[]","['atirar', 'circular', 'imagem', 'imagem']","[1, 1, 2, 2]",0,4,4,0
5795,"[]","[]","['circular', 'compartilhar', 'parir', 'parir', 'parir', 'postagen', 'protestar', 'socialismo', 'usuario', 'usuario']","[1, 1, 3, 3, 3, 1, 1, 1, 2, 2]",0,10,10,0
5796,"['carat', 'pib', 'republico', 'republico', 'republico', 'sobretudo', 'sobretudo']","[1, 1, 3, 3, 3, 2, 2]","['parir', 'pelar', 'pelar', 'vc']","[1, 2, 2, 1]",7,4,11,0
5798,"[]","[]","[]","[]",0,0,0,0
5802,"['comprometido', 'coordenar', 'ideologico', 'ideologico', 'mudanca', 'mudanca']","[1, 1, 2, 2, 2, 2]","['lixar', 'manchet', 'usuario']","[1, 1, 1]",6,3,9,0
5803,"['folhar', 'souza', 'souza', 'spaulo']","[1, 2, 2, 1]","['compartilhar', 'fotografo', 'imagem']","[1, 1, 1]",4,3,7,0
5807,"['apurar', 'dificuldad', 'situacao']","[1, 1, 1]","['atribuir', 'capturar', 'circular', 'enganoso', 'fotografia', 'imagem']","[1, 1, 1, 1, 1, 1]",3,6,9,0
5808,"['carla', 'internacao', 'zambelli']","[1, 1, 1]","['amplament', 'compartilhar', 'compartilhar', 'usuario', 'vazio', 'vc', 'versao']","[1, 2, 2, 1, 1, 1, 1]",3,7,10,0
5809,"['republico']","[1]","[]","[]",1,0,1,0
5811,"['justificativo']","[1]","['circular']","[1]",1,1,2,0
5813,"['fronteiro']","[1]","['verificar']","[1]",1,1,2,0
5814,"['acumular', 'dedicar', 'favorito', 'favorito', 'favorito', 'parceiro', 'queixar']","[1, 1, 3, 3, 3, 1, 1]","[]","[]",7,0,7,0
5816,"[]","[]","['falsar']","[1]",0,1,1,0
5819,"['fux', 'ministrar', 'ministrar', 'provisorio', 'suspensao']","[1, 2, 2, 1, 1]","['realment']","[1]",5,1,6,0
5820,"['adicionar', 'biliao', 'colaboracao', 'conjuntar', 'consequencia', 'determinacao', 'funcao', 'investigacao', 'investigacao', 'justicar', 'justicar', 'legislativo', 'manutencao', 'periodo', 'quedo', 'servidor', 'servidor', 'servidor', 'supremo', 'temporariament']","[1, 1, 1, 1, 1, 1, 1, 2, 2, 2, 2, 1, 1, 1, 1, 3, 3, 3, 1, 1]","['boatar', 'boatar', 'compartilhar', 'compartilhar', 'espalhar', 'fraudar', 'imagem', 'imagem', 'imagem', 'logotipo', 'logotipo', 'telegram', 'usuario', 'usuario', 'usuario', 'usuario', 'usuario', 'usuario', 'usuario', 'usuario', 'usuario', 'usuario', 'usuario', 'usuario']","[2, 2, 2, 2, 1, 1, 3, 3, 3, 2, 2, 1, 12, 12, 12, 12, 12, 12, 12, 12, 12, 12, 12, 12]",20,24,44,0
5823,"['assistencia', 'infectar', 'remessar', 'viagem']","[1, 1, 1, 1]","['amigar']","[1]",4,1,5,0
5826,"[]","[]","[]","[]",0,0,0,0
5828,"['intensivo', 'provincia', 'regiao', 'situacao', 'subir', 'transmissao']","[1, 1, 1, 1, 1, 1]","['caixao', 'caixao', 'parir']","[2, 2, 1]",6,3,9,0
5829,"['anuncio', 'definitivo', 'definitivo', 'pratico', 'prazo']","[1, 2, 2, 1, 1]","[]","[]",5,0,5,0
5830,"['prescricao']","[1]","['wagner']","[1]",1,1,2,0
5831,"[]","[]","['capturar', 'realment']","[1, 1]",0,2,2,0
5834,"['infectar', 'infectar', 'infectar']","[3, 3, 3]","[]","[]",3,0,3,0
5836,"['inicialment']","[1]","['arquivar']","[1]",1,1,2,0
5837,"['periodo', 'risco', 'subir']","[1, 1, 1]","['lembres', 'parir']","[1, 1]",3,2,5,0
5838,"['conformar', 'palacio', 'subir']","[1, 1, 1]","['amigar', 'amigar']","[2, 2]",3,2,5,0
5839,"['celebrar', 'celebrar', 'projecao', 'projecao']","[2, 2, 2, 2]","['bandeiro', 'bandeiro', 'bandeiro', 'circular', 'dubai', 'dubai', 'imagem', 'legendar', 'legendar', 'torrar', 'torrar', 'torrar', 'verificar']","[3, 3, 3, 1, 2, 2, 1, 2, 2, 3, 3, 3, 1]",4,13,17,0
5847,"[]","[]","['gravacao']","[1]",0,1,1,0
5848,"['augusto', 'depoimento', 'discussao', 'oliveira']","[1, 1, 1, 1]","['assassinar', 'atirar', 'torturar']","[1, 1, 1]",4,3,7,0
5849,"['condicao', 'economia', 'economia', 'kong', 'levantamento', 'liderar', 'oferecido', 'pib']","[1, 2, 2, 1, 1, 1, 1, 1]","[]","[]",8,0,8,0
5855,"['converso', 'converso', 'converso', 'converso', 'ministrar']","[4, 4, 4, 4, 1]","[]","[]",5,0,5,0
5864,"[]","[]","['abortar']","[1]",0,1,1,0
5865,"[]","[]","[]","[]",0,0,0,0
5866,"['saudar', 'suspenso', 'temporariament']","[1, 1, 1]","['circular']","[1]",3,1,4,0
5867,"[]","[]","['adelio', 'basto', 'bispar', 'circular', 'imagem', 'imagem', 'verdadeiro']","[1, 1, 1, 1, 2, 2, 1]",0,7,7,0
5869,"[]","[]","['circular', 'compartilhar', 'falsar']","[1, 1, 1]",0,3,3,0
5870,"['alteracao', 'destinar', 'equipamento']","[1, 1, 1]","['circular', 'compartilhar', 'enganar', 'fraudar', 'imagem', 'legendar', 'versao']","[1, 1, 1, 1, 1, 1, 1]",3,7,10,0
5873,"['especialment']","[1]","[]","[]",1,0,1,0
5876,"['desenvolvimento', 'fase', 'monitoramento']","[1, 1, 1]","['circular', 'compartilhar', 'telegram', 'visualizar']","[1, 1, 1, 1]",3,4,7,0
5880,"['economia', 'quarentenar', 'saudar', 'situacao']","[1, 1, 1, 1]","['implantar', 'maldiz', 'sortir']","[1, 1, 1]",4,3,7,0
5881,"[]","[]","['compartilhar']","[1]",0,1,1,0
5885,"[]","[]","['camisa', 'camisa', 'espalhar', 'estampar', 'imagem', 'pelar']","[2, 2, 1, 1, 1, 1]",0,6,6,0
5886,"['situacao']","[1]","['agredir', 'lixar', 'safar']","[1, 1, 1]",1,3,4,0
5888,"['avancar', 'condicao', 'decisao', 'decisao', 'processo', 'proposto', 'recordar', 'saudar', 'saudar', 'suspeito', 'temor']","[1, 1, 2, 2, 1, 1, 1, 2, 2, 1, 1]","['renunciar', 'renunciar', 'renunciar']","[3, 3, 3]",11,3,14,0
5889,"['destinar', 'passageiro']","[1, 1]","['curioso', 'motorista', 'quinzena']","[1, 1, 1]",2,3,5,0
5891,"['individuar']","[1]","['circular', 'imagem', 'motorista']","[1, 1, 1]",1,3,4,0
5896,"['afp', 'ambito', 'guaruja', 'processo', 'triplex']","[1, 1, 1, 1, 1]","['checar', 'circular', 'compartilhar', 'reverso', 'versao']","[1, 1, 1, 1, 1]",5,5,10,0
5897,"['desenvolvimento']","[1]","['espalhar', 'quinzena']","[1, 1]",1,2,3,0
5898,"['barroso', 'barroso', 'barroso', 'barroso', 'cerimonia', 'domingo', 'domingo', 'ministrar', 'ministrar', 'ministrar', 'ministrar', 'situacao']","[4, 4, 4, 4, 1, 2, 2, 4, 4, 4, 4, 1]","[]","[]",12,0,12,0
5899,"[]","[]","['lixar']","[1]",0,1,1,0
5900,"['autoridad', 'converso', 'investigacao']","[1, 1, 1]","['abusar', 'expulsar', 'expulsar', 'expulsar', 'invadir', 'verdadeiro']","[1, 3, 3, 3, 1, 1]",3,6,9,0
5901,"['cronica', 'cronica', 'cronica', 'precaucao']","[3, 3, 3, 1]","['versao']","[1]",4,1,5,0
5902,"[]","[]","['parir']","[1]",0,1,1,0
5903,"[]","[]","['parir', 'parir']","[2, 2]",0,2,2,0
5905,"['tatto']","[1]","['cuspir']","[1]",1,1,2,0
5907,"['palacio', 'palacio']","[2, 2]","[]","[]",2,0,2,0
5908,"['etapa', 'regulamentar']","[1, 1]","['humanar', 'instrucao', 'parir', 'pelar', 'segundar']","[1, 1, 1, 1, 1]",2,5,7,0
5909,"['hospitalizar', 'saudar', 'saudar']","[1, 2, 2]","['chorar', 'estranhar', 'estranhar', 'falsar', 'fraudar', 'imagem', 'versao', 'versao', 'versao', 'versao', 'versao', 'versao']","[1, 2, 2, 1, 1, 1, 6, 6, 6, 6, 6, 6]",3,12,15,0
5910,"[]","[]","[]","[]",0,0,0,0
5912,"[]","[]","[]","[]",0,0,0,0
5913,"[]","[]","['indignar']","[1]",0,1,1,0
5914,"['condenacao', 'condenacao', 'edson', 'edson', 'fachin', 'fachin', 'investigacao', 'justicar', 'ministrar', 'ministrar', 'supremo']","[2, 2, 2, 2, 2, 2, 1, 1, 2, 2, 1]","['circular', 'circular', 'circular']","[3, 3, 3]",11,3,14,0
5915,"[]","[]","[]","[]",0,0,0,0
5916,"['cronica', 'dificuldad', 'pulmonar', 'respiratorio', 'ribeiro', 'saudar']","[1, 1, 1, 1, 1, 1]","['circular', 'compartilhar', 'idioma']","[1, 1, 1]",6,3,9,0
5917,"['avancar', 'etapa', 'regiao']","[1, 1, 1]","['falsar', 'filmar', 'pelar', 'sobrar', 'transposicao']","[1, 1, 1, 1, 1]",3,5,8,0
5920,"['queiroz']","[1]","[]","[]",1,0,1,0
5925,"['bolsonarista', 'europeu', 'ministrar', 'primeiroministro', 'saudar', 'vetar']","[1, 1, 1, 1, 1, 1]","['supostament']","[1]",6,1,7,0
5927,"[]","[]","['espalhar', 'imagem', 'secreto']","[1, 1, 1]",0,3,3,0
5928,"[]","[]","['chorar', 'espalhar', 'quinzena', 'sobrar']","[1, 1, 1, 1]",0,4,4,0
5930,"['ambientar', 'circulacao', 'colaborar', 'equipamento', 'especializar', 'especifico', 'hipertensao', 'infectar', 'infectar', 'mutacao', 'observar', 'proliferacao', 'proliferacao', 'saudar', 'universitario']","[1, 1, 1, 1, 1, 1, 1, 2, 2, 1, 1, 2, 2, 1, 1]","['compartilhar', 'compartilhar', 'compartilhar', 'despejar', 'estomago', 'estomago', 'estomago', 'estomago', 'garganta', 'garganta', 'limao', 'limao', 'limao', 'limao', 'limao', 'suco', 'verificacao', 'verificacao', 'vitaminar']","[3, 3, 3, 1, 4, 4, 4, 4, 2, 2, 5, 5, 5, 5, 5, 1, 2, 2, 1]",15,19,34,0
5934,"[]","[]","['compartilhar', 'disfarcar', 'fotografia', 'fotografia', 'fotografia', 'fotografo', 'imagem', 'legendar', 'protestar', 'sacar']","[1, 1, 3, 3, 3, 1, 1, 1, 1, 1]",0,10,10,0
5935,"['barroso', 'recuar', 'republico']","[1, 1, 1]","['assassinar', 'assassinar', 'ideologia', 'pelar', 'sobrar', 'sobrar', 'sobrar', 'venezuelano']","[2, 2, 1, 1, 3, 3, 3, 1]",3,8,11,0
5936,"['domingo', 'instalacao', 'logistico']","[1, 1, 1]","['grupar', 'imenso', 'invadir', 'parir', 'versao', 'versao', 'versao']","[1, 1, 1, 1, 3, 3, 3]",3,7,10,0
5939,"['goncalo', 'reafirmar']","[1, 1]","['ideologia', 'ideologia', 'implantar', 'implantar']","[2, 2, 2, 2]",2,4,6,0
5941,"['amplo', 'autoridad', 'propagacao', 'saudar']","[1, 1, 1, 1]","['compartilhar', 'gravacao']","[1, 1]",4,2,6,0
5942,"[]","[]","['curioso', 'espalhar']","[1, 1]",0,2,2,0
5943,"['ministrar', 'primeiroministro', 'primeiroministro', 'reuniao']","[1, 2, 2, 1]","['parir', 'revoltar', 'versao', 'versao']","[1, 1, 2, 2]",4,4,8,0
5945,"['manutencao', 'recurso', 'respirador']","[1, 1, 1]","[]","[]",3,0,3,0
5947,"['pastar', 'pratico', 'regrar']","[1, 1, 1]","['circular', 'compartilhar', 'imagem']","[1, 1, 1]",3,3,6,0
5948,"[]","[]","[]","[]",0,0,0,0
5950,"['planar']","[1]","['biblia', 'versao']","[1, 1]",1,2,3,0
5952,"['californio', 'orientacao']","[1, 1]","['atribuir', 'atribuir', 'circular', 'verificar']","[2, 2, 1, 1]",2,4,6,0
5953,"['client', 'condicao', 'condicao']","[1, 2, 2]","['realment']","[1]",3,1,4,0
5954,"['constituicao', 'saudar']","[1, 1]","['dorio', 'dorio', 'parabem']","[2, 2, 1]",2,3,5,0
5961,"['administrativo', 'autoridad', 'improbidad']","[1, 1, 1]","['abusar', 'enganar']","[1, 1]",3,2,5,0
5963,"['quedo']","[1]","['chorar']","[1]",1,1,2,0
5964,"['domingo', 'domingo']","[2, 2]","['circular', 'fotografo', 'imagem', 'imagem']","[1, 1, 2, 2]",2,4,6,0
5970,"['diariament', 'orientacao']","[1, 1]","['garganta', 'garganta', 'limao', 'limao', 'vitaminar']","[2, 2, 2, 2, 1]",2,5,7,0
5972,"[]","[]","['humanar']","[1]",0,1,1,0
5974,"[]","[]","['espalhar', 'pelar']","[1, 1]",0,2,2,0
5982,"[]","[]","['acidentar', 'acidentar', 'circular', 'legendar', 'motorista', 'sequer']","[2, 2, 1, 1, 1, 1]",0,6,6,0
5985,"['competicao', 'movimentacao', 'plantao', 'proporcao', 'realizacao', 'wilson', 'witzel']","[1, 1, 1, 1, 1, 1, 1]","['libertador']","[1]",7,1,8,0
5988,"['bruto', 'bruto']","[2, 2]","['compartilhar', 'despejar', 'despejar', 'lixar', 'nordestino', 'nordestino', 'venezuelano', 'venezuelano']","[1, 2, 2, 1, 2, 2, 2, 2]",2,8,10,0
5992,"['adulto', 'dedicar']","[1, 1]","['filmar', 'parir']","[1, 1]",2,2,4,0
5997,"[]","[]","['realment']","[1]",0,1,1,0
5999,"[]","[]","['imagem']","[1]",0,1,1,0
6003,"['economia', 'gued', 'ministrar', 'monitoramento', 'privatizacao']","[1, 1, 1, 1, 1]","['circular', 'enganoso']","[1, 1]",5,2,7,0
6012,"['sabado']","[1]","['logotipo', 'usuario']","[1, 1]",1,2,3,0
6014,"['escalar']","[1]","['circular', 'limao']","[1, 1]",1,2,3,0
6021,"['celso', 'subir']","[1, 1]","['checar', 'numericament', 'parir']","[1, 1, 1]",2,3,5,0
6022,"['celso', 'opcao', 'regiao']","[1, 1, 1]","['checar', 'numericament']","[1, 1]",3,2,5,0
6023,"['entregu', 'entregu', 'recordar']","[2, 2, 1]","['checar', 'numericament']","[1, 1]",3,2,5,0
6024,"[]","[]","['checar', 'numericament']","[1, 1]",0,2,2,0
6025,"['crescimento', 'liderar']","[1, 1]","['checar', 'numericament']","[1, 1]",2,2,4,0
6026,"[]","[]","['checar', 'numericament', 'vazio']","[1, 1, 1]",0,3,3,0
6027,"['quedo', 'ricardo']","[1, 1]","['acidentar']","[1]",2,1,3,0
6035,"['absoluto']","[1]","['huawei']","[1]",1,1,2,0
6036,"['risco', 'saudar', 'saudar', 'saudar']","[1, 3, 3, 3]","['circular', 'circular', 'incendio']","[2, 2, 1]",4,3,7,0
6038,"['suspeito']","[1]","['assaltar', 'assaltar', 'desfilar', 'escutar', 'postagen', 'viralizada']","[2, 2, 1, 1, 1, 1]",1,6,7,0
6040,"['gabinet']","[1]","['cbn', 'circular', 'circular']","[1, 2, 2]",1,3,4,0
6041,"['desempenhar', 'desempenhar']","[2, 2]","['camisa', 'camisa', 'camisa', 'camisa', 'clicar', 'compartilhar', 'compartilhar', 'instrucao', 'patrocinador']","[4, 4, 4, 4, 1, 2, 2, 1, 1]",2,9,11,0
6043,"[]","[]","[]","[]",0,0,0,0
6047,"['congresso']","[1]","['circular', 'idioma', 'legendar']","[1, 1, 1]",1,3,4,0
6049,"[]","[]","['atribuir', 'espalhar', 'torrar', 'torrar']","[1, 1, 2, 2]",0,4,4,0
6051,"['pereira', 'publicitario', 'quarentenar']","[1, 1, 1]","['circular', 'fotografo', 'legendar']","[1, 1, 1]",3,3,6,0
6053,"['conformar', 'especifico', 'respostar']","[1, 1, 1]","[]","[]",3,0,3,0
6054,"['circulacao', 'privar', 'vetar']","[1, 1, 1]","['cartaz', 'circular', 'enganir']","[1, 1, 1]",3,3,6,0
6056,"['positivar']","[1]","['checar']","[1]",1,1,2,0
6058,"['gued', 'ministrar']","[1, 1]","['manchet']","[1]",2,1,3,0
6059,"['ambito']","[1]","['atribuir', 'circular', 'compartilhar', 'compartilhar', 'falsar']","[1, 1, 2, 2, 1]",1,5,6,0
6062,"[]","[]","[]","[]",0,0,0,0
6063,"['estagio', 'fase', 'genoma', 'genoma']","[1, 1, 2, 2]","['compartilhar', 'parabem', 'parabem']","[1, 2, 2]",4,3,7,0
6067,"[]","[]","['efarsa', 'realment']","[1, 1]",0,2,2,0
6068,"['opcao', 'preservacao', 'preservacao', 'recebido', 'recebido', 'regiao', 'respostar']","[1, 2, 2, 2, 2, 1, 1]","['vc']","[1]",7,1,8,0
6070,"[]","[]","['circular', 'pelar']","[1, 1]",0,2,2,0
6071,"['condicao', 'prorrogacao']","[1, 1]","['atribuir', 'boatar', 'circular', 'imagem', 'postagen', 'sequer']","[1, 1, 1, 1, 1, 1]",2,6,8,0
6072,"['precaucao']","[1]","['preencher']","[1]",1,1,2,0
6074,"['feriar', 'republico', 'saudar']","[1, 1, 1]","[]","[]",3,0,3,0
6075,"['consolidar', 'periodo', 'propagacao']","[1, 1, 1]","['circular', 'circular', 'compartilhar', 'dorio', 'usuario']","[2, 2, 1, 1, 1]",3,5,8,0
6077,"['informaco']","[1]","['caixao', 'caixao', 'caixao', 'caixao', 'humanar', 'vazio', 'vazio', 'vazio', 'vazio', 'vazio']","[4, 4, 4, 4, 1, 5, 5, 5, 5, 5]",1,10,11,0
6078,"['jornada', 'sabado']","[1, 1]","['circular', 'circular', 'circular', 'imagem', 'imagem', 'imagem']","[3, 3, 3, 3, 3, 3]",2,6,8,0
6079,"[]","[]","[]","[]",0,0,0,0
6082,"['destacar', 'parceiro']","[1, 1]","['circular', 'ganhar', 'ganhar', 'motorista', 'sobrar']","[1, 2, 2, 1, 1]",2,5,7,0
6083,"['companhia', 'companhia', 'folhar', 'situacao', 'varar']","[2, 2, 1, 1, 1]","['arvor', 'arvor', 'arvor', 'circular', 'legendar', 'motorista']","[3, 3, 3, 1, 1, 1]",5,6,11,0
6084,"['anvisa', 'oficio']","[1, 1]","['enganoso']","[1]",2,1,3,0
6086,"['respostar']","[1]","['cedula', 'cedula', 'cedula', 'circular', 'compartilhar', 'falsar']","[3, 3, 3, 1, 1, 1]",1,6,7,0
6087,"['estatistico', 'regiao']","[1, 1]","['acidentar', 'circular', 'fraudar', 'manipulacao', 'realment']","[1, 1, 1, 1, 1]",2,5,7,0
6089,"[]","[]","['parir']","[1]",0,1,1,0
6090,"['biliao']","[1]","[]","[]",1,0,1,0
6091,"[]","[]","['circular', 'compartilhar', 'imagem', 'legendar', 'sequer']","[1, 1, 1, 1, 1]",0,5,5,0
6096,"['legislativo', 'wellington']","[1, 1]","['circular', 'circular', 'compartilhar', 'imagem', 'imagem']","[2, 2, 1, 2, 2]",2,5,7,0
6099,"['conformar', 'exministro', 'exministro', 'mandatario', 'monitoramento', 'nomeacao']","[1, 2, 2, 1, 1, 1]","['circular', 'enganoso', 'viralizado']","[1, 1, 1]",6,3,9,0
6100,"[]","[]","['argan', 'basto', 'compartilhar', 'enderecar', 'enderecar', 'ganhar', 'ganhar', 'ganhar', 'inscricao', 'parabem', 'preencher']","[1, 1, 1, 2, 2, 3, 3, 3, 1, 1, 1]",0,11,11,0
6108,"['integro']","[1]","['circular']","[1]",1,1,2,0
6110,"['parceiro']","[1]","['dorio']","[1]",1,1,2,0
6113,"[]","[]","['manobrar']","[1]",0,1,1,0
6118,"['defendido', 'orientacao']","[1, 1]","['atribuir', 'atribuir', 'circular', 'compartilhar', 'usuario']","[2, 2, 1, 1, 1]",2,5,7,0
6120,"['presidir']","[1]","['capturar', 'compartilhar', 'postagen', 'realment']","[1, 1, 1, 1]",1,4,5,0
6121,"['alunar', 'possibilidad', 'previsao']","[1, 1, 1]","['compartilhar']","[1]",3,1,4,0
6122,"['prorrogar']","[1]","['dorio', 'expulsar']","[1, 1]",1,2,3,0
6123,"['preventivo']","[1]","[]","[]",1,0,1,0
6126,"['associacao', 'dosar', 'preventivo', 'reforcar']","[1, 1, 1, 1]","['circular', 'vitaminar']","[1, 1]",4,2,6,0
6127,"['destacar', 'destacar', 'folhar', 'mello', 'minoria', 'periodo', 'reportar', 'reuter', 'spaulo']","[2, 2, 1, 1, 1, 1, 1, 1, 1]","['circular', 'compartilhar', 'compartilhar', 'imagem', 'imagem', 'imagem', 'usuario']","[1, 2, 2, 3, 3, 3, 1]",9,7,16,0
6129,"['diretoria', 'exministro', 'inquerito', 'oficialment']","[1, 1, 1, 1]","['adelio', 'adelio', 'adelio', 'bispar']","[3, 3, 3, 1]",4,4,8,0
6130,"['apurar', 'estabilidad', 'estabilidad', 'relativo', 'totalizar']","[1, 2, 2, 1, 1]","['circular', 'fraudar', 'fraudar']","[1, 2, 2]",5,3,8,0
6131,"['integrant', 'saudar', 'saudar', 'situacao']","[1, 2, 2, 1]","[]","[]",4,0,4,0
6134,"['domingo', 'mudanca', 'sabado']","[1, 1, 1]","['amplament', 'circular', 'postagen', 'replicar']","[1, 1, 1, 1]",3,4,7,0
6136,"['diminuicao', 'reconhecimento']","[1, 1]","['ganhar', 'imagem', 'imagem']","[1, 2, 2]",2,3,5,0
6139,"['espanha', 'espanha', 'fronteiro', 'fronteiro']","[2, 2, 2, 2]","[]","[]",4,0,4,0
6141,"['paralelo', 'recebido', 'recurso']","[1, 1, 1]","['auditoria', 'auditoria', 'auditoria', 'auditoria', 'auditoria', 'circular', 'fraudar', 'sortear']","[5, 5, 5, 5, 5, 1, 1, 1]",3,8,11,0
6142,"[]","[]","[]","[]",0,0,0,0
6147,"['epidemiologico', 'quedo']","[1, 1]","['boatar', 'desmentir']","[1, 1]",2,2,4,0
6150,"['gued']","[1]","[]","[]",1,0,1,0
6151,"[]","[]","['venezuelano', 'venezuelano', 'venezuelano']","[3, 3, 3]",0,3,3,0
6152,"['saudar', 'situacao']","[1, 1]","['espalhar', 'imagem']","[1, 1]",2,2,4,0
6153,"[]","[]","['verdadeiro']","[1]",0,1,1,0
6154,"['proposto']","[1]","['enganoso', 'postagen', 'sobrar', 'verificacao']","[1, 1, 1, 1]",1,4,5,0
6162,"[]","[]","['imagem', 'parir']","[1, 1]",0,2,2,0
6165,"['autoridad', 'saudar']","[1, 1]","['enganir', 'segundar', 'sobrar']","[1, 1, 1]",2,3,5,0
6167,"['justicar', 'normalment', 'normalment']","[1, 2, 2]","['circular', 'circular', 'fraudar', 'fraudar', 'fraudar']","[2, 2, 3, 3, 3]",3,5,8,0
6168,"['folhar', 'reuniao']","[1, 1]","['compartilhar', 'imagem', 'manchet']","[1, 1, 1]",2,3,5,0
6169,"['amplo', 'atuam', 'consequencia', 'desenvolvido', 'precedent', 'saudar', 'transferir']","[1, 1, 1, 1, 1, 1, 1]","['humanar', 'manipulacao', 'manipulacao', 'realment']","[1, 2, 2, 1]",7,4,11,0
6174,"['recebido', 'risco', 'saudar', 'saudar', 'taxar']","[1, 1, 2, 2, 1]","['compartilhar', 'enfim', 'sapato']","[1, 1, 1]",5,3,8,0
6175,"['adotada', 'expressar', 'propagacao', 'restritivo']","[1, 1, 1, 1]","['compartilhar', 'legendar', 'viralizada']","[1, 1, 1]",4,3,7,0
6177,"[]","[]","['circular', 'limao', 'limao', 'limao', 'suco', 'suco']","[1, 3, 3, 3, 2, 2]",0,6,6,0
6180,"['biliao', 'dificuldad', 'integrant', 'respiratorio']","[1, 1, 1, 1]","['circular', 'estomago', 'estomago', 'estomago', 'garganta', 'garganta', 'garganta', 'garganta', 'garganta', 'suco']","[1, 3, 3, 3, 5, 5, 5, 5, 5, 1]",4,10,14,0
6185,"['absoluto', 'enxergar']","[1, 1]","['manobrar', 'revoltar']","[1, 1]",2,2,4,0
6186,"['adotada', 'restritivo']","[1, 1]","['compartilhar', 'fotografia', 'ganhar', 'imagem', 'postagen', 'reverso']","[1, 1, 1, 1, 1, 1]",2,6,8,0
6187,"['cerimonia']","[1]","['espalhar', 'humanar', 'imagem']","[1, 1, 1]",1,3,4,0
6188,"['decisao', 'equivalent', 'possibilidad', 'possibilidad', 'possibilidad', 'prever', 'supremo']","[1, 1, 3, 3, 3, 1, 1]","['cedula', 'cedula', 'enganir', 'supostament']","[2, 2, 1, 1]",7,4,11,0
6189,"['aplicacao', 'presenca']","[1, 1]","['circular', 'circular', 'imagem', 'imagem', 'imagem', 'legendar', 'realment', 'versao']","[2, 2, 3, 3, 3, 1, 1, 1]",2,8,10,0
6191,"['justicar', 'ministrar']","[1, 1]","['circular', 'rosario']","[1, 1]",2,2,4,0
6192,"['administrativo', 'distrito', 'distrito', 'observacao', 'pastar', 'regiao', 'santiago']","[1, 2, 2, 1, 1, 1, 1]","['compartilhar', 'interaco', 'menino', 'soltura', 'soltura', 'soltura', 'torturar']","[1, 1, 1, 3, 3, 3, 1]",7,7,14,0
6193,"['expressivo']","[1]","['copiar']","[1]",1,1,2,0
6198,"['congresso']","[1]","['compartilhar', 'fraudar', 'legendar', 'parir', 'protestar', 'protestar', 'protestar']","[1, 1, 1, 1, 3, 3, 3]",1,7,8,0
6201,"['exportacao', 'exportacao', 'investigacao', 'monetario', 'periodo', 'volumar']","[2, 2, 1, 1, 1, 1]","[]","[]",6,0,6,0
6202,"['associacao', 'investigacao']","[1, 1]","['abortar', 'abortar', 'sortir']","[2, 2, 1]",2,3,5,0
6204,"['escalar', 'justicar', 'previsto', 'supremo']","[1, 1, 1, 1]","['amplament', 'circular', 'compartilhar', 'espalhar', 'fotografia', 'imagem', 'imagem', 'indignar', 'usuario', 'viralizada']","[1, 1, 1, 1, 1, 2, 2, 1, 1, 1]",4,10,14,0
6205,"[]","[]","[]","[]",0,0,0,0
6208,"['ambientar', 'ambientar']","[2, 2]","[]","[]",2,0,2,0
6209,"['pagamento', 'pagamento']","[2, 2]","['fraudar', 'fraudar', 'fraudar', 'fraudar', 'vc', 'vc']","[4, 4, 4, 4, 2, 2]",2,6,8,0
6210,"['acumular']","[1]","['biblia', 'circular', 'circular', 'idioma', 'imagem', 'imagem', 'imagem', 'legendar', 'reverso']","[1, 2, 2, 1, 3, 3, 3, 1, 1]",1,9,10,0
6212,"[]","[]","['compartilhar', 'deitar', 'imagem']","[1, 1, 1]",0,3,3,0
6218,"[]","[]","['circular', 'compartilhar', 'idioma']","[1, 1, 1]",0,3,3,0
6219,"['curso', 'economia']","[1, 1]","[]","[]",2,0,2,0
6220,"[]","[]","['compartilhar', 'usuario']","[1, 1]",0,2,2,0
6222,"['comorbidad']","[1]","[]","[]",1,0,1,0
6225,"['afp']","[1]","['checar', 'compartilhar', 'legendar', 'maldiz', 'verificacao']","[1, 1, 1, 1, 1]",1,5,6,0
6227,"['ministrar', 'respirador', 'teich', 'teich', 'teich', 'teich']","[1, 1, 4, 4, 4, 4]","['patrocinador']","[1]",6,1,7,0
6228,"['consumidor']","[1]","['amigar', 'enganar', 'puro', 'puro', 'puro', 'puro']","[1, 1, 4, 4, 4, 4]",1,6,7,0
6230,"['privar']","[1]","['compartilhar', 'falsar', 'gravacao', 'imagem', 'imagem', 'vazio', 'viralizada']","[1, 1, 1, 2, 2, 1, 1]",1,7,8,0
6235,"['convencao', 'espanha', 'itamarati', 'itamarati', 'mudanca', 'passageiro', 'regrar', 'regrar', 'tripulacao']","[1, 1, 2, 2, 1, 1, 2, 2, 1]","['circular', 'cocaina']","[1, 1]",9,2,11,0
6236,"['aglomeracao', 'assistencia', 'recurso', 'respectivament']","[1, 1, 1, 1]","['enderecar']","[1]",4,1,5,0
6237,"[]","[]","['bonner', 'revoltar', 'sobrar', 'vc']","[1, 1, 1, 1]",0,4,4,0
6245,"['infectar']","[1]","['cbn', 'compartilhar', 'sacar']","[1, 1, 1]",1,3,4,0
6253,"[]","[]","['imagem']","[1]",0,1,1,0
6255,"[]","[]","['espalhar', 'imagem', 'imagem']","[1, 2, 2]",0,3,3,0
6256,"[]","[]","['postagen']","[1]",0,1,1,0
6258,"[]","[]","['manipular']","[1]",0,1,1,0
6263,"[]","[]","[]","[]",0,0,0,0
6264,"['circulacao', 'suportar']","[1, 1]","['abusar', 'sortir']","[1, 1]",2,2,4,0
6265,"[]","[]","['circular', 'compartilhar', 'imagem', 'misturar', 'postagen']","[1, 1, 1, 1, 1]",0,5,5,0
6269,"[]","[]","['amplament', 'chorar', 'circular', 'compartilhar', 'rouanet']","[1, 1, 1, 1, 1]",0,5,5,0
6272,"['aprovacao', 'argumentar', 'diariament', 'disseminacao', 'infectar', 'propagacao', 'saudar', 'saudar', 'supremo']","[1, 1, 1, 1, 1, 1, 2, 2, 1]","[]","[]",9,0,9,0
6274,"['ambientar', 'ambientar']","[2, 2]","['circular']","[1]",2,1,3,0
6275,"[]","[]","['assassinar', 'compartilhar']","[1, 1]",0,2,2,0
6277,"['reforcar', 'suspeito']","[1, 1]","['atirar', 'atirar', 'atirar']","[3, 3, 3]",2,3,5,0
6278,"['dialogo']","[1]","['crer', 'cuspir', 'cuspir', 'espancar', 'expulsar', 'inocentar', 'menino', 'menino', 'parir', 'parir', 'parir', 'soldar']","[1, 2, 2, 1, 1, 1, 2, 2, 3, 3, 3, 1]",1,12,13,0
6281,"[]","[]","[]","[]",0,0,0,0
6286,"['economia', 'economia', 'gued', 'gued', 'gued', 'ministrar', 'ministrar', 'ministrar']","[2, 2, 3, 3, 3, 3, 3, 3]","['atribuir', 'atribuir', 'circular', 'enderecar', 'verificar']","[2, 2, 1, 1, 1]",8,5,13,0
6289,"['californio', 'segredar', 'treinamento']","[1, 1, 1]","['atirar', 'circular', 'falsar', 'imagem']","[1, 1, 1, 1]",3,4,7,0
6290,"[]","[]","['amplament', 'compartilhar', 'ilustrar', 'imagem', 'postagen', 'reverso', 'usuario']","[1, 1, 1, 1, 1, 1, 1]",0,7,7,0
6292,"['avancar']","[1]","['bandeiro', 'bandeiro', 'bandeiro', 'bandeiro', 'bandeiro', 'bandeiro']","[6, 6, 6, 6, 6, 6]",1,6,7,0
6294,"[]","[]","['enganir', 'espalhar']","[1, 1]",0,2,2,0
6296,"['afastamento', 'antonio', 'antonio', 'araujo', 'bolsonarista', 'decorrent', 'ernesto', 'ministrar']","[1, 2, 2, 1, 1, 1, 1, 1]","[]","[]",8,0,8,0
6297,"['economia']","[1]","['indignar']","[1]",1,1,2,0
6298,"['ministrar', 'saudar']","[1, 1]","['espalhar']","[1]",2,1,3,0
6299,"['crescimento', 'varar']","[1, 1]","['circular']","[1]",2,1,3,0
6301,"[]","[]","[]","[]",0,0,0,0
6303,"['aplicacao', 'insuficient', 'preventivo']","[1, 1, 1]","['compartilhar']","[1]",3,1,4,0
6304,"['individuar']","[1]","['compartilhar', 'usuario']","[1, 1]",1,2,3,0
6305,"[]","[]","['estranhar']","[1]",0,1,1,0
6307,"['avancar', 'importancia', 'inovacao']","[1, 1, 1]","['efarsa']","[1]",3,1,4,0
6308,"['ministrar']","[1]","[]","[]",1,0,1,0
6309,"['autoridad']","[1]","[]","[]",1,0,1,0
6311,"['flavio']","[1]","['checar', 'falsar', 'legendar', 'legendar', 'parir', 'pelar', 'segundar', 'telegram']","[1, 1, 2, 2, 1, 1, 1, 1]",1,8,9,0
6313,"['acumular', 'queiroz', 'queiroz']","[1, 2, 2]","['checar', 'versao']","[1, 1]",3,2,5,0
6315,"['infectar', 'parcelar']","[1, 1]","[]","[]",2,0,2,0
6316,"[]","[]","['desgracar', 'dorio', 'safar']","[1, 1, 1]",0,3,3,0
6319,"['client', 'diariament', 'parceria']","[1, 1, 1]","['clicar', 'compartilhar', 'compartilhar', 'compartilhar', 'compartilhar', 'ganhar']","[1, 4, 4, 4, 4, 1]",3,6,9,0
6320,"[]","[]","['barragem', 'invadir']","[1, 1]",0,2,2,0
6322,"['posturar', 'proposto']","[1, 1]","['dorio', 'dorio', 'verdadeiro']","[2, 2, 1]",2,3,5,0
6323,"['araujo', 'reforcar']","[1, 1]","['arvor', 'circular', 'filmar', 'imagem']","[1, 1, 1, 1]",2,4,6,0
6325,"[]","[]","['desmentir', 'efarsa', 'tampouco']","[1, 1, 1]",0,3,3,0
6326,"[]","[]","[]","[]",0,0,0,0
6327,"[]","[]","['camisa', 'obama', 'pelar']","[1, 1, 1]",0,3,3,0
6329,"[]","[]","['intitular']","[1]",0,1,1,0
6331,"['alteracao', 'infraestrutura', 'infraestrutura', 'ministrar', 'mudanca', 'mudanca', 'planalto', 'pratico', 'prazo', 'prever', 'proposto', 'regrar', 'regrar', 'resolucao', 'resolucao']","[1, 2, 2, 1, 2, 2, 1, 1, 1, 1, 1, 2, 2, 2, 2]","['circular', 'cnh', 'cnh', 'cnh', 'cnh', 'verdadeiro']","[1, 4, 4, 4, 4, 1]",15,6,21,0
6333,"['decisao', 'guarulho', 'oliveira']","[1, 1, 1]","['chorar', 'estuprar', 'estuprar', 'patrocinador']","[1, 2, 2, 1]",3,4,7,0
6334,"['monitoramento']","[1]","['abortar', 'circular', 'compartilhar', 'compartilhar', 'cristao', 'postagen']","[1, 1, 2, 2, 1, 1]",1,6,7,0
6337,"[]","[]","['circular', 'postagen']","[1, 1]",0,2,2,0
6339,"['internar']","[1]","['circular', 'verificar']","[1, 1]",1,2,3,0
6340,"[]","[]","['circular', 'imagem']","[1, 1]",0,2,2,0
6341,"['aprovacao', 'congresso', 'vetar']","[1, 1, 1]","['casamentar', 'casamentar', 'casamentar', 'casamentar', 'casamentar', 'pelar', 'pelar', 'pelar']","[5, 5, 5, 5, 5, 3, 3, 3]",3,8,11,0
6342,"['apurar']","[1]","['assassinar', 'sacar']","[1, 1]",1,2,3,0
6346,"['pagamento', 'parceria']","[1, 1]","['compartilhar', 'quinzena']","[1, 1]",2,2,4,0
6347,"['anticorpo', 'isolar']","[1, 1]","[]","[]",2,0,2,0
6349,"['globonew']","[1]","['cbn', 'checagem', 'checagem', 'disseminar', 'verificacao']","[1, 2, 2, 1, 1]",1,5,6,0
6350,"['exministro', 'inquerito']","[1, 1]","['compartilhar']","[1]",2,1,3,0
6352,"[]","[]","['bandeiro', 'clicar', 'clicar']","[1, 2, 2]",0,3,3,0
6360,"['presenca']","[1]","[]","[]",1,0,1,0
6361,"[]","[]","[]","[]",0,0,0,0
6362,"[]","[]","['caixao', 'caixao', 'vazio', 'vazio']","[2, 2, 2, 2]",0,4,4,0
6365,"[]","[]","['espalhar', 'imagem', 'quinzena']","[1, 1, 1]",0,3,3,0
6368,"[]","[]","[]","[]",0,0,0,0
6369,"[]","[]","['basto', 'compartilhar', 'compartilhar', 'ganhar', 'ganhar']","[1, 2, 2, 2, 2]",0,5,5,0
6373,"['rastreamento']","[1]","['implantar', 'protestar', 'protestar', 'protestar', 'vc', 'vc', 'vc', 'vc', 'vc', 'vc', 'vc']","[1, 3, 3, 3, 7, 7, 7, 7, 7, 7, 7]",1,11,12,0
6376,"['ufrj']","[1]","['espalhar', 'quinzena']","[1, 1]",1,2,3,0
6377,"['conduta', 'enfrentamento']","[1, 1]","['atribuir', 'enganoso']","[1, 1]",2,2,4,0
6379,"['previsto']","[1]","['atribuir', 'circular', 'fotografia', 'ilustrar', 'imagem', 'imagem', 'imagem', 'legendar']","[1, 1, 1, 1, 3, 3, 3, 1]",1,8,9,0
6382,"['ampliacao', 'ampliacao', 'companhia', 'trafego']","[2, 2, 1, 1]","['checar', 'circular', 'circular', 'versao']","[1, 2, 2, 1]",4,4,8,0
6384,"['carat', 'conduta']","[1, 1]","['chorar', 'parir', 'parir', 'pelar', 'soldar', 'soldar', 'soldar', 'torturar', 'vezar']","[1, 2, 2, 1, 3, 3, 3, 1, 1]",2,9,11,0
6385,"['esforco', 'impactar', 'inclusao', 'mudanca']","[1, 1, 1, 1]","['circular', 'sacar']","[1, 1]",4,2,6,0
6386,"['complicacao', 'infectar', 'instituto']","[1, 1, 1]","['circular', 'compartilhar', 'legendar']","[1, 1, 1]",3,3,6,0
6390,"[]","[]","['amplament', 'circular', 'espalhar', 'replicar', 'reverso']","[1, 1, 1, 1, 1]",0,5,5,0
6394,"['escalar', 'infectar', 'precaucao', 'quarentenar', 'totalizar']","[1, 1, 1, 1, 1]","['amplament', 'circular', 'compartilhar']","[1, 1, 1]",5,3,8,0
6395,"['mantido']","[1]","['circular', 'manchet']","[1, 1]",1,2,3,0
6396,"['saudar']","[1]","['atribuir', 'cartaz', 'cartaz', 'circular', 'imagem', 'manipular', 'verdadeiro']","[1, 2, 2, 1, 1, 1, 1]",1,7,8,0
6397,"[]","[]","[]","[]",0,0,0,0
6399,"['comissao', 'henriqu', 'integrant', 'pagamento', 'reuniao']","[1, 1, 1, 1, 1]","[]","[]",5,0,5,0
6400,"['justicar', 'marinhar', 'pagamento', 'pagamento', 'transmissao']","[1, 1, 2, 2, 1]","[]","[]",5,0,5,0
6401,"['assistencia']","[1]","['circular', 'mentiroso']","[1, 1]",1,2,3,0
6406,"['augusto', 'concedido', 'oliveira']","[1, 1, 1]","['libertador', 'verificar']","[1, 1]",3,2,5,0
6407,"['ministrar', 'ministrar', 'plenario']","[2, 2, 1]","[]","[]",3,0,3,0
6408,"['calculo', 'estimativo', 'estimativo', 'estimativo', 'impactar']","[1, 3, 3, 3, 1]","['atribuir', 'ganhar', 'parir', 'parir', 'pelar', 'pelar', 'pelar', 'segundar', 'verificar']","[1, 1, 2, 2, 3, 3, 3, 1, 1]",5,9,14,0
6410,"[]","[]","['enganir', 'parir', 'parir', 'sobrar']","[1, 2, 2, 1]",0,4,4,0
6413,"['estimativo']","[1]","[]","[]",1,0,1,0
6417,"[]","[]","['biblia', 'desligar', 'vc', 'vc', 'vc', 'vc']","[1, 1, 4, 4, 4, 4]",0,6,6,0
6419,"['celebrar', 'crise', 'dosar', 'imunizacao', 'legislativo', 'ministrar', 'provinci', 'sputnik', 'tendencia']","[1, 1, 1, 1, 1, 1, 1, 1, 1]","['imagem', 'imagem', 'replicar']","[2, 2, 1]",9,3,12,0
6423,"['ministrar', 'ribeiro']","[1, 1]","['espalhar', 'imagem']","[1, 1]",2,2,4,0
6424,"['decisao', 'implementar', 'lewandowski', 'ministrar', 'plenario', 'proferir']","[1, 1, 1, 1, 1, 1]","['versao']","[1]",6,1,7,0
6430,"['suspeito']","[1]","[]","[]",1,0,1,0
6431,"[]","[]","[]","[]",0,0,0,0
6434,"['calheiro', 'inquerito', 'justicar', 'mantido']","[1, 1, 1, 1]","['adelio', 'adelio', 'adelio', 'amigar', 'amigar', 'bispar', 'bispar', 'bispar', 'soltar']","[3, 3, 3, 2, 2, 3, 3, 3, 1]",4,9,13,0
6441,"['avancar']","[1]","['transposicao']","[1]",1,1,2,0
6443,"['contrato', 'enquadrar', 'especifico', 'mudanca', 'prazo', 'reducao', 'reducao', 'regrar', 'regrar', 'risco']","[1, 1, 1, 1, 1, 2, 2, 2, 2, 1]","['boatar']","[1]",10,1,11,0
6446,"[]","[]","['checagem', 'efarsa']","[1, 1]",0,2,2,0
6447,"['pulmonar', 'pulmonar']","[2, 2]","['acidentar']","[1]",2,1,3,0
6449,"['decisao', 'plenario', 'republico', 'supremo', 'unanimidad']","[1, 1, 1, 1, 1]","['biblia', 'biblia', 'biblia', 'compartilhar', 'postagen']","[3, 3, 3, 1, 1]",5,5,10,0
6453,"['atrasar', 'elaborar', 'lavagem', 'lavagem', 'plano']","[1, 1, 2, 2, 1]","['compartilhar', 'obama', 'obama', 'obama', 'trafico', 'trafico']","[1, 3, 3, 3, 2, 2]",5,6,11,0
6456,"['desenvolvimento', 'modelo', 'processo']","[1, 1, 1]","['assassinar', 'circular']","[1, 1]",3,2,5,0
6457,"['favorito']","[1]","[]","[]",1,0,1,0
6458,"['ministrar', 'saudar']","[1, 1]","['circular', 'compartilhar', 'espancar', 'imagem', 'imagem', 'reverso']","[1, 1, 1, 2, 2, 1]",2,6,8,0
6459,"['ministrar']","[1]","['pelar', 'tortura']","[1, 1]",1,2,3,0
6465,"['anticorpo', 'estagio', 'instituto']","[1, 1, 1]","['enfim', 'humanar', 'parabem']","[1, 1, 1]",3,3,6,0
6466,"['crise', 'internar', 'subir', 'transferencia']","[1, 1, 1, 1]","['circular', 'imagem', 'manipular']","[1, 1, 1]",4,3,7,0
6467,"['piorar']","[1]","['enganoso', 'legendar']","[1, 1]",1,2,3,0
6468,"['administrativo', 'suspensao']","[1, 1]","['cnh', 'motorista', 'motorista']","[1, 2, 2]",2,3,5,0
6469,"[]","[]","['filmar', 'filmar', 'filmar']","[3, 3, 3]",0,3,3,0
6472,"['institut', 'instituto', 'saudar', 'variacao']","[1, 1, 1, 1]","['checar', 'circular']","[1, 1]",4,2,6,0
6475,"['acumular']","[1]","['abencoar', 'circular', 'circular', 'compartilhar', 'imagem', 'limao', 'postagen']","[1, 2, 2, 1, 1, 1, 1]",1,7,8,0
6476,"[]","[]","[]","[]",0,0,0,0
6477,"['aplicacao', 'instituto']","[1, 1]","['checar', 'circular', 'enganoso', 'imagem']","[1, 1, 1, 1]",2,4,6,0
6478,"['distrito', 'externo']","[1, 1]","['acidentar', 'amplament', 'carrefour', 'compartilhar', 'incendio', 'incendio', 'incendio', 'protestar']","[1, 1, 1, 1, 3, 3, 3, 1]",2,8,10,0
6481,"['iniciativo']","[1]","['bandeiro', 'bandeiro', 'bandeiro', 'compartilhar', 'espalhar', 'imagem', 'usuario']","[3, 3, 3, 1, 1, 1, 1]",1,7,8,0
6484,"['desenvolvimento']","[1]","['boatar', 'espalhar', 'usuario']","[1, 1, 1]",1,3,4,0
6485,"[]","[]","['fraudar', 'secreto']","[1, 1]",0,2,2,0
6487,"['autorizacao', 'autorizacao', 'companhia', 'concedido', 'obtido']","[2, 2, 1, 1, 1]","['grupar', 'nasal', 'nasal', 'parir', 'parir', 'parir', 'parir', 'pelar', 'pelar', 'pelar', 'verificar']","[1, 2, 2, 4, 4, 4, 4, 3, 3, 3, 1]",5,11,16,0
6488,"['decisao', 'decisao', 'interpretar', 'pagamento', 'recurso', 'recurso', 'supremo', 'transferir']","[2, 2, 1, 1, 2, 2, 1, 1]","['enganoso', 'menino', 'menino']","[1, 2, 2]",8,3,11,0
6489,"['domingo', 'suspeito']","[1, 1]","[]","[]",2,0,2,0
6490,"['habito', 'internar', 'preventivo']","[1, 1, 1]","['amigar', 'amigar', 'amigar', 'amigar', 'amigar', 'parir', 'puro', 'puro', 'quantum', 'terrorismo']","[5, 5, 5, 5, 5, 1, 2, 2, 1, 1]",3,10,13,0
6491,"['apurar']","[1]","['fraudar', 'ganhar']","[1, 1]",1,2,3,0
6494,"[]","[]","['falsar', 'sobrar', 'sobrar']","[1, 2, 2]",0,3,3,0
6495,"['autorizacao', 'lewandowski', 'ministrar']","[1, 1, 1]","['circular', 'compartilhar', 'imagem', 'legendar']","[1, 1, 1, 1]",3,4,7,0
6497,"['pagamento', 'saudar']","[1, 1]","['amplament', 'bandeiro', 'circular', 'compartilhar', 'gravacao', 'imagem', 'postagen', 'protestar']","[1, 1, 1, 1, 1, 1, 1, 1]",2,8,10,0
6500,"['anteriorment', 'aspecto', 'complicacao', 'desgastar', 'infancia', 'infectar', 'infectar', 'infectar', 'infectar', 'infectar', 'inicialment', 'necessario', 'precaucao', 'pulmonar', 'reducao', 'respostar', 'respostar', 'saudar', 'saudar', 'ventilador', 'ventilador']","[1, 1, 1, 1, 1, 5, 5, 5, 5, 5, 1, 1, 1, 1, 1, 2, 2, 2, 2, 2, 2]","['deitar']","[1]",21,1,22,0
6502,"['higienizacao', 'viagem']","[1, 1]","[]","[]",2,0,2,0
6503,"['calendario', 'fase', 'imunizacao', 'previsao', 'saudar']","[1, 1, 1, 1, 1]","[]","[]",5,0,5,0
6505,"['quarentenar']","[1]","['autopsia', 'circular', 'compartilhar', 'gravacao', 'minutar', 'postagen']","[1, 1, 1, 1, 1, 1]",1,6,7,0
6506,"['constituicao', 'varar']","[1, 1]","['ideologia', 'parir', 'parir', 'quantum']","[1, 2, 2, 1]",2,4,6,0
6508,"[]","[]","[]","[]",0,0,0,0
6509,"['justicar', 'privar']","[1, 1]","['compartilhar', 'invadir', 'pelar', 'torturar']","[1, 1, 1, 1]",2,4,6,0
6514,"['infraestrutura', 'possibilidad', 'previsao', 'propagacao', 'regulamentar', 'situacao']","[1, 1, 1, 1, 1, 1]","['circular', 'circular', 'cnh', 'motorista']","[2, 2, 1, 1]",6,4,10,0
6517,"['biliao', 'henriqu', 'henriqu']","[1, 2, 2]","['compartilhar', 'compartilhar', 'maldiz']","[2, 2, 1]",3,3,6,0
6518,"['client', 'desafiar', 'passageiro', 'quarentenar']","[1, 1, 1, 1]","['circular']","[1]",4,1,5,0
6519,"['habitant', 'intensivo', 'quedo', 'quedo', 'reabrir', 'reabrir', 'saudar', 'saudar', 'suspensao', 'turistico']","[1, 1, 2, 2, 2, 2, 2, 2, 1, 1]","['parir', 'pelar', 'pelar']","[1, 2, 2]",10,3,13,0
6520,"['economia', 'justicar', 'levantamento', 'supremo']","[1, 1, 1, 1]","['mafia']","[1]",4,1,5,0
6527,"['julgamento', 'prever', 'prever', 'regrar', 'supremo', 'supremo', 'unanimidad']","[1, 2, 2, 1, 2, 2, 1]","['circular']","[1]",7,1,8,0
6531,"['preconceito']","[1]","['verdadeiro']","[1]",1,1,2,0
6532,"['ambientar', 'ministrar', 'ministrar', 'reuniao', 'ricardo', 'sall', 'sall']","[1, 2, 2, 1, 1, 2, 2]","['amplament', 'compartilhar', 'espalhar']","[1, 1, 1]",7,3,10,0
6533,"['celebrar', 'fase', 'iniciativo', 'oficialment', 'privar']","[1, 1, 1, 1, 1]","['circular', 'imagem', 'legendar', 'verificar']","[1, 1, 1, 1]",5,4,9,0
6539,"['armazenamento', 'preservar', 'recebido', 'remessar', 'saudar', 'saudar']","[1, 1, 1, 1, 2, 2]","['circular']","[1]",6,1,7,0
6541,"['europeu', 'oficialment', 'saudar']","[1, 1, 1]","['cbn', 'circular']","[1, 1]",3,2,5,0
6543,"[]","[]","[]","[]",0,0,0,0
6544,"['recordar']","[1]","['circular', 'compartilhar', 'incendio', 'postagen']","[1, 1, 1, 1]",1,4,5,0
6547,"['investigacao', 'passageiro', 'passageiro']","[1, 2, 2]","['espalhar', 'imagem', 'menino', 'vazar', 'venezuelano']","[1, 1, 1, 1, 1]",3,5,8,0
6549,"[]","[]","['compartilhar', 'compartilhar', 'compartilhar', 'compartilhar', 'compartilhar', 'compartilhar', 'vagabundar', 'vagabundar', 'vagabundar', 'vagabundar']","[6, 6, 6, 6, 6, 6, 4, 4, 4, 4]",0,10,10,0
6550,"[]","[]","['expulsar', 'expulsar', 'expulsar']","[3, 3, 3]",0,3,3,0
6551,"['almeida', 'anteriorment']","[1, 1]","['atribuir', 'circular', 'reivindicar']","[1, 1, 1]",2,3,5,0
6554,"[]","[]","[]","[]",0,0,0,0
6556,"['condicao', 'enfrentamento', 'ricardo', 'saudar']","[1, 1, 1, 1]","['parir', 'parir', 'pelar', 'sobrar']","[2, 2, 1, 1]",4,4,8,0
6560,"['planar']","[1]","['compartilhar', 'imagem', 'parir']","[1, 1, 1]",1,3,4,0
6562,"[]","[]","['humanar', 'parabem']","[1, 1]",0,2,2,0
6563,"['nomeacao', 'ribeiro', 'ribeiro', 'situacao']","[1, 2, 2, 1]","['filmar', 'versao', 'versao']","[1, 2, 2]",4,3,7,0
6566,"['decisao', 'supremo']","[1, 1]","['checagem', 'checar', 'circular', 'circular']","[1, 1, 2, 2]",2,4,6,0
6567,"['anuncio', 'companhia', 'companhia', 'economia', 'gued', 'ministrar', 'mudanca', 'planar', 'privatizacao', 'privatizacao', 'privatizacao', 'proposto']","[1, 2, 2, 1, 1, 1, 1, 1, 3, 3, 3, 1]","['postagen']","[1]",12,1,13,0
6569,"[]","[]","[]","[]",0,0,0,0
6570,"['anvisa', 'anvisa', 'anvisa', 'decorrent', 'necessario']","[3, 3, 3, 1, 1]","['circular', 'verdadeiro']","[1, 1]",5,2,7,0
6571,"[]","[]","[]","[]",0,0,0,0
6572,"['anuncio']","[1]","['compartilhar', 'espalhar', 'soltura', 'soltura']","[1, 1, 2, 2]",1,4,5,0
6573,"['decisao', 'federativo', 'parcelar']","[1, 1, 1]","[]","[]",3,0,3,0
6574,"[]","[]","['basto', 'enderecar', 'enderecar', 'enderecar', 'ganhar', 'ganhar', 'ganhar', 'preencher']","[1, 3, 3, 3, 3, 3, 3, 1]",0,8,8,0
6575,"['funcao']","[1]","[]","[]",1,0,1,0
6576,"['exministro']","[1]","['compartilhar', 'usuario']","[1, 1]",1,2,3,0
6577,"[]","[]","['compartilhar', 'imagem', 'manipulacao', 'sequer']","[1, 1, 1, 1]",0,4,4,0
6579,"['depoimento', 'desenvolvimento', 'fabricacao', 'instituto', 'instituto', 'instituto', 'parceria']","[1, 1, 1, 3, 3, 3, 1]","['atribuir', 'cbn', 'sequer', 'viralizado']","[1, 1, 1, 1]",7,4,11,0
6580,"['internar', 'internar', 'lesao', 'metropolitano', 'metropolitano', 'regiao', 'regiao', 'saudar']","[2, 2, 1, 2, 2, 2, 2, 1]","['acidentar', 'boatar', 'circular', 'circular', 'imagem', 'imagem', 'verificar']","[1, 1, 2, 2, 2, 2, 1]",8,7,15,0
6581,"['aprovacao', 'aprovacao', 'apurar', 'biliao', 'biliao', 'biliao', 'biliao', 'congresso', 'destinar', 'emendar', 'recurso', 'recurso']","[2, 2, 1, 4, 4, 4, 4, 1, 1, 1, 2, 2]","['compartilhar', 'enganoso', 'postagen', 'postagen']","[1, 1, 2, 2]",12,4,16,0
6583,"['bolsonarista']","[1]","['assassinar', 'assassinar', 'estuprar', 'invadir', 'lazaro', 'lazaro', 'lazaro', 'maldiz']","[2, 2, 1, 1, 3, 3, 3, 1]",1,8,9,0
6584,"['carla', 'zambelli']","[1, 1]","['amplament', 'circular', 'compartilhar', 'compartilhar', 'falsar', 'filmar', 'filmar', 'filmar', 'gravacao', 'imagem', 'usuario']","[1, 1, 2, 2, 1, 3, 3, 3, 1, 1, 1]",2,11,13,0
6585,"['contagioso', 'contagioso', 'correspondent', 'epidemiar', 'epidemiar', 'passageiro', 'quarentenar', 'surtir', 'surtir', 'variacao']","[2, 2, 1, 2, 2, 1, 1, 2, 2, 1]","['circular', 'compartilhar', 'interaco', 'supostament']","[1, 1, 1, 1]",10,4,14,0
6588,"[]","[]","['circular', 'compartilhar', 'fotografia', 'imagem', 'legendar', 'postagen', 'protestar', 'usuario']","[1, 1, 1, 1, 1, 1, 1, 1]",0,8,8,0
6589,"[]","[]","['circular', 'circular', 'falsar', 'fraudar', 'legendar', 'sacar', 'versao']","[2, 2, 1, 1, 1, 1, 1]",0,7,7,0
6592,"['periodo']","[1]","[]","[]",1,0,1,0
6593,"[]","[]","['grupar', 'sobrar']","[1, 1]",0,2,2,0
6594,"[]","[]","[]","[]",0,0,0,0
6595,"['enfatizar', 'enfatizar']","[2, 2]","[]","[]",2,0,2,0
6596,"['henriqu']","[1]","['circular', 'compartilhar', 'legendar', 'visualizacao']","[1, 1, 1, 1]",1,4,5,0
6599,"['domingo', 'rejeitar']","[1, 1]","['expulsar', 'expulsar', 'expulsar']","[3, 3, 3]",2,3,5,0
6601,"['eventualment', 'jorg']","[1, 1]","['circular', 'circular', 'imagem', 'visualizacao']","[2, 2, 1, 1]",2,4,6,0
6602,"['ricardo', 'ricardo']","[2, 2]","['abencoar', 'circular', 'ganhar', 'imagem', 'imagem', 'imagem', 'imagem', 'legendar', 'padrar']","[1, 1, 1, 4, 4, 4, 4, 1, 1]",2,9,11,0
6603,"[]","[]","['soldar']","[1]",0,1,1,0
6606,"[]","[]","['estampar', 'imagem']","[1, 1]",0,2,2,0
6609,"[]","[]","['patrocinador', 'soltar']","[1, 1]",0,2,2,0
6611,"['previsao']","[1]","['atribuir', 'circular', 'parir', 'parir', 'segundar']","[1, 1, 2, 2, 1]",1,5,6,0
6612,"['aprovacao', 'pratico', 'recebido']","[1, 1, 1]","['cristao', 'verdadeiro']","[1, 1]",3,2,5,0
6613,"[]","[]","['barragem', 'barragem', 'barragem', 'rompimento']","[3, 3, 3, 1]",0,4,4,0
6614,"['aglomeracao', 'campino', 'crise', 'feriar', 'propagacao', 'triagem', 'triagem']","[1, 1, 1, 1, 1, 2, 2]","['circular', 'manipulacao', 'sequer']","[1, 1, 1]",7,3,10,0
6616,"[]","[]","['atribuir']","[1]",0,1,1,0
6618,"['conduta', 'magistrado', 'ministrar', 'republico']","[1, 1, 1, 1]","['dorio']","[1]",4,1,5,0
6621,"['piorar', 'piorar']","[2, 2]","['atirar', 'vc', 'vc']","[1, 2, 2]",2,3,5,0
6623,"['especifico', 'necessario']","[1, 1]","['circular', 'falsar']","[1, 1]",2,2,4,0
6625,"['ambientar', 'contribuicao', 'gued', 'insuficient', 'ministrar']","[1, 1, 1, 1, 1]","['vc', 'vc']","[2, 2]",5,2,7,0
6626,"['biliao', 'biliao', 'boletim', 'consolidar', 'economia']","[2, 2, 1, 1, 1]","['replicar']","[1]",5,1,6,0
6627,"['sigla', 'supremo']","[1, 1]","['capturar', 'circular', 'compartilhar', 'compartilhar', 'ilustrar', 'ilustrar', 'imagem', 'imagem', 'intitular', 'versao']","[1, 1, 2, 2, 2, 2, 2, 2, 1, 1]",2,10,12,0
6629,"['afetado', 'especialment']","[1, 1]","[]","[]",2,0,2,0
6630,"['concedido', 'emprestimo', 'fachin', 'lewandowski', 'ministrar']","[1, 1, 1, 1, 1]","['gleisi', 'parir', 'pelar', 'pelar']","[1, 1, 2, 2]",5,4,9,0
6631,"['arrecadacao', 'instituto']","[1, 1]","['captar', 'rouanet']","[1, 1]",2,2,4,0
6633,"['preservar', 'republico']","[1, 1]","['assaltar', 'assaltar', 'fingir']","[2, 2, 1]",2,3,5,0
6637,"['domingo']","[1]","['parir']","[1]",1,1,2,0
6638,"[]","[]","[]","[]",0,0,0,0
6639,"['consequencia']","[1]","['bandeiro', 'bandeiro', 'bandeiro', 'bandeiro', 'bandeiro', 'espalhar', 'indignar', 'versao', 'versao', 'versao', 'versao']","[5, 5, 5, 5, 5, 1, 1, 4, 4, 4, 4]",1,11,12,0
6644,"[]","[]","['enganoso', 'parir', 'parir', 'parir', 'segundar']","[1, 3, 3, 3, 1]",0,5,5,0
6646,"['fundacao']","[1]","['circular', 'circular', 'imagem', 'mencao', 'versao']","[2, 2, 1, 1, 1]",1,5,6,0
6649,"['carat', 'justicar', 'privar', 'salao']","[1, 1, 1, 1]","['invadir', 'invadir', 'torturar']","[2, 2, 1]",4,3,7,0
6650,"['diariament', 'epidemiologico', 'hospitalizar', 'ministrar', 'nelson', 'reportar', 'saudar', 'saudar', 'saudar', 'saudar', 'teich', 'vigilancia']","[1, 1, 1, 1, 1, 1, 4, 4, 4, 4, 1, 1]","['auditoria', 'cartaz', 'circular']","[1, 1, 1]",12,3,15,0
6653,"['desenvolvimento', 'ministrar', 'regiao']","[1, 1, 1]","['amigar']","[1]",3,1,4,0
6654,"['desembarcar', 'espanha']","[1, 1]","['cocaina', 'espalhar']","[1, 1]",2,2,4,0
6656,"[]","[]","['enderecar', 'enderecar']","[2, 2]",0,2,2,0
6657,"['bruno', 'jn', 'renata', 'renata', 'renata']","[1, 1, 3, 3, 3]","['circular', 'gravacao', 'imagem', 'imagem', 'imagem', 'legendar']","[1, 1, 3, 3, 3, 1]",5,6,11,0
6658,"['lancamento']","[1]","['circular', 'expulsar', 'ganhar', 'pelar']","[1, 1, 1, 1]",1,4,5,0
6660,"['ambientar', 'conformar', 'deflagrar']","[1, 1, 1]","['disseminar', 'falsar', 'incendio', 'incendio', 'mencao', 'verdadeiro']","[1, 1, 2, 2, 1, 1]",3,6,9,0
6663,"['exministro', 'ministrar']","[1, 1]","['parir', 'quinzena']","[1, 1]",2,2,4,0
6666,"['republico']","[1]","['menino', 'parir', 'pelar']","[1, 1, 1]",1,3,4,0
6667,"['regiao']","[1]","['assinalar', 'descricao', 'descricao', 'fotografia', 'fotografia', 'legendar', 'sequer']","[1, 2, 2, 2, 2, 1, 1]",1,7,8,0
6669,"['aglomeracao', 'avancar', 'necessario']","[1, 1, 1]","['cadastramento', 'cadastramento', 'clicar', 'compartilhar', 'compartilhar', 'compartilhar', 'inscricao', 'preencher', 'preencher', 'preencher', 'verificacao']","[2, 2, 1, 3, 3, 3, 1, 3, 3, 3, 1]",3,11,14,0
6670,"[]","[]","[]","[]",0,0,0,0
6672,"[]","[]","['filmar']","[1]",0,1,1,0
6674,"['esquema']","[1]","[]","[]",1,0,1,0
6675,"['supremo']","[1]","['camiseta', 'camiseta', 'legendar']","[2, 2, 1]",1,3,4,0
6676,"['pagamento', 'pagamento']","[2, 2]","[]","[]",2,0,2,0
6678,"[]","[]","['compartilhar', 'vc']","[1, 1]",0,2,2,0
6682,"['quarentenar', 'reabertura']","[1, 1]","['torrar', 'torrar', 'torrar', 'torrar']","[4, 4, 4, 4]",2,4,6,0
6684,"['desigualdad', 'distant']","[1, 1]","['desmentir', 'imagem', 'imagem', 'legendar', 'legendar', 'soltar', 'viralizado']","[1, 2, 2, 2, 2, 1, 1]",2,7,9,0
6685,"[]","[]","['parir', 'parir', 'parir']","[3, 3, 3]",0,3,3,0
6686,"['anticorpo', 'testagem']","[1, 1]","['quantum', 'sobrar']","[1, 1]",2,2,4,0
6687,"['fronteiro', 'planar', 'planar', 'prever']","[1, 2, 2, 1]","['amigar', 'manipulacao', 'pego']","[1, 1, 1]",4,3,7,0
6689,"['juro']","[1]","['basto', 'versao', 'versao', 'versao']","[1, 3, 3, 3]",1,4,5,0
6690,"['epidemiar', 'minimizar']","[1, 1]","['espalhar']","[1]",2,1,3,0
6694,"[]","[]","['enganir', 'manipular']","[1, 1]",0,2,2,0
6703,"['anvisa', 'instituto', 'parceria', 'vigilancia']","[1, 1, 1, 1]","['compartilhar', 'compartilhar', 'postagen', 'usuario']","[2, 2, 1, 1]",4,4,8,0
6709,"['afp']","[1]","['boatar', 'checagem', 'circular', 'desmentir', 'imagem', 'imagem', 'imagem', 'legendar', 'protestar']","[1, 1, 1, 1, 3, 3, 3, 1, 1]",1,9,10,0
6713,"[]","[]","['motorista']","[1]",0,1,1,0
6717,"['bandeirant', 'decisao', 'disseminacao', 'palacio', 'rigoroso', 'saudar']","[1, 1, 1, 1, 1, 1]","['circular', 'circular', 'imagem', 'imagem', 'legendar', 'verificar']","[2, 2, 2, 2, 1, 1]",6,6,12,0
6718,"[]","[]","['compartilhar']","[1]",0,1,1,0
6719,"['folhar', 'ricardo', 'sabatino', 'spaulo']","[1, 1, 1, 1]","[]","[]",4,0,4,0
6720,"[]","[]","['gasolina']","[1]",0,1,1,0
6723,"['aglomeracao', 'metropolitano', 'quarentenar', 'regiao', 'turma']","[1, 1, 1, 1, 1]","[]","[]",5,0,5,0
6724,"['feriar']","[1]","['catolico', 'circular', 'compartilhar', 'ganhar', 'imagem', 'legendar', 'postagen', 'postagen', 'usuario', 'viralizada']","[1, 1, 1, 1, 1, 1, 2, 2, 1, 1]",1,10,11,0
6725,"['ambientar', 'ambientar', 'cilindro', 'demandar', 'martim', 'martim', 'martim', 'privar']","[2, 2, 1, 1, 3, 3, 3, 1]","['amigar', 'imagem']","[1, 1]",8,2,10,0
6727,"['afp']","[1]","['checar', 'circular', 'compartilhar', 'imagem', 'postagen', 'verificacao']","[1, 1, 1, 1, 1, 1]",1,6,7,0
6728,"['avancar', 'comparacao', 'infraestrutura', 'iniciativo']","[1, 1, 1, 1]","['ilustrar', 'imagem', 'imagem', 'postagen', 'transposicao']","[1, 2, 2, 1, 1]",4,5,9,0
6729,"[]","[]","[]","[]",0,0,0,0
6730,"['abordagem', 'justicar', 'sorocaba']","[1, 1, 1]","['circular', 'imagem', 'legendar']","[1, 1, 1]",3,3,6,0
6731,"['ministrar', 'ministrar', 'regrar', 'ribeiro', 'suspenso']","[2, 2, 1, 1, 1]","['atribuir', 'circular']","[1, 1]",5,2,7,0
6734,"['dedicar', 'posturar', 'pratico', 'preventivo', 'respostar']","[1, 1, 1, 1, 1]","['adorar', 'escutar', 'pelar', 'secreto']","[1, 1, 1, 1]",5,4,9,0
6735,"['converso', 'dedicar', 'gabinet', 'possibilidad', 'primeiroministro', 'primeiroministro', 'universitario']","[1, 1, 1, 1, 2, 2, 1]","['canadens', 'canadens', 'circular', 'circular', 'versao']","[2, 2, 2, 2, 1]",7,5,12,0
6736,"['adversario', 'aprovacao', 'facilitar', 'implementar', 'plenario', 'prazo', 'proposto', 'reducao', 'reducao']","[1, 1, 1, 1, 1, 1, 1, 2, 2]","['lupa', 'verificar']","[1, 1]",9,2,11,0
6737,"['almeida']","[1]","['incendio']","[1]",1,1,2,0
6739,"['conjuntar', 'domingo']","[1, 1]","['compartilhar', 'filmar', 'imagem', 'inscricao', 'mafia', 'mesario', 'wagner', 'wagner']","[1, 1, 1, 1, 1, 1, 2, 2]",2,8,10,0
6740,"[]","[]","['fraudar']","[1]",0,1,1,0
6741,"['enfrentamento', 'lavagem', 'regrar']","[1, 1, 1]","['circular']","[1]",3,1,4,0
6742,"[]","[]","[]","[]",0,0,0,0
6749,"[]","[]","['circular', 'circular', 'descricao', 'fotografia', 'imagem', 'imagem', 'postagen']","[2, 2, 1, 1, 2, 2, 1]",0,7,7,0
6751,"[]","[]","['questionario']","[1]",0,1,1,0
6752,"['antonio', 'domingo', 'possibilidad', 'republico']","[1, 1, 1, 1]","['boatar', 'compartilhar', 'facada', 'facada', 'facada', 'viralizado']","[1, 1, 3, 3, 3, 1]",4,6,10,0
6753,"['fux', 'fux', 'fux', 'ministrar', 'ministrar', 'ministrar']","[3, 3, 3, 3, 3, 3]","['disfarcar', 'espalhar', 'soltar']","[1, 1, 1]",6,3,9,0
6754,"[]","[]","['imagem', 'parir', 'wagner']","[1, 1, 1]",0,3,3,0
6758,"['domingo', 'liderar']","[1, 1]","['bandeiro', 'bandeiro', 'circular', 'fotografia', 'fotografo', 'imagem', 'imagem', 'imagem', 'legendar', 'protestar', 'protestar', 'reverso']","[2, 2, 1, 1, 1, 3, 3, 3, 1, 2, 2, 1]",2,12,14,0
6759,"['congresso']","[1]","['telejorn']","[1]",1,1,2,0
6760,"[]","[]","[]","[]",0,0,0,0
6762,"['decisao', 'proposto', 'transmissao', 'transmissao']","[1, 1, 2, 2]","[]","[]",4,0,4,0
6764,"[]","[]","['camisa', 'camiseta', 'camiseta']","[1, 2, 2]",0,3,3,0
6765,"['arrecadar', 'salao', 'salao', 'salao']","[1, 3, 3, 3]","[]","[]",4,0,4,0
6768,"['coletivo', 'coletivo', 'liderar']","[2, 2, 1]","[]","[]",3,0,3,0
6769,"['liderar', 'mudanca']","[1, 1]","[]","[]",2,0,2,0
6772,"['destacar']","[1]","['bandeiro', 'bandeiro', 'bandeiro', 'camisa', 'circular', 'compartilhar', 'gravacao', 'gravacao', 'postagen', 'usuario', 'verdadeiro', 'viralizada']","[3, 3, 3, 1, 1, 1, 2, 2, 1, 1, 1, 1]",1,12,13,0
6773,"['destacar']","[1]","['biblia', 'verificar']","[1, 1]",1,2,3,0
6775,"['aglomeracao']","[1]","['sacar', 'sacar', 'sacar', 'safar', 'safar', 'safar']","[3, 3, 3, 3, 3, 3]",1,6,7,0
6786,"['higienizacao', 'saudar']","[1, 1]","['gasolina', 'puro', 'puro', 'soltar']","[1, 2, 2, 1]",2,4,6,0
6788,"['circulacao', 'equipamento', 'especifico', 'infectar', 'mutacao', 'observar', 'saudar']","[1, 1, 1, 1, 1, 1, 1]","['despejar', 'limao', 'limao', 'limao', 'limao', 'suco', 'vitaminar']","[1, 4, 4, 4, 4, 1, 1]",7,7,14,0
6790,"[]","[]","['amplament', 'compartilhar', 'espalhar', 'manchet', 'quinzena']","[1, 1, 1, 1, 1]",0,5,5,0
6791,"[]","[]","['ganhar', 'imagem']","[1, 1]",0,2,2,0
6792,"['guaruja', 'guaruja']","[2, 2]","[]","[]",2,0,2,0
6798,"['goncalo', 'internar', 'varga', 'varga']","[1, 1, 2, 2]","['espalhar', 'menino', 'menino', 'pego', 'perdao', 'realment', 'realment', 'suco']","[1, 2, 2, 1, 1, 2, 2, 1]",4,8,12,0
6799,"[]","[]","[]","[]",0,0,0,0
6800,"['adotada', 'propagacao']","[1, 1]","['compartilhar', 'dorio', 'imagem', 'imagem', 'postagen', 'viralizada']","[1, 1, 2, 2, 1, 1]",2,6,8,0
6803,"['supremo']","[1]","['atribuir', 'compartilhar', 'versao']","[1, 1, 1]",1,3,4,0
6804,"['biliao', 'pagamento', 'pagamento', 'transmissao']","[1, 2, 2, 1]","[]","[]",4,0,4,0
6807,"[]","[]","['atribuir', 'carbono', 'compartilhar', 'compartilhar', 'dioxido', 'postagen', 'usuario']","[1, 1, 2, 2, 1, 1, 1]",0,7,7,0
6810,"['quarentenar']","[1]","['ganhar', 'soltar', 'soltar', 'vc']","[1, 2, 2, 1]",1,4,5,0
6813,"['subir']","[1]","[]","[]",1,0,1,0
6814,"['funcao']","[1]","['adorar']","[1]",1,1,2,0
6815,"['converso', 'integrant']","[1, 1]","['imagem']","[1]",2,1,3,0
6821,"['comissao']","[1]","['soldar']","[1]",1,1,2,0
6825,"['celebrar', 'contemplar', 'iniciativo', 'iniciativo', 'necessario', 'republico', 'sancao', 'sancao', 'volumar']","[1, 1, 2, 2, 1, 1, 2, 2, 1]","['biblia', 'lembres']","[1, 1]",9,2,11,0
6826,"['witzel']","[1]","['estranhar', 'vazio']","[1, 1]",1,2,3,0
6827,"[]","[]","['humanar', 'menino', 'soltura']","[1, 1, 1]",0,3,3,0
6828,"['absoluto', 'colombio', 'levantamento']","[1, 1, 1]","['compartilhar', 'equador', 'usuario']","[1, 1, 1]",3,3,6,0
6829,"['comissao', 'exministro', 'inquerito', 'saudar']","[1, 1, 1, 1]","[]","[]",4,0,4,0
6830,"[]","[]","['atribuir', 'espalhar', 'lixar', 'segundar']","[1, 1, 1, 1]",0,4,4,0
6832,"['arrecadar', 'decisao', 'transmissao', 'transmissao']","[1, 1, 2, 2]","['circular', 'compartilhar', 'imagem', 'postagen']","[1, 1, 1, 1]",4,4,8,0
6835,"['adicionar', 'biliao', 'limitacao', 'limitacao', 'regrar']","[1, 1, 2, 2, 1]","['lixar', 'telegram', 'telegram', 'telegram']","[1, 3, 3, 3]",5,4,9,0
6836,"['resolucao', 'taxar']","[1, 1]","[]","[]",2,0,2,0
6837,"[]","[]","[]","[]",0,0,0,0
6839,"[]","[]","['compartilhar', 'espalhar', 'quinzena']","[1, 1, 1]",0,3,3,0
6840,"['funcao']","[1]","['faccao', 'intitular']","[1, 1]",1,2,3,0
6841,"['assistenci', 'exercicio', 'positivar']","[1, 1, 1]","['abencoar', 'verdadeiro']","[1, 1]",3,2,5,0
6842,"['celebrar']","[1]","['padrar', 'padrar']","[2, 2]",1,2,3,0
6845,"[]","[]","['checar', 'numericament']","[1, 1]",0,2,2,0
6846,"['discussao', 'julgamento', 'julgamento', 'jurista', 'precaucao', 'preventivo', 'proferir', 'reuniao', 'vespera']","[1, 2, 2, 1, 1, 1, 1, 1, 1]","['abusar', 'checar', 'enfim', 'numericament', 'parir', 'pelar']","[1, 1, 1, 1, 1, 1]",9,6,15,0
6847,"['julgamento']","[1]","['checar', 'numericament']","[1, 1]",1,2,3,0
6848,"[]","[]","['checar', 'numericament']","[1, 1]",0,2,2,0
6849,"['rocha']","[1]","['checar', 'estuprar', 'numericament']","[1, 1, 1]",1,3,4,0
6850,"[]","[]","['checar', 'numericament']","[1, 1]",0,2,2,0
6851,"['surto']","[1]","['circular', 'compartilhar', 'imagem', 'postagen', 'viralizada']","[1, 1, 1, 1, 1]",1,5,6,0
6853,"['destinar']","[1]","[]","[]",1,0,1,0
6856,"['prever', 'previsto']","[1, 1]","['compartilhar', 'greve', 'greve', 'greve']","[1, 3, 3, 3]",2,4,6,0
6857,"['bancada', 'ritmar']","[1, 1]","['manchet']","[1]",2,1,3,0
6858,"['liderar', 'motivacao']","[1, 1]","['atribuir', 'boatar', 'carrefour', 'carrefour', 'circular', 'falsar']","[1, 1, 2, 2, 1, 1]",2,6,8,0
6859,"['regrar']","[1]","['biblia', 'espalhar']","[1, 1]",1,2,3,0
6860,"[]","[]","['casamentar', 'parir', 'verdadeiro']","[1, 1, 1]",0,3,3,0
6863,"[]","[]","['realment', 'segundar']","[1, 1]",0,2,2,0
6866,"['previo', 'quadro', 'recordar']","[1, 1, 1]","['compartilhar', 'compartilhar', 'postagen']","[2, 2, 1]",3,3,6,0
6868,"[]","[]","['captar', 'imagem', 'vazio']","[1, 1, 1]",0,3,3,0
6871,"['anteriorment', 'avancar', 'expectativa', 'saudar']","[1, 1, 1, 1]","['parir', 'pelar']","[1, 1]",4,2,6,0
6872,"['autoridad']","[1]","[]","[]",1,0,1,0
6874,"['autoridad', 'possibilidad', 'saudar']","[1, 1, 1]","['circular', 'postagen']","[1, 1]",3,2,5,0
6875,"[]","[]","[]","[]",0,0,0,0
6879,"['circulacao', 'epidemiar', 'impactar', 'significativo']","[1, 1, 1, 1]","[]","[]",4,0,4,0
6880,"['domicilio']","[1]","['circular']","[1]",1,1,2,0
6886,"['ministrar', 'ministrar', 'ministrar', 'ministrar', 'pastar', 'supremo']","[4, 4, 4, 4, 1, 1]","['atribuir', 'circular', 'descricao', 'verificar']","[1, 1, 1, 1]",6,4,10,0
6887,"[]","[]","[]","[]",0,0,0,0
6888,"['articulacao', 'cepa', 'contagioso', 'periodo', 'regiao', 'respiratorio', 'taxar']","[1, 1, 1, 1, 1, 1, 1]","['circular', 'compartilhar', 'espalhar', 'espalhar', 'garganta', 'nasal', 'parir', 'parir', 'pelar', 'vezar']","[1, 1, 2, 2, 1, 1, 2, 2, 1, 1]",7,10,17,0
6889,"['saudar']","[1]","['lixar']","[1]",1,1,2,0
6897,"[]","[]","['circular', 'falsar', 'imagem']","[1, 1, 1]",0,3,3,0
6898,"['quarentenar', 'quarentenar']","[2, 2]","['enfim', 'versao', 'versao']","[1, 2, 2]",2,3,5,0
6900,"[]","[]","['soltar', 'torrar']","[1, 1]",0,2,2,0
6901,"['autoridad', 'crise', 'espanha', 'espanha', 'propagacao', 'provincia', 'saudar', 'saudar', 'testagem']","[1, 1, 2, 2, 1, 1, 2, 2, 1]","['circular']","[1]",9,1,10,0
6902,"['interferencia', 'remessar']","[1, 1]","[]","[]",2,0,2,0
6905,"['circulacao', 'circulacao', 'decorrent', 'distrito', 'distrito', 'distrito', 'distrito', 'prazo', 'prazo', 'preservar', 'republico', 'rocha', 'suspensao']","[2, 2, 1, 4, 4, 4, 4, 2, 2, 1, 1, 1, 1]","[]","[]",13,0,13,0
6906,"[]","[]","[]","[]",0,0,0,0
6907,"['crise']","[1]","['compartilhar', 'inscricao']","[1, 1]",1,2,3,0
6912,"[]","[]","['cristao', 'manobrar', 'manobrar', 'verdadeiro']","[1, 2, 2, 1]",0,4,4,0
6913,"['metropolitano', 'regiao']","[1, 1]","['atribuir', 'barragem', 'barragem', 'circular', 'circular', 'compartilhar', 'imagem', 'postagen', 'rompimento', 'rompimento']","[1, 2, 2, 2, 2, 1, 1, 1, 2, 2]",2,10,12,0
6914,"['metropolitano', 'regiao']","[1, 1]","['barragem', 'circular', 'imagem', 'rompimento']","[1, 1, 1, 1]",2,4,6,0
6915,"['metropolitano', 'possibilidad', 'regiao']","[1, 1, 1]","['barragem', 'circular', 'imagem', 'parir', 'rompimento', 'rompimento']","[1, 1, 1, 1, 2, 2]",3,6,9,0
6916,"['apurar', 'autoridad', 'metropolitano', 'regiao']","[1, 1, 1, 1]","['atribuir', 'barragem', 'barragem', 'imagem', 'pelar', 'rompimento', 'rompimento', 'secreto', 'venezuelano']","[1, 2, 2, 1, 1, 2, 2, 1, 1]",4,9,13,0
6917,"['metropolitano', 'regiao', 'republico']","[1, 1, 1]","['barragem', 'compartilhar', 'compartilhar', 'imagem', 'imagem', 'rompimento']","[1, 2, 2, 2, 2, 1]",3,6,9,0
6920,"['wilson', 'witzel']","[1, 1]","['dorio']","[1]",2,1,3,0
6924,"[]","[]","['espalhar', 'imagem']","[1, 1]",0,2,2,0
6926,"['adversario', 'crise', 'investigacao', 'justicar']","[1, 1, 1, 1]","['camisa']","[1]",4,1,5,0
6928,"['vieira']","[1]","['verdadeiro']","[1]",1,1,2,0
6931,"['congresso', 'decisao', 'escassez', 'estrategia', 'fase', 'necessario', 'quarentenar', 'subir', 'subir']","[1, 1, 1, 1, 1, 1, 1, 2, 2]","['copiar', 'dorio', 'revoltar', 'soldar']","[1, 1, 1, 1]",9,4,13,0
6936,"['lancamento', 'lancamento', 'situacao']","[2, 2, 1]","['segundar']","[1]",3,1,4,0
6937,"[]","[]","['enganir']","[1]",0,1,1,0
6939,"['condicao', 'instituto', 'jorg', 'jorg', 'jorg']","[1, 1, 3, 3, 3]","['parabem', 'parabem', 'realment']","[2, 2, 1]",5,3,8,0
6940,"['antecipar', 'coletivo', 'destinar', 'justicar']","[1, 1, 1, 1]","['circular', 'enderecar', 'gleisi', 'gleisi', 'gleisi', 'gravacao', 'sequer']","[1, 1, 3, 3, 3, 1, 1]",4,7,11,0
6942,"['propagacao']","[1]","[]","[]",1,0,1,0
6943,"['redondo']","[1]","[]","[]",1,0,1,0
6945,"[]","[]","[]","[]",0,0,0,0
6950,"['airlin', 'passageiro']","[1, 1]","['acidentar', 'efarsa', 'realment']","[1, 1, 1]",2,3,5,0
6951,"['wilson', 'witzel']","[1, 1]","[]","[]",2,0,2,0
6954,"[]","[]","['arquivar', 'visualizacao']","[1, 1]",0,2,2,0
6956,"['especifico', 'saudar', 'saudar', 'saudar']","[1, 3, 3, 3]","['atribuir', 'circular', 'compartilhar', 'suco']","[1, 1, 1, 1]",4,4,8,0
6958,"['cooperacao', 'desenvolvimento', 'economia', 'economia', 'gued', 'ministrar']","[1, 1, 2, 2, 1, 1]","['circular', 'compartilhar', 'enganoso', 'enganoso', 'misturar', 'verdadeiro', 'verificacao', 'verificar']","[1, 1, 2, 2, 1, 1, 1, 1]",6,8,14,0
6959,"['californio', 'santiago', 'situacao']","[1, 1, 1]","['circular', 'legendar']","[1, 1]",3,2,5,0
6962,"['azevedo', 'jorg', 'liderar', 'planar', 'quedo']","[1, 1, 1, 1, 1]","['melancia']","[1]",5,1,6,0
6967,"[]","[]","['imagem']","[1]",0,1,1,0
6969,"['adotada']","[1]","['circular', 'legendar', 'protestar', 'protestar', 'protestar']","[1, 1, 3, 3, 3]",1,5,6,0
6970,"['materiaprima', 'viagem']","[1, 1]","['clicar', 'imagem', 'imagem', 'imagem', 'legendar', 'manipular']","[1, 3, 3, 3, 1, 1]",2,6,8,0
6971,"['araujo', 'saudar']","[1, 1]","[]","[]",2,0,2,0
6972,"['saudar']","[1]","['espalhar', 'pelar', 'realment']","[1, 1, 1]",1,3,4,0
6975,"[]","[]","['espalhar', 'parir', 'parir', 'segundar']","[1, 2, 2, 1]",0,4,4,0
6978,"['atrasar', 'definitivo']","[1, 1]","['expulsar', 'tumulo', 'versao']","[1, 1, 1]",2,3,5,0
6979,"['risco', 'saudar', 'saudar', 'taxar']","[1, 2, 2, 1]","['compartilhar', 'enfim', 'sapato']","[1, 1, 1]",4,3,7,0
6980,"['intenso', 'situacao', 'volumar']","[1, 1, 1]","[]","[]",3,0,3,0
6981,"['anticorpo', 'anticorpo', 'anticorpo', 'assintomatico', 'assintomatico', 'habito', 'quarentenar']","[3, 3, 3, 2, 2, 1, 1]","['assinalar', 'circular', 'humanar', 'realment']","[1, 1, 1, 1]",7,4,11,0
6982,"['fluminens', 'mandatario', 'plano', 'plano', 'republico', 'substituto', 'superar', 'superar', 'superar']","[1, 1, 2, 2, 1, 1, 3, 3, 3]","['bonner', 'bonner', 'bonner', 'bonner', 'bonner', 'clicar', 'compartilhar', 'telejorn']","[5, 5, 5, 5, 5, 1, 1, 1]",9,8,17,0
6984,"[]","[]","['ganhar', 'imagem', 'parir', 'segundar']","[1, 1, 1, 1]",0,4,4,0
6985,"['adotada', 'pratico']","[1, 1]","['circular', 'ganhar', 'imagem', 'imagem', 'incendio', 'legendar', 'reverso']","[1, 1, 2, 2, 1, 1, 1]",2,7,9,0
6986,"['presenca', 'regiao', 'regiao']","[1, 2, 2]","[]","[]",3,0,3,0
6987,"[]","[]","[]","[]",0,0,0,0
6988,"['biliao', 'contrato', 'contrato', 'henriqu', 'ministrar', 'ministrar', 'parceria', 'planalto', 'recurso', 'saudar', 'saudar']","[1, 2, 2, 1, 2, 2, 1, 1, 1, 2, 2]","['maldiz']","[1]",11,1,12,0
6989,"['flavio', 'flavio']","[2, 2]","['atribuir', 'bandeiro', 'bandeiro', 'bandeiro', 'bandeiro', 'bandeiro', 'bandeiro', 'bandeiro', 'bandeiro', 'bandeiro', 'circular', 'usuario', 'verdadeiro']","[1, 9, 9, 9, 9, 9, 9, 9, 9, 9, 1, 1, 1]",2,13,15,0
6991,"['pratico']","[1]","['assassinar', 'boicotar', 'carrefour', 'chorar']","[1, 1, 1, 1]",1,4,5,0
6994,"['margem', 'margem', 'regiao']","[2, 2, 1]","['invadir', 'mafia', 'safar']","[1, 1, 1]",3,3,6,0
6995,"['autoridad', 'regiao']","[1, 1]","['catolico', 'circular', 'imagem', 'legendar']","[1, 1, 1, 1]",2,4,6,0
6997,"['gabinet', 'heleno', 'integrant', 'integrant', 'investigacao', 'movimentacao', 'planar', 'planar', 'planar', 'planar', 'preliminar']","[1, 1, 2, 2, 1, 1, 4, 4, 4, 4, 1]","['pelar']","[1]",11,1,12,0
6998,"['avancar', 'fundacao']","[1, 1]","['basto', 'enderecar', 'enderecar', 'inscricao', 'preencher', 'questionario']","[1, 2, 2, 1, 1, 1]",2,6,8,0
6999,"['azevedo', 'converso']","[1, 1]","['falsar', 'imagem', 'parir']","[1, 1, 1]",2,3,5,0
7001,"[]","[]","['checar']","[1]",0,1,1,0
7006,"['afp']","[1]","['acidentar', 'checar', 'circular', 'compartilhar', 'nobel', 'verificacao']","[1, 1, 1, 1, 1, 1]",1,6,7,0
7011,"['absoluto', 'concreto', 'especifico', 'imunizacao', 'infectar', 'presenca', 'transmissao', 'transmissao']","[1, 1, 1, 1, 1, 1, 2, 2]","['circular', 'garganta', 'invadir']","[1, 1, 1]",8,3,11,0
7012,"['conformar', 'imunizacao', 'pagamento', 'saudar', 'saudar', 'saudar']","[1, 1, 1, 3, 3, 3]","['atribuir', 'circular']","[1, 1]",6,2,8,0
7015,"['estimular', 'europeu']","[1, 1]","['dorio']","[1]",2,1,3,0
7017,"['comparacao']","[1]","['circular', 'compartilhar', 'enganoso', 'postagen']","[1, 1, 1, 1]",1,4,5,0
7018,"['crise', 'parcelar', 'parcelar', 'parceria', 'previsto']","[1, 2, 2, 1, 1]","['basto', 'compartilhar', 'sacar']","[1, 1, 1]",5,3,8,0
7020,"['wilson', 'wilson', 'witzel', 'witzel']","[2, 2, 2, 2]","['circular', 'imagem', 'libertador']","[1, 1, 1]",4,3,7,0
7021,"['aurelio', 'aurelio', 'mello', 'ministrar', 'ministrar', 'ministrar', 'ministrar', 'ricardo', 'ricardo', 'supremo', 'viagem']","[2, 2, 1, 4, 4, 4, 4, 2, 2, 1, 1]","['circular', 'circular', 'circular']","[3, 3, 3]",11,3,14,0
7022,"['saudar']","[1]","['caixao', 'caixao']","[2, 2]",1,2,3,0
7024,"['apurar']","[1]","['assaltar', 'atribuir', 'camisa', 'circular', 'circular', 'falsar', 'imagem']","[1, 1, 1, 2, 2, 1, 1]",1,7,8,0
7028,"['infectar', 'pratico']","[1, 1]","['checagem', 'compartilhar']","[1, 1]",2,2,4,0
7031,"['consumidor']","[1]","['cartaz', 'circular', 'clicar', 'ganhar', 'imagem', 'logotipo', 'verificar']","[1, 1, 1, 1, 1, 1, 1]",1,7,8,0
7033,"['batalhar', 'comprometido', 'congresso', 'constituicao', 'parceiro', 'parceiro', 'saudar']","[1, 1, 1, 1, 2, 2, 1]","['abencoar', 'enfim', 'parir', 'pelar', 'sobrar', 'sobrar', 'sobrar', 'vitaminar', 'zincar']","[1, 1, 1, 1, 3, 3, 3, 1, 1]",7,9,16,0
7035,"[]","[]","['arquivar', 'arquivar']","[2, 2]",0,2,2,0
7036,"['pastar', 'pastar']","[2, 2]","['assaltar', 'assaltar', 'espalhar', 'espalhar']","[2, 2, 2, 2]",2,4,6,0
7039,"['comprometido', 'republico', 'republico', 'sessao']","[1, 2, 2, 1]","['camisa', 'compartilhar', 'espalhar', 'fraudar', 'fraudar', 'manipulacao', 'manipular', 'mesario']","[1, 1, 1, 2, 2, 1, 1, 1]",4,8,12,0
7041,"['destinar']","[1]","['vc', 'vc']","[2, 2]",1,2,3,0
7042,"['discussao']","[1]","[]","[]",1,0,1,0
7047,"['processo']","[1]","['verificar']","[1]",1,1,2,0
7048,"[]","[]","[]","[]",0,0,0,0
7050,"['externo']","[1]","['circular', 'imagem', 'imagem', 'imagem', 'imagem', 'imagem', 'imagem', 'legendar', 'soldar', 'transposicao']","[1, 6, 6, 6, 6, 6, 6, 1, 1, 1]",1,10,11,0
7052,"['situacao']","[1]","[]","[]",1,0,1,0
7053,"['periodo']","[1]","[]","[]",1,0,1,0
7055,"['regiao']","[1]","['lazaro', 'lazaro', 'segundar', 'segundar', 'segundar', 'versao', 'versao']","[2, 2, 3, 3, 3, 2, 2]",1,7,8,0
7056,"['congresso', 'converso', 'economia', 'economia', 'economia', 'gued', 'gued', 'ministrar', 'ministrar', 'ministrar', 'ministrar', 'suspenso']","[1, 1, 3, 3, 3, 2, 2, 4, 4, 4, 4, 1]","['amplament', 'atribuir', 'capturar', 'checagem', 'checagem', 'circular', 'compartilhar', 'desmentir', 'enganoso', 'imagem', 'usuario', 'viralizado']","[1, 1, 1, 2, 2, 1, 1, 1, 1, 1, 1, 1]",12,12,24,0
7063,"[]","[]","['parabem']","[1]",0,1,1,0
7064,"['fase', 'piorar']","[1, 1]","['safar']","[1]",2,1,3,0
7065,"['autoridad', 'proliferacao', 'rocha', 'rocha', 'saudar', 'taxar', 'transmissao']","[1, 1, 2, 2, 1, 1, 1]","['carbono', 'dioxido', 'imagem', 'usuario', 'verdadeiro', 'visualizacao']","[1, 1, 1, 1, 1, 1]",7,6,13,0
7067,"[]","[]","['lembres']","[1]",0,1,1,0
7068,"['amplo', 'autoridad', 'autorizacao', 'autorizacao', 'conformar', 'conjuntar', 'curvo', 'mantido', 'temporariament']","[1, 1, 2, 2, 1, 1, 1, 1, 1]","['capturar', 'chorar', 'escravo', 'escravo', 'fraudar', 'humanar', 'invadir', 'invadir', 'menino', 'menino', 'parir', 'parir', 'parir', 'parir', 'parir', 'parir', 'parir', 'parir', 'pelar', 'pelar', 'sobrar', 'supostament', 'trafico', 'trafico', 'trafico']","[1, 1, 2, 2, 1, 1, 2, 2, 2, 2, 8, 8, 8, 8, 8, 8, 8, 8, 2, 2, 1, 1, 3, 3, 3]",9,25,34,0
7069,"['campino']","[1]","['sequer']","[1]",1,1,2,0
7070,"[]","[]","['arquivar', 'usuario']","[1, 1]",0,2,2,0
7071,"[]","[]","[]","[]",0,0,0,0
7081,"[]","[]","[]","[]",0,0,0,0
7082,"[]","[]","['adelio', 'bispar', 'facada', 'wylli']","[1, 1, 1, 1]",0,4,4,0
7085,"['adesao', 'desenvolvimento', 'logistico']","[1, 1, 1]","[]","[]",3,0,3,0
7089,"['saudar']","[1]","['greve', 'greve', 'greve']","[3, 3, 3]",1,3,4,0
7090,"[]","[]","['circular']","[1]",0,1,1,0
7091,"[]","[]","['espalhar', 'estranhar']","[1, 1]",0,2,2,0
7093,"['anvisa', 'necessario', 'vigilancia', 'vigilancia']","[1, 1, 2, 2]","['circular', 'versao']","[1, 1]",4,2,6,0
7094,"['etapa', 'passageiro', 'sabado']","[1, 1, 1]","[]","[]",3,0,3,0
7095,"[]","[]","[]","[]",0,0,0,0
7096,"[]","[]","['circular', 'compartilhar', 'desmentir', 'efarsa', 'falsar', 'pelar', 'sequer']","[1, 1, 1, 1, 1, 1, 1]",0,7,7,0
7098,"[]","[]","['invadir', 'invadir', 'sacar', 'sacar']","[2, 2, 2, 2]",0,4,4,0
7099,"['justicar', 'preventivo', 'varar']","[1, 1, 1]","['circular', 'espancar', 'espancar', 'imagem', 'soltar']","[1, 2, 2, 1, 1]",3,5,8,0
7106,"[]","[]","['compartilhar', 'manipulacao', 'versao']","[1, 1, 1]",0,3,3,0
7109,"[]","[]","[]","[]",0,0,0,0
7110,"['boletim', 'diariament', 'hipertensa']","[1, 1, 1]","['amigar', 'amigar', 'garganta', 'parir', 'parir', 'parir', 'parir', 'parir', 'parir', 'vezar']","[2, 2, 1, 6, 6, 6, 6, 6, 6, 1]",3,10,13,0
7111,"['varar']","[1]","['agredir', 'agredir', 'circular', 'fotografo', 'imagem', 'imagem', 'imagem', 'legendar']","[2, 2, 1, 1, 3, 3, 3, 1]",1,8,9,0
7113,"['internar']","[1]","['ganhar']","[1]",1,1,2,0
7114,"['diariament', 'ministrar', 'saudar', 'saudar', 'vespera']","[1, 1, 2, 2, 1]","['circular', 'imagem', 'imagem', 'legendar', 'lixar']","[1, 2, 2, 1, 1]",5,5,10,0
7115,"['autonomia', 'curso', 'implementar', 'planar', 'prever', 'privar', 'privatizacao', 'reuniao']","[1, 1, 1, 1, 1, 1, 1, 1]","[]","[]",8,0,8,0
7116,"['painel']","[1]","['arquivar']","[1]",1,1,2,0
7117,"['autoridad', 'reforcar', 'respostar']","[1, 1, 1]","['circular']","[1]",3,1,4,0
7118,"['circulacao', 'decisao']","[1, 1]","['amigar', 'atribuir', 'boatar', 'cartaz', 'circular', 'circular', 'desmentir', 'sortir']","[1, 1, 1, 1, 2, 2, 1, 1]",2,8,10,0
7119,"[]","[]","['espalhar', 'imagem']","[1, 1]",0,2,2,0
7122,"['autoridad', 'exportacao', 'planar']","[1, 1, 1]","['cocaina', 'cocaina', 'indignar', 'trafico', 'trafico', 'venezuelano']","[2, 2, 1, 2, 2, 1]",3,6,9,0
7126,"['crise', 'quarentenar']","[1, 1]","['circular', 'imagem', 'imagem', 'verificar']","[1, 2, 2, 1]",2,4,6,0
7128,"['alteracao', 'fundacao', 'infeccioso']","[1, 1, 1]","['estranhar', 'instrucao']","[1, 1]",3,2,5,0
7132,"['condicao', 'consequencia', 'constituicao', 'economia', 'exercicio', 'sindicato', 'sindicato']","[1, 1, 1, 1, 1, 2, 2]","['compartilhar']","[1]",7,1,8,0
7134,"['ampliacao', 'instituto', 'saudar']","[1, 1, 1]","['imagem']","[1]",3,1,4,0
7139,"[]","[]","['circular', 'clicar']","[1, 1]",0,2,2,0
7140,"['associacao', 'pratico', 'resolucao']","[1, 1, 1]","['circular']","[1]",3,1,4,0
7141,"['reabertura', 'respirador', 'subir']","[1, 1, 1]","['imagem', 'torrar', 'torrar']","[1, 2, 2]",3,3,6,0
7143,"[]","[]","['compartilhar', 'compartilhar']","[2, 2]",0,2,2,0
7145,"[]","[]","[]","[]",0,0,0,0
7146,"['araujo', 'araujo', 'araujo', 'assintomatico', 'necessario', 'randolf']","[3, 3, 3, 1, 1, 1]","['parir']","[1]",6,1,7,0
7148,"[]","[]","['ganhar', 'versao', 'versao']","[1, 2, 2]",0,3,3,0
7149,"['coletivo', 'coletivo', 'respectivament']","[2, 2, 1]","[]","[]",3,0,3,0
7152,"['comissao', 'descumprimento', 'federar', 'plenario', 'proposto', 'provisorio', 'provisorio', 'saudar', 'servidor', 'suspenso', 'temporario']","[1, 1, 1, 1, 1, 2, 2, 1, 1, 1, 1]","['circular', 'imagem', 'mencao']","[1, 1, 1]",11,3,14,0
7154,"['independentement']","[1]","['circular', 'enderecar']","[1, 1]",1,2,3,0
7159,"['enxergar', 'marilia', 'marilia', 'mendonca', 'mendonca']","[1, 2, 2, 2, 2]","['chorar', 'menino', 'menino']","[1, 2, 2]",5,3,8,0
7160,"['regiao', 'regiao']","[2, 2]","['enderecar', 'vezar']","[1, 1]",2,2,4,0
7163,"['crise', 'esquema', 'fronteiro', 'roraima', 'roraima', 'roraima']","[1, 1, 1, 3, 3, 3]","['circular']","[1]",6,1,7,0
7164,"[]","[]","['bonner']","[1]",0,1,1,0
7166,"['comunitario', 'respiratorio']","[1, 1]","['acidentar', 'acidentar', 'amigar']","[2, 2, 1]",2,3,5,0
7167,"['afp', 'condicao', 'privar']","[1, 1, 1]","['atribuir', 'circular', 'imagem', 'nobel', 'viralizada']","[1, 1, 1, 1, 1]",3,5,8,0
7169,"['apurar', 'argumentar']","[1, 1]","['circular', 'fraudar']","[1, 1]",2,2,4,0
7170,"['tornear']","[1]","['circular', 'imagem', 'imagem', 'legendar', 'viralizado']","[1, 2, 2, 1, 1]",1,5,6,0
7171,"['consecutivo', 'margem']","[1, 1]","['estranhar', 'fraudar', 'lixar', 'manipulacao']","[1, 1, 1, 1]",2,4,6,0
7172,"['respiratorio']","[1]","['compartilhar', 'imagem', 'maldiz', 'postagen', 'postagen']","[1, 1, 1, 2, 2]",1,5,6,0
7173,"[]","[]","['catedr', 'circular', 'imagem', 'incendio', 'parir', 'quinzena', 'supostament']","[1, 1, 1, 1, 1, 1, 1]",0,7,7,0
7180,"['cerimonia']","[1]","['bandeiro', 'bandeiro', 'bandeiro', 'circular', 'compartilhar', 'imagem', 'imagem', 'sequer', 'usuario', 'viralizada']","[3, 3, 3, 1, 1, 2, 2, 1, 1, 1]",1,10,11,0
7181,"['autoridad', 'equipamento', 'regiao']","[1, 1, 1]","['desmaiar', 'postagen']","[1, 1]",3,2,5,0
7182,"['destacar', 'pagamento']","[1, 1]","[]","[]",2,0,2,0
7184,"['aglomeracao', 'quarentenar', 'quarentenar']","[1, 2, 2]","['circular', 'compartilhar', 'imagem', 'postagen', 'soltar', 'soltar', 'soltar', 'viralizado']","[1, 1, 1, 1, 3, 3, 3, 1]",3,8,11,0
7185,"['alcolumbr', 'esquema', 'exonerar', 'irregularidad', 'julgamento', 'ministrar', 'palacio', 'subordinar']","[1, 1, 1, 1, 1, 1, 1, 1]","['dorio', 'dorio', 'facada', 'mentiroso', 'safar']","[2, 2, 1, 1, 1]",8,5,13,0
7186,"[]","[]","['adelio', 'adelio', 'bispar', 'bispar', 'boatar', 'circular', 'imagem', 'legendar']","[2, 2, 2, 2, 1, 1, 1, 1]",0,8,8,0
7187,"[]","[]","[]","[]",0,0,0,0
7189,"['administrativo']","[1]","['clicar']","[1]",1,1,2,0
7190,"[]","[]","['circular', 'desmaiar', 'espalhar', 'imagem', 'visualizacao']","[1, 1, 1, 1, 1]",0,5,5,0
7191,"['anticorpo', 'rejeitar']","[1, 1]","[]","[]",2,0,2,0
7195,"[]","[]","['parir', 'parir']","[2, 2]",0,2,2,0
7197,"['abordagem', 'desenvolvido', 'treinar', 'treinar']","[1, 1, 2, 2]","['filmar', 'invadir', 'versao', 'versao', 'versao', 'versao']","[1, 1, 4, 4, 4, 4]",4,6,10,0
7198,"[]","[]","[]","[]",0,0,0,0
7200,"[]","[]","['espalhar']","[1]",0,1,1,0
7201,"['aprovacao']","[1]","['bandeiro', 'basto', 'botao', 'clicar', 'compartilhar', 'compartilhar', 'enderecar', 'preencher', 'verdadeiro']","[1, 1, 1, 1, 2, 2, 1, 1, 1]",1,9,10,0
7203,"['respostar', 'respostar']","[2, 2]","['clicar', 'clicar', 'compartilhar', 'compartilhar', 'ganhar', 'ganhar', 'instrucao', 'instrucao', 'macho', 'minutar', 'parabem', 'parabem', 'parabem', 'reivindicar', 'reivindicar', 'selecionar', 'sortir', 'usuario', 'usuario']","[2, 2, 2, 2, 2, 2, 2, 2, 1, 1, 3, 3, 3, 2, 2, 1, 1, 2, 2]",2,19,21,0
7205,"['extraordinario', 'extraordinario', 'importancia', 'importancia']","[2, 2, 2, 2]","['fraudar', 'legendar']","[1, 1]",4,2,6,0
7207,"['autoridad', 'espanha', 'saudar', 'superar']","[1, 1, 1, 1]","['gravacao']","[1]",4,1,5,0
7208,"['equivalent', 'impactar']","[1, 1]","[]","[]",2,0,2,0
7216,"[]","[]","['biblia', 'quantum']","[1, 1]",0,2,2,0
7219,"['desvio', 'justicar', 'ministrar', 'ministrar', 'ministrar', 'nelson', 'possibilidad', 'respirador', 'teich', 'teich', 'teich', 'teich', 'witzel']","[1, 1, 3, 3, 3, 1, 1, 1, 4, 4, 4, 4, 1]","['mafia', 'trafico']","[1, 1]",13,2,15,0
7220,"['saudar']","[1]","['verdadeiro', 'versao', 'versao']","[1, 2, 2]",1,3,4,0
7221,"['confederacao', 'especifico', 'surtir', 'surtir', 'surtir']","[1, 1, 3, 3, 3]","['circular', 'circular', 'circular', 'desmentir', 'desmentir', 'viralizado']","[3, 3, 3, 2, 2, 1]",5,6,11,0
7223,"[]","[]","['amplament', 'bandeiro', 'circular', 'compartilhar', 'imagem', 'postagen', 'protestar', 'usuario']","[1, 1, 1, 1, 1, 1, 1, 1]",0,8,8,0
7224,"['congresso', 'congresso', 'conjunto', 'legislativo', 'prazo', 'prazo', 'regrar', 'regrar', 'sessao', 'vetar', 'vetar', 'vetar', 'vetar', 'vetar', 'vetar', 'vetar']","[2, 2, 1, 1, 2, 2, 2, 2, 1, 7, 7, 7, 7, 7, 7, 7]","['verificar']","[1]",16,1,17,0
7226,"['ausencia', 'dialogo', 'justificativo', 'necessidad', 'transferir']","[1, 1, 1, 1, 1]","['menino', 'menino', 'menino', 'menino', 'padrar']","[4, 4, 4, 4, 1]",5,5,10,0
7228,"['distrito', 'situacao', 'suspeito']","[1, 1, 1]","['compartilhar', 'gravacao', 'gravacao', 'usuario', 'verificacao']","[1, 2, 2, 1, 1]",3,5,8,0
7231,"['alergia', 'cepa', 'prever']","[1, 1, 1]","['atribuir', 'imagem']","[1, 1]",3,2,5,0
7233,"['contemplar']","[1]","[]","[]",1,0,1,0
7236,"['mendonca']","[1]","['curioso', 'fraudar', 'fraudar', 'ganhar', 'ganhar', 'ganhar', 'ganhar', 'sortear', 'sortear', 'sortear', 'sortear']","[1, 2, 2, 4, 4, 4, 4, 4, 4, 4, 4]",1,11,12,0
7237,"['higienizacao', 'implementar', 'intenso', 'normalment', 'propagacao']","[1, 1, 1, 1, 1]","['circular', 'imagem', 'legendar']","[1, 1, 1]",5,3,8,0
7239,"['alteracao', 'alteracao', 'aprovacao', 'despesa', 'equivalent', 'mudanca', 'planar', 'privar', 'saudar']","[2, 2, 1, 1, 1, 1, 1, 1, 1]","['indignacao']","[1]",9,1,10,0
7240,"['republico']","[1]","['circular']","[1]",1,1,2,0
7244,"[]","[]","['compartilhar', 'fraudar', 'minutar', 'minutar', 'parir', 'parir', 'pelar', 'segundar', 'sobrar']","[1, 1, 2, 2, 2, 2, 1, 1, 1]",0,9,9,0
7245,"['aliquota', 'crise', 'desenvolvimento', 'disseminacao', 'emprestimo', 'facilitar', 'importacao', 'reducao', 'risco']","[1, 1, 1, 1, 1, 1, 1, 1, 1]","['boatar', 'circular', 'compartilhar']","[1, 1, 1]",9,3,12,0
7251,"['ambientar', 'compromisso', 'europeu']","[1, 1, 1]","['checar', 'socialismo', 'socialismo']","[1, 2, 2]",3,3,6,0
7252,"[]","[]","['checagem', 'circular', 'imagem', 'imagem', 'inscricao', 'legendar', 'reverso', 'tumulo', 'tumulo']","[1, 1, 2, 2, 1, 1, 1, 2, 2]",0,9,9,0
7256,"['surtir']","[1]","['arvor', 'arvor', 'sobrar']","[2, 2, 1]",1,3,4,0
7257,"[]","[]","['facada']","[1]",0,1,1,0
7258,"[]","[]","[]","[]",0,0,0,0
7261,"[]","[]","[]","[]",0,0,0,0
7264,"[]","[]","['enderecar', 'usuario']","[1, 1]",0,2,2,0
7265,"['impactar', 'impactar']","[2, 2]","['circular', 'circular', 'imagem', 'imagem', 'imagem', 'imagem', 'manipular']","[2, 2, 4, 4, 4, 4, 1]",2,7,9,0
7266,"['cenario', 'enfatizar', 'prever']","[1, 1, 1]","[]","[]",3,0,3,0
7267,"['piorar', 'possibilidad', 'reuniao', 'reuniao']","[1, 1, 2, 2]","['circular', 'circular', 'legendar', 'manchet']","[2, 2, 1, 1]",4,4,8,0
7268,"['adversario', 'folhar', 'instituto', 'parceria', 'sabatino', 'transmissao']","[1, 1, 1, 1, 1, 1]","['checar', 'lupa']","[1, 1]",6,2,8,0
7271,"['augusto', 'augusto', 'concedido', 'depoimento', 'globonew', 'globonew', 'integrant', 'integrant', 'justicar', 'oliveira', 'oliveira', 'oliveira', 'universitario']","[2, 2, 1, 1, 2, 2, 2, 2, 1, 3, 3, 3, 1]","['catolico', 'circular', 'libertador', 'misturar']","[1, 1, 1, 1]",13,4,17,0
7272,"[]","[]","['imagem', 'imagem', 'versao']","[2, 2, 1]",0,3,3,0
7274,"['rocha']","[1]","['checar', 'numericament']","[1, 1]",1,2,3,0
7275,"['equipamento']","[1]","['checar', 'numericament', 'parir']","[1, 1, 1]",1,3,4,0
7276,"['jorg', 'republico']","[1, 1]","['checar', 'numericament', 'parir', 'parir', 'parir']","[1, 1, 3, 3, 3]",2,5,7,0
7277,"[]","[]","['checar', 'numericament']","[1, 1]",0,2,2,0
7278,"['guarulho', 'guarulho', 'saudar']","[2, 2, 1]","['circular']","[1]",3,1,4,0
7279,"['inicialment']","[1]","['espalhar']","[1]",1,1,2,0
7281,"['conformar', 'dosar', 'recebido', 'saudar']","[1, 1, 1, 1]","['atribuir', 'circular']","[1, 1]",4,2,6,0
7284,"[]","[]","[]","[]",0,0,0,0
7285,"[]","[]","['chorar', 'filmar', 'macho', 'menino', 'parir', 'parir', 'parir']","[1, 1, 1, 1, 3, 3, 3]",0,7,7,0
7286,"['autoridad', 'avancar', 'calheiro', 'calheiro', 'emendar', 'esquema', 'mdbal', 'proposto', 'randolf', 'randolf', 'respectivament']","[1, 1, 2, 2, 1, 1, 1, 1, 2, 2, 1]","['parir', 'pelar', 'sobrar']","[1, 1, 1]",11,3,14,0
7288,"[]","[]","['espalhar']","[1]",0,1,1,0
7289,"[]","[]","['imagem', 'sobrar']","[1, 1]",0,2,2,0
7291,"['associacao', 'celebrar', 'decisao', 'entendimento', 'justicar', 'justicar', 'preservacao', 'prever', 'provisorio', 'suspenso']","[1, 1, 1, 1, 2, 2, 1, 1, 1, 1]","['carbono', 'carbono', 'compartilhar', 'falsar']","[2, 2, 1, 1]",10,4,14,0
7294,"['hospitalizacao', 'preliminar', 'revisar']","[1, 1, 1]","['parir']","[1]",3,1,4,0
7296,"['queiroz']","[1]","['parir', 'parir']","[2, 2]",1,2,3,0
7297,"['expressar', 'reuniao']","[1, 1]","['cristao', 'humanar', 'menino', 'menino', 'verdadeiro']","[1, 1, 2, 2, 1]",2,5,7,0
7298,"['regiao', 'regiao']","[2, 2]","['nordestino']","[1]",2,1,3,0
7302,"['respostar', 'respostar']","[2, 2]","['clicar', 'compartilhar', 'compartilhar', 'questionario', 'sacar', 'sacar', 'sacar', 'verificar', 'verificar', 'verificar']","[1, 2, 2, 1, 3, 3, 3, 3, 3, 3]",2,10,12,0
7307,"['alunar', 'apurar', 'inquerito', 'inquerito', 'saudar', 'saudar', 'testagem', 'testagem', 'vigilancia']","[1, 1, 2, 2, 2, 2, 2, 2, 1]","['boatar', 'circular', 'circular', 'imagem', 'imagem']","[1, 2, 2, 2, 2]",9,5,14,0
7308,"['campino']","[1]","['quantum']","[1]",1,1,2,0
7310,"['projecao']","[1]","['bandeiro', 'bandeiro', 'circular', 'imagem', 'imagem', 'legendar', 'verdadeiro']","[2, 2, 1, 2, 2, 1, 1]",1,7,8,0
7311,"['consolidar', 'contabilizar', 'estatistico', 'pastar', 'positivar', 'pslrj', 'quedo', 'saudar', 'silveiro']","[1, 1, 1, 1, 1, 1, 1, 1, 1]","['enganir', 'versao']","[1, 1]",9,2,11,0
7314,"[]","[]","['cartaz', 'circular', 'falsar', 'imagem', 'imagem', 'inscricao']","[1, 1, 1, 2, 2, 1]",0,6,6,0
7316,"['administrativo', 'enfermagem', 'logistico', 'plano', 'saudar']","[1, 1, 1, 1, 1]","['amigar']","[1]",5,1,6,0
7317,"[]","[]","['casamentar', 'menino']","[1, 1]",0,2,2,0
7319,"['requerimento']","[1]","['clicar', 'compartilhar', 'ganhar', 'instrucao', 'minutar', 'questionario']","[1, 1, 1, 1, 1, 1]",1,6,7,0
7320,"[]","[]","['misericordia']","[1]",0,1,1,0
7323,"['bbc', 'coreia', 'coreia', 'coreia', 'supremo', 'supremo']","[1, 3, 3, 3, 2, 2]","['cristao']","[1]",6,1,7,0
7327,"[]","[]","['espalhar', 'sobrar', 'torturar']","[1, 1, 1]",0,3,3,0
7328,"['autorizacao', 'coordenar', 'justificativo', 'legislativo', 'legislativo', 'legislativo', 'legislativo', 'prever']","[1, 1, 1, 4, 4, 4, 4, 1]","[]","[]",8,0,8,0
7331,"['cerimoni', 'flavio']","[1, 1]","['ganhar', 'indignar', 'verdadeiro']","[1, 1, 1]",2,3,5,0
7332,"[]","[]","['checar']","[1]",0,1,1,0
7333,"[]","[]","['checar']","[1]",0,1,1,0
7334,"['margem']","[1]","['checar', 'parir']","[1, 1]",1,2,3,0
7335,"[]","[]","['checar']","[1]",0,1,1,0
7336,"[]","[]","['checar']","[1]",0,1,1,0
7338,"['constituicao', 'necessario', 'planar', 'previsao']","[1, 1, 1, 1]","['adelio', 'bispar', 'compartilhar', 'fraudar', 'fraudar', 'menino', 'parir', 'parir', 'parir', 'parir', 'parir', 'parir', 'soltar']","[1, 1, 1, 2, 2, 1, 6, 6, 6, 6, 6, 6, 1]",4,13,17,0
7340,"['entregu', 'regrar', 'respostar']","[1, 1, 1]","['enderecar', 'ganhar', 'ganhar', 'parabem', 'parabem', 'parabem', 'questionario', 'selecionar', 'sobrar', 'sortir', 'sortir']","[1, 2, 2, 3, 3, 3, 1, 1, 1, 2, 2]",3,11,14,0
7342,"['adversario']","[1]","[]","[]",1,0,1,0
7343,"[]","[]","['imagem']","[1]",0,1,1,0
7344,"['habito', 'risco']","[1, 1]","['circular']","[1]",2,1,3,0
7348,"[]","[]","[]","[]",0,0,0,0
7349,"['biliao', 'dosar', 'gued', 'ministrar', 'ministrar', 'saudar']","[1, 1, 1, 2, 2, 1]","['torrar']","[1]",6,1,7,0
7350,"['internar', 'internar', 'internar', 'suspeito']","[3, 3, 3, 1]","[]","[]",4,0,4,0
7353,"['decisao', 'interpretar', 'plantao', 'subir', 'subir']","[1, 1, 1, 2, 2]","['caixao', 'sacar', 'vagabundar']","[1, 1, 1]",5,3,8,0
7354,"['desmatamento', 'situacao']","[1, 1]","['curioso', 'humanar', 'lixar', 'parir', 'parir', 'vc', 'vc']","[1, 1, 1, 2, 2, 2, 2]",2,7,9,0
7356,"['internar', 'internar', 'transferir']","[2, 2, 1]","[]","[]",3,0,3,0
7357,"['realizacao', 'recurso']","[1, 1]","['filmar', 'postagen']","[1, 1]",2,2,4,0
7359,"['bbc', 'desenvolvido', 'dosar', 'reuter', 'saudar', 'sigla', 'vespera']","[1, 1, 1, 1, 1, 1, 1]","['postagen']","[1]",7,1,8,0
7362,"['fase', 'impactar', 'levantamento']","[1, 1, 1]","['compartilhar', 'enganoso', 'parir', 'pelar', 'sobrar']","[1, 1, 1, 1, 1]",3,5,8,0
7363,"['decorrent', 'impulsionar', 'saudar']","[1, 1, 1]","['circular', 'falsar']","[1, 1]",3,2,5,0
7366,"['internar']","[1]","[]","[]",1,0,1,0
7367,"['enfrentamento']","[1]","['circular', 'circular', 'imagem', 'imagem', 'legendar', 'postagen', 'viralizada']","[2, 2, 2, 2, 1, 1, 1]",1,7,8,0
7369,"['surto']","[1]","['circular', 'compartilhar', 'disseminar', 'legendar', 'postagen']","[1, 1, 1, 1, 1]",1,5,6,0
7371,"['colleg', 'consequencia']","[1, 1]","['boatar', 'circular', 'compartilhar']","[1, 1, 1]",2,3,5,0
7374,"['ambientar', 'consecutivo', 'diplomata', 'estagio', 'instituto', 'instituto', 'instituto', 'instituto', 'plano', 'processo', 'relativo', 'turma']","[1, 1, 1, 1, 4, 4, 4, 4, 1, 1, 1, 1]","['disfarcar', 'mafia', 'mafia']","[1, 2, 2]",12,3,15,0
7376,"['cupula']","[1]","['desgracar']","[1]",1,1,2,0
7377,"[]","[]","['vezar']","[1]",0,1,1,0
7378,"['congresso', 'demrj', 'plenario', 'rejeitar']","[1, 1, 1, 1]","['atribuir', 'imagem']","[1, 1]",4,2,6,0
7381,"['metropolitano', 'regiao']","[1, 1]","['circular', 'gravacao', 'imagem', 'incendio', 'invadir', 'legendar']","[1, 1, 1, 1, 1, 1]",2,6,8,0
7383,"['toquio']","[1]","['compartilhar']","[1]",1,1,2,0
7385,"[]","[]","['copiar', 'parir', 'parir', 'pelar', 'postagen']","[1, 2, 2, 1, 1]",0,5,5,0
7398,"['biliao', 'esquema', 'funcionamento']","[1, 1, 1]","['circular', 'compartilhar', 'enganar', 'fraudar', 'fraudar']","[1, 1, 1, 2, 2]",3,5,8,0
7399,"['anvisa', 'extensao', 'prazo', 'prever', 'prorrogacao', 'vigilancia']","[1, 1, 1, 1, 1, 1]","['enganir', 'parir', 'pelar', 'segundar']","[1, 1, 1, 1]",6,4,10,0
7400,"['velocidad']","[1]","[]","[]",1,0,1,0
7402,"['henriqu']","[1]","['circular', 'efarsa']","[1, 1]",1,2,3,0
7404,"['vulneravel']","[1]","['checar', 'compartilhar', 'espalhar', 'humanar', 'nasal', 'nasal', 'parir']","[1, 1, 1, 1, 2, 2, 1]",1,7,8,0
7405,"['palacio', 'planalto']","[1, 1]","['compartilhar', 'compartilhar', 'espalhar', 'imagem', 'indignacao', 'legendar', 'menino', 'postagen', 'usuario']","[2, 2, 1, 1, 1, 1, 1, 1, 1]",2,9,11,0
7409,"[]","[]","['versao', 'versao', 'versao', 'versao']","[4, 4, 4, 4]",0,4,4,0
7410,"['companhia', 'destinar', 'destinar']","[1, 2, 2]","['circular']","[1]",3,1,4,0
7411,"[]","[]","['parir', 'segundar', 'tampouco']","[1, 1, 1]",0,3,3,0
7412,"['alerj', 'correspondent', 'justificativo', 'legislativo', 'respostar', 'taxar', 'taxar', 'taxar', 'taxar']","[1, 1, 1, 1, 1, 4, 4, 4, 4]","['circular', 'compartilhar']","[1, 1]",9,2,11,0
7413,"['anvisa', 'anvisa', 'decisao', 'decisao', 'domingo', 'saudar']","[2, 2, 2, 2, 1, 1]","['quantum']","[1]",6,1,7,0
7414,"['exministro']","[1]","[]","[]",1,0,1,0
7416,"[]","[]","['acidentar', 'capturar', 'compartilhar', 'postagen', 'supostament']","[1, 1, 1, 1, 1]",0,5,5,0
7419,"['etapa', 'etapa', 'etapa']","[3, 3, 3]","['clicar', 'compartilhar', 'compartilhar', 'galaxi', 'ganhar', 'instrucao', 'instrucao', 'lembres', 'parabem', 'reivindicar', 'reivindicar', 'reivindicar', 'sortir', 'sortir', 'verificar']","[1, 2, 2, 1, 1, 2, 2, 1, 1, 3, 3, 3, 2, 2, 1]",3,15,18,0
7420,"['consecutivo', 'dosar', 'dosar', 'dosar', 'mergulhar', 'observacao', 'planar']","[1, 3, 3, 3, 1, 1, 1]","['curioso', 'disfarcar']","[1, 1]",7,2,9,0
7422,"['realizacao']","[1]","['assinalar', 'cedula', 'cedula', 'circular', 'fraudar', 'fraudar', 'gravacao', 'idioma', 'legendar', 'visualizar']","[1, 2, 2, 1, 2, 2, 1, 1, 1, 1]",1,10,11,0
7423,"['acordo', 'apreensao', 'autoridad', 'autoridad', 'barroso', 'barroso', 'decisao', 'decisao', 'destacar', 'esquema', 'esquema', 'inquerito', 'ministrar', 'ministrar', 'pratico', 'situacao']","[1, 1, 2, 2, 2, 2, 2, 2, 1, 2, 2, 1, 2, 2, 1, 1]","['casamentar', 'filmar', 'filmar', 'filmar', 'fraudar', 'ganhar', 'parir', 'parir', 'parir', 'parir', 'parir', 'parir', 'parir', 'parir', 'parir', 'parir', 'parir', 'parir', 'parir', 'pelar', 'pelar', 'secreto', 'sobrar', 'sobrar', 'vc']","[1, 3, 3, 3, 1, 1, 13, 13, 13, 13, 13, 13, 13, 13, 13, 13, 13, 13, 13, 2, 2, 1, 2, 2, 1]",16,25,41,0
7424,"[]","[]","[]","[]",0,0,0,0
7425,"[]","[]","['botao', 'clicar', 'compartilhar', 'compartilhar', 'compartilhar', 'telejorn']","[1, 1, 3, 3, 3, 1]",0,6,6,0
7426,"['checo']","[1]","['expulsar']","[1]",1,1,2,0
7429,"['converso', 'nelson', 'proposto', 'regrar', 'reuniao', 'servidor']","[1, 1, 1, 1, 1, 1]","['vazar']","[1]",6,1,7,0
7433,"['comparacao', 'crise', 'desafiar', 'surtir']","[1, 1, 1, 1]","['falsar', 'falsar', 'narrativo', 'vazar']","[2, 2, 1, 1]",4,4,8,0
7436,"['eventualment', 'fase']","[1, 1]","['circular', 'suco']","[1, 1]",2,2,4,0
7437,"['funcao']","[1]","['compartilhar']","[1]",1,1,2,0
7438,"['desenvolvido']","[1]","[]","[]",1,0,1,0
7439,"[]","[]","['amplament', 'circular', 'circular', 'gravacao', 'imagem', 'legendar', 'reverso', 'telegram', 'versao']","[1, 2, 2, 1, 1, 1, 1, 1, 1]",0,9,9,0
7440,"['exministro']","[1]","['insinuar']","[1]",1,1,2,0
7442,"[]","[]","['mesario']","[1]",0,1,1,0
7443,"['curvo', 'espanha']","[1, 1]","['arquivar']","[1]",2,1,3,0
7445,"['calculo', 'obtido']","[1, 1]","['fraudar', 'fraudar']","[2, 2]",2,2,4,0
7448,"['mudanca']","[1]","['espalhar', 'gretar']","[1, 1]",1,2,3,0
7449,"[]","[]","[]","[]",0,0,0,0
7452,"['reconhecimento']","[1]","['parir', 'parir']","[2, 2]",1,2,3,0
7453,"['client', 'elaborar', 'treinar']","[1, 1, 1]","['incendio', 'menino']","[1, 1]",3,2,5,0
7456,"['prazo', 'regrar']","[1, 1]","[]","[]",2,0,2,0
7458,"[]","[]","['clicar', 'clicar']","[2, 2]",0,2,2,0
7459,"['carla', 'decorrencia', 'zambelli']","[1, 1, 1]","['amplament', 'circular', 'compartilhar', 'gravacao', 'gravacao', 'ilustrar', 'terrorismo', 'usuario', 'visualizar']","[1, 1, 1, 2, 2, 1, 1, 1, 1]",3,9,12,0
7461,"['taxar', 'temporada', 'temporada']","[1, 2, 2]","['circular', 'circular', 'imagem', 'imagem', 'imagem', 'reverso']","[2, 2, 3, 3, 3, 1]",3,6,9,0
7462,"[]","[]","['versao']","[1]",0,1,1,0
7463,"['lewandowski', 'lewandowski', 'ministrar', 'periodo', 'piorar', 'ricardo', 'ricardo', 'ricardo']","[2, 2, 1, 1, 1, 3, 3, 3]","['vc']","[1]",8,1,9,0
7464,"[]","[]","[]","[]",0,0,0,0
7467,"['gorinchteyn', 'infectar', 'infectar']","[1, 2, 2]","['boatar', 'circular', 'gravacao']","[1, 1, 1]",3,3,6,0
7468,"['regrar', 'regrar']","[2, 2]","['circular', 'compartilhar']","[1, 1]",2,2,4,0
7472,"[]","[]","[]","[]",0,0,0,0
7473,"['saudar', 'sputnik']","[1, 1]","[]","[]",2,0,2,0
7474,"['aprovacao', 'congresso', 'individuar', 'prever', 'suportar']","[1, 1, 1, 1, 1]","['circular']","[1]",5,1,6,0
7475,"['florido']","[1]","['segundar']","[1]",1,1,2,0
7478,"['hubei', 'provincia']","[1, 1]","['espalhar']","[1]",2,1,3,0
7480,"['estabilidad', 'ministrar', 'supremo']","[1, 1, 1]","['atribuir', 'atribuir', 'cbn', 'circular']","[2, 2, 1, 1]",3,4,7,0
7481,"[]","[]","['compartilhar', 'parir', 'usuario', 'verdadeiro']","[1, 1, 1, 1]",0,4,4,0
7482,"['destinar', 'pastar']","[1, 1]","['circular', 'imagem']","[1, 1]",2,2,4,0
7484,"[]","[]","[]","[]",0,0,0,0
7486,"['mudanca']","[1]","[]","[]",1,0,1,0
7487,"['domingo', 'domingo']","[2, 2]","['catedr', 'circular', 'circular', 'legendar']","[1, 2, 2, 1]",2,4,6,0
7488,"['exigencia', 'periodo', 'prever']","[1, 1, 1]","['circular']","[1]",3,1,4,0
7491,"[]","[]","[]","[]",0,0,0,0
7493,"['cupula']","[1]","['gretar', 'gretar', 'gretar', 'motorista', 'verificacao']","[3, 3, 3, 1, 1]",1,5,6,0
7495,"['saudar']","[1]","['circular', 'imagem', 'imagem', 'postagen']","[1, 2, 2, 1]",1,4,5,0
7496,"['ambientar', 'reflexo']","[1, 1]","['carbono', 'carbono', 'carbono', 'circular', 'compartilhar', 'desmaiar', 'dioxido', 'dioxido', 'dioxido']","[3, 3, 3, 1, 1, 1, 3, 3, 3]",2,9,11,0
7498,"['varga']","[1]","['dorio']","[1]",1,1,2,0
7499,"['afp', 'espanha', 'infectar', 'instituto', 'presenca', 'sequenciamento']","[1, 1, 1, 1, 1, 1]","['circular', 'circular', 'compartilhar', 'postagen']","[2, 2, 1, 1]",6,4,10,0
7500,"['observar']","[1]","['agredir', 'agredir', 'agredir', 'inocentar', 'versao']","[3, 3, 3, 1, 1]",1,5,6,0
7501,"[]","[]","['fraudar', 'parir', 'parir', 'parir', 'parir', 'parir', 'pelar', 'pelar']","[1, 5, 5, 5, 5, 5, 2, 2]",0,8,8,0
7503,"['planar', 'planar']","[2, 2]","['arquivar', 'circular', 'compartilhar']","[1, 1, 1]",2,3,5,0
7504,"['passageiro', 'quarentenar']","[1, 1]","['circular']","[1]",2,1,3,0
7505,"[]","[]","['compartilhar', 'parir', 'pelar', 'quinzena', 'vezar']","[1, 1, 1, 1, 1]",0,5,5,0
7509,"['calamidad', 'decisao', 'decorrent', 'edson', 'fachin', 'ministrar', 'ministrar', 'realizacao', 'subir', 'supremo']","[1, 1, 1, 1, 1, 2, 2, 1, 1, 1]","['compartilhar', 'realment', 'usuario']","[1, 1, 1]",10,3,13,0
7512,"['reuniao', 'videoconferencia']","[1, 1]","['deitar', 'enganar', 'espalhar', 'imagem', 'imagem']","[1, 1, 1, 2, 2]",2,5,7,0
7514,"[]","[]","['sapato', 'sapato', 'sapato']","[3, 3, 3]",0,3,3,0
7516,"[]","[]","[]","[]",0,0,0,0
7518,"[]","[]","['ganhar', 'vezar']","[1, 1]",0,2,2,0
7519,"['constituicao']","[1]","['cartaz', 'circular']","[1, 1]",1,2,3,0
7521,"['articulacao', 'esquema']","[1, 1]","['greve']","[1]",2,1,3,0
7522,"['folhar', 'saudar']","[1, 1]","['assassinar']","[1]",2,1,3,0
7524,"['agravar', 'argumentar', 'augusto', 'compromisso', 'converso', 'converso', 'crise', 'federar', 'justicar', 'ministrar', 'republico', 'transferir']","[1, 1, 1, 1, 2, 2, 1, 1, 1, 1, 1, 1]","['amigar', 'faccao', 'faccao', 'faccao', 'faccao', 'torturar', 'vazar']","[1, 4, 4, 4, 4, 1, 1]",12,7,19,0
7525,"['vespera']","[1]","['circular', 'fotografo', 'imagem', 'legendar', 'reverso']","[1, 1, 1, 1, 1]",1,5,6,0
7528,"[]","[]","['espalhar']","[1]",0,1,1,0
7532,"[]","[]","['cbn', 'circular']","[1, 1]",0,2,2,0
7533,"['florido', 'florido']","[2, 2]","[]","[]",2,0,2,0
7535,"['estimular', 'volumar']","[1, 1]","['disseminar']","[1]",2,1,3,0
7536,"['companhia']","[1]","[]","[]",1,0,1,0
7541,"['californio']","[1]","['drone', 'incendio', 'vagabundar']","[1, 1, 1]",1,3,4,0
7542,"['armazenamento', 'atuacao', 'desempenhar', 'propagacao']","[1, 1, 1, 1]","['basto', 'compartilhar']","[1, 1]",4,2,6,0
7545,"[]","[]","[]","[]",0,0,0,0
7550,"['colunista', 'republico']","[1, 1]","['atribuir', 'circular', 'versao', 'versao']","[1, 1, 2, 2]",2,4,6,0
7556,"['anteriorment', 'anticorpo', 'consequencia', 'infeccioso', 'liderar', 'precedent', 'saudar', 'supremo', 'supremo']","[1, 1, 1, 1, 1, 1, 1, 2, 2]","['grupar', 'grupar', 'humanar', 'lembres', 'manipulacao', 'parir', 'parir', 'parir', 'parir', 'pelar', 'pelar', 'pelar', 'sequer', 'supostament']","[2, 2, 1, 1, 1, 4, 4, 4, 4, 3, 3, 3, 1, 1]",9,14,23,0
7559,"['afp']","[1]","['checagem', 'chorar', 'chorar', 'chorar', 'circular', 'compartilhar', 'imagem', 'imagem', 'imagem', 'legendar', 'misericordia', 'misericordia', 'reverso']","[1, 3, 3, 3, 1, 1, 3, 3, 3, 1, 2, 2, 1]",1,13,14,0
7560,"[]","[]","['motorista']","[1]",0,1,1,0
7561,"['assintomatico', 'biliao', 'biliao', 'colegio', 'cupula', 'economia', 'impactar', 'impactar', 'impactar', 'infectar', 'necessario', 'propagacao', 'surtir', 'taxar', 'transmissao', 'transmissao', 'vulneravel']","[1, 2, 2, 1, 1, 1, 3, 3, 3, 1, 1, 1, 1, 1, 2, 2, 1]","['espalhar', 'espalhar', 'estranhar', 'usuario']","[2, 2, 1, 1]",17,4,21,0
7564,"['cardiologista', 'lesao', 'possibilidad', 'precisao', 'saudar']","[1, 1, 1, 1, 1]","['cbn', 'circular']","[1, 1]",5,2,7,0
7565,"['infancia', 'pratico', 'treinamento']","[1, 1, 1]","['circular', 'crech', 'crech', 'mencao']","[1, 2, 2, 1]",3,4,7,0
7566,"['internar']","[1]","['falsar', 'pelar']","[1, 1]",1,2,3,0
7567,"['afp']","[1]","['capturar', 'checar', 'circular', 'compartilhar', 'compartilhar', 'verificacao']","[1, 1, 1, 2, 2, 1]",1,6,7,0
7569,"['recurso', 'saudar']","[1, 1]","['circular', 'compartilhar', 'rouanet', 'supostament']","[1, 1, 1, 1]",2,4,6,0
7570,"['etapa']","[1]","['clicar', 'clicar', 'compartilhar', 'compartilhar', 'ganhar', 'ganhar', 'instrucao', 'instrucao', 'instrucao', 'parabem', 'preencher', 'reivindicar', 'reivindicar', 'reivindicar', 'verificar']","[2, 2, 2, 2, 2, 2, 3, 3, 3, 1, 1, 3, 3, 3, 1]",1,15,16,0
7571,"['republico']","[1]","[]","[]",1,0,1,0
7572,"['comissao', 'discussao', 'justicar', 'ministrar', 'presenciar', 'reuniao']","[1, 1, 1, 1, 1, 1]","[]","[]",6,0,6,0
7573,"[]","[]","['amplament', 'compartilhar', 'fraudar', 'imagem', 'imagem', 'usuario', 'viralizada']","[1, 1, 1, 2, 2, 1, 1]",0,7,7,0
7576,"['condicao']","[1]","[]","[]",1,0,1,0
7579,"[]","[]","[]","[]",0,0,0,0
7581,"['proposto']","[1]","['checar', 'numericament']","[1, 1]",1,2,3,0
7582,"[]","[]","[]","[]",0,0,0,0
7586,"['exonerar', 'justicar', 'justicar', 'ministrar', 'ministrar', 'ministrar']","[1, 2, 2, 3, 3, 3]","['adorar', 'humanar', 'humanar', 'obama', 'obama', 'torturar', 'trafico', 'trafico']","[1, 2, 2, 2, 2, 1, 2, 2]",6,8,14,0
7588,"['ambientar', 'colaborar', 'periodo']","[1, 1, 1]","[]","[]",3,0,3,0
7590,"[]","[]","['amigar', 'dorio']","[1, 1]",0,2,2,0
7594,"['economia', 'situacao']","[1, 1]","['imagem', 'misturar', 'verdadeiro', 'viralizada']","[1, 1, 1, 1]",2,4,6,0
7596,"[]","[]","['espalhar', 'quinzena', 'trafico']","[1, 1, 1]",0,3,3,0
7597,"['disseminacao', 'domingo', 'elaborar', 'planar', 'sabado']","[1, 1, 1, 1, 1]","['circular', 'mencao', 'mesario']","[1, 1, 1]",5,3,8,0
7598,"['investigacao']","[1]","['circular']","[1]",1,1,2,0
7600,"['converso', 'crescimento', 'regiao']","[1, 1, 1]","['imagem']","[1]",3,1,4,0
7601,"['autoridad', 'condicao', 'extensao', 'prazo']","[1, 1, 1, 1]","['pelar']","[1]",4,1,5,0
7602,"['comportamento', 'suportar']","[1, 1]","['lixar', 'realment', 'sacar', 'venezuelano']","[1, 1, 1, 1]",2,4,6,0
7604,"['oliveira', 'transferencia']","[1, 1]","['catolico']","[1]",2,1,3,0
7605,"['aglomeracao', 'esquema']","[1, 1]","['dorio', 'fotografia', 'imagem', 'imagem', 'indignar', 'legendar', 'usuario']","[1, 1, 2, 2, 1, 1, 1]",2,7,9,0
7608,"['biliao', 'biliao', 'biliao', 'destinar', 'fase', 'montant', 'planar', 'saudar', 'saudar']","[3, 3, 3, 1, 1, 1, 1, 2, 2]","['circular']","[1]",9,1,10,0
7609,"[]","[]","['parabem', 'parabem']","[2, 2]",0,2,2,0
7611,"[]","[]","['ganhar']","[1]",0,1,1,0
7612,"[]","[]","['circular', 'idioma', 'invadir', 'sacar', 'sacar', 'tampouco']","[1, 1, 1, 2, 2, 1]",0,6,6,0
7613,"['afp']","[1]","['checagem', 'circular', 'ganhar', 'postagen', 'supostament', 'verificacao']","[1, 1, 1, 1, 1, 1]",1,6,7,0
7614,"['converso', 'plantao', 'plantao', 'provisorio']","[1, 2, 2, 1]","['pego', 'pego', 'perdao']","[2, 2, 1]",4,3,7,0
7615,"['definitivo', 'habito', 'subir']","[1, 1, 1]","['minutar', 'parir', 'parir', 'parir', 'parir', 'parir', 'parir', 'parir', 'parir', 'parir', 'parir', 'pelar', 'pelar', 'pelar', 'quantum', 'quantum', 'quantum', 'realment', 'secreto', 'verdadeiro']","[1, 10, 10, 10, 10, 10, 10, 10, 10, 10, 10, 3, 3, 3, 3, 3, 3, 1, 1, 1]",3,20,23,0
7616,"['proposto']","[1]","['compartilhar']","[1]",1,1,2,0
7619,"['converso', 'desmatamento', 'instituto', 'instituto', 'periodo', 'regiao', 'ricardo', 'rotina']","[1, 1, 2, 2, 1, 1, 1, 1]","[]","[]",8,0,8,0
7620,"['respostar']","[1]","['arvor', 'ganhar', 'gretar', 'gretar', 'parir', 'parir', 'parir', 'pelar', 'segundar']","[1, 1, 2, 2, 3, 3, 3, 1, 1]",1,9,10,0
7621,"['ribeiro', 'ribeiro', 'ribeiro']","[3, 3, 3]","['circular', 'compartilhar', 'gravacao', 'legendar', 'postagen']","[1, 1, 1, 1, 1]",3,5,8,0
7623,"[]","[]","['compartilhar', 'espalhar', 'grupar', 'grupar', 'parir', 'protestar']","[1, 1, 2, 2, 1, 1]",0,6,6,0
7624,"[]","[]","[]","[]",0,0,0,0
7625,"['estatistico', 'positivar']","[1, 1]","[]","[]",2,0,2,0
7626,"[]","[]","['checar', 'enganir', 'transposicao']","[1, 1, 1]",0,3,3,0
7627,"['autoridad']","[1]","['circular']","[1]",1,1,2,0
7628,"[]","[]","['bandeiro', 'imagem', 'imagem', 'versao']","[1, 2, 2, 1]",0,4,4,0
7629,"[]","[]","[]","[]",0,0,0,0
7632,"['previsto', 'tendencia']","[1, 1]","[]","[]",2,0,2,0
7634,"['complicacao']","[1]","['parir']","[1]",1,1,2,0
7635,"['economia', 'economia', 'mudanca', 'palacio', 'planalto']","[2, 2, 1, 1, 1]","['circular', 'verdadeiro']","[1, 1]",5,2,7,0
7636,"['decisao', 'fluminens', 'marinhar', 'marinhar', 'ricardo', 'ricardo']","[1, 1, 2, 2, 2, 2]","['imagem', 'libertador', 'verdadeiro']","[1, 1, 1]",6,3,9,0
7637,"[]","[]","['imagem', 'lixar', 'minutar']","[1, 1, 1]",0,3,3,0
7643,"['companhia', 'converso', 'integrant', 'periodo']","[1, 1, 1, 1]","['atribuir']","[1]",4,1,5,0
7646,"[]","[]","[]","[]",0,0,0,0
7647,"['entregu', 'parceria', 'quarentenar', 'regiao']","[1, 1, 1, 1]","['basto', 'compartilhar', 'inscricao', 'preencher']","[1, 1, 1, 1]",4,4,8,0
7648,"['exministro', 'nomeacao']","[1, 1]","['chorar', 'macho']","[1, 1]",2,2,4,0
7649,"[]","[]","['circular']","[1]",0,1,1,0
7650,"[]","[]","['circular', 'compartilhar', 'espalhar', 'imagem', 'inscricao']","[1, 1, 1, 1, 1]",0,5,5,0
7651,"['afp', 'agravar', 'crise', 'gued']","[1, 1, 1, 1]","['checar', 'circular', 'compartilhar', 'imagem', 'imagem', 'reverso']","[1, 1, 1, 2, 2, 1]",4,6,10,0
7652,"['despesa']","[1]","[]","[]",1,0,1,0
7653,"['alergia', 'ambientar', 'infeccioso', 'infeccioso']","[1, 1, 2, 2]","[]","[]",4,0,4,0
7654,"[]","[]","['circular', 'circular', 'imagem', 'imagem']","[2, 2, 2, 2]",0,4,4,0
7655,"['plano', 'quedo']","[1, 1]","['atribuir', 'circular', 'imagem', 'postagen']","[1, 1, 1, 1]",2,4,6,0
7656,"[]","[]","[]","[]",0,0,0,0
7657,"[]","[]","['espalhar', 'imagem']","[1, 1]",0,2,2,0
7659,"[]","[]","['circular', 'circular', 'imagem', 'imagem', 'imagem']","[2, 2, 3, 3, 3]",0,5,5,0
7663,"['deteccao', 'epidemiar', 'epidemiar', 'epidemiar', 'epidemiar', 'escalar']","[1, 4, 4, 4, 4, 1]","['amplament', 'circular', 'compartilhar', 'compartilhar', 'filmar', 'filmar', 'filmar', 'filmar', 'imagem', 'intitular', 'intitular', 'legendar', 'maldiz', 'postagen', 'reverso', 'supostament', 'usuario']","[1, 1, 2, 2, 4, 4, 4, 4, 1, 2, 2, 1, 1, 1, 1, 1, 1]",6,17,23,0
7664,"[]","[]","[]","[]",0,0,0,0
7665,"[]","[]","[]","[]",0,0,0,0
7667,"[]","[]","[]","[]",0,0,0,0
7669,"['destacar', 'quedo']","[1, 1]","['amplament', 'circular', 'compartilhar', 'estomago', 'ilustrar', 'imagem', 'suco', 'viralizada']","[1, 1, 1, 1, 1, 1, 1, 1]",2,8,10,0
7670,"['heleno', 'proporcao']","[1, 1]","['capturar', 'circular', 'circular', 'circular', 'gravacao', 'incendio', 'incendio', 'legendar', 'lembres', 'menino', 'menino', 'menino', 'reverso', 'vc', 'vc', 'versao']","[1, 3, 3, 3, 1, 2, 2, 1, 1, 3, 3, 3, 1, 2, 2, 1]",2,16,18,0
7671,"['aglomeracao']","[1]","['circular', 'compartilhar', 'imagem', 'invadir', 'legendar', 'lembres', 'postagen', 'rouanet']","[1, 1, 1, 1, 1, 1, 1, 1]",1,8,9,0
7677,"[]","[]","[]","[]",0,0,0,0
7678,"['gued', 'instalacao', 'instalacao', 'tambem', 'transferir']","[1, 2, 2, 1, 1]","['carrefour']","[1]",5,1,6,0
7679,"['fluminens', 'fundacao', 'instituto', 'quarentenar', 'turistico', 'wilson', 'witzel', 'witzel', 'witzel', 'witzel']","[1, 1, 1, 1, 1, 1, 4, 4, 4, 4]","['cbn', 'circular', 'imagem']","[1, 1, 1]",10,3,13,0
7680,"['comissao', 'minoria']","[1, 1]","['casamentar']","[1]",2,1,3,0
7682,"[]","[]","['efarsa']","[1]",0,1,1,0
7683,"['fronteiro', 'fronteiro']","[2, 2]","['maldiz']","[1]",2,1,3,0
7684,"['preventivo']","[1]","['abencoar', 'limao', 'limao', 'limao', 'limao', 'limao', 'suco']","[1, 5, 5, 5, 5, 5, 1]",1,7,8,0
7686,"['saudar']","[1]","['imagem', 'sortir', 'sortir']","[1, 2, 2]",1,3,4,0
7688,"[]","[]","['falsar', 'parir', 'sequer', 'usuario']","[1, 1, 1, 1]",0,4,4,0
7690,"['interino']","[1]","['circular', 'imagem', 'venezuelano']","[1, 1, 1]",1,3,4,0
7692,"['respostar']","[1]","['assassinar', 'chorar', 'deitar', 'estuprar', 'inocentar']","[1, 1, 1, 1, 1]",1,5,6,0
7696,"[]","[]","['canadens', 'secreto', 'vagabundar']","[1, 1, 1]",0,3,3,0
7700,"['escalar', 'infectar', 'michael', 'michael', 'planar', 'transferir']","[1, 1, 2, 2, 1, 1]","['enganar', 'legendar', 'manipulacao']","[1, 1, 1]",6,3,9,0
7701,"[]","[]","['amigar', 'deitar', 'drone', 'espalhar', 'imagem', 'parir', 'verdadeiro']","[1, 1, 1, 1, 1, 1, 1]",0,7,7,0
7702,"['economia', 'periferia', 'positivar']","[1, 1, 1]","['amplament', 'compartilhar', 'compartilhar', 'cuspir', 'cuspir', 'cuspir', 'espalhar', 'gravacao', 'imagem', 'terrorismo']","[1, 2, 2, 3, 3, 3, 1, 1, 1, 1]",3,10,13,0
7707,"[]","[]","['cnh', 'parabem', 'parir', 'pelar', 'pelar']","[1, 1, 1, 2, 2]",0,5,5,0
7708,"['concessionario', 'conjuntar', 'infraestrutura', 'infraestrutura', 'monitoramento', 'periodo', 'situacao', 'situacao']","[1, 1, 2, 2, 1, 1, 2, 2]","['atribuir', 'imagem', 'imagem', 'imagem', 'verificacao', 'verificacao', 'versao']","[1, 3, 3, 3, 2, 2, 1]",8,7,15,0
7711,"['airlin', 'domingo', 'quedo', 'quedo']","[1, 1, 2, 2]","['acidentar', 'acidentar', 'acidentar', 'circular', 'circular', 'legendar', 'verdadeiro']","[3, 3, 3, 2, 2, 1, 1]",4,7,11,0
7712,"['risco']","[1]","[]","[]",1,0,1,0
7715,"['aglomeracao', 'avancar']","[1, 1]","[]","[]",2,0,2,0
7716,"['adulto', 'especialment', 'implementar', 'observar', 'percepcao', 'saudar', 'saudar']","[1, 1, 1, 1, 1, 2, 2]","['realment']","[1]",7,1,8,0
7717,"['ambientar', 'desenvolvimento']","[1, 1]","['verificar']","[1]",2,1,3,0
7718,"['biliao']","[1]","['amigar', 'cristao']","[1, 1]",1,2,3,0
7719,"[]","[]","['amigar', 'amigar', 'amigar', 'lixar', 'vagabundar', 'vagabundar', 'vagabundar']","[3, 3, 3, 1, 3, 3, 3]",0,7,7,0
7720,"['associacao', 'associacao', 'associacao', 'bancada', 'crise', 'desafiar', 'enxergar', 'integrant']","[3, 3, 3, 1, 1, 1, 1, 1]","[]","[]",8,0,8,0
7722,"[]","[]","['imagem', 'vezar']","[1, 1]",0,2,2,0
7723,"[]","[]","['barragem', 'compartilhar', 'rompimento']","[1, 1, 1]",0,3,3,0
7726,"['assistenci', 'avancar', 'contemplar', 'parcelar', 'situacao', 'vulnerabilidad']","[1, 1, 1, 1, 1, 1]","['enderecar', 'enderecar', 'inscricao']","[2, 2, 1]",6,3,9,0
7728,"['emprestimo']","[1]","['parir']","[1]",1,1,2,0
7729,"['circulacao', 'internar', 'intubacao', 'parceria', 'reforcar', 'saudar', 'saudar', 'saudar', 'saudar']","[1, 1, 1, 1, 1, 4, 4, 4, 4]","[]","[]",9,0,9,0
7732,"['adulto', 'esperancar', 'ministrar']","[1, 1, 1]","['circular', 'cobaia', 'maldiz']","[1, 1, 1]",3,3,6,0
7733,"[]","[]","['sortir']","[1]",0,1,1,0
7734,"[]","[]","[]","[]",0,0,0,0
7741,"[]","[]","[]","[]",0,0,0,0
7742,"[]","[]","['chorar', 'circular', 'compartilhar']","[1, 1, 1]",0,3,3,0
7746,"['recordar', 'recordar']","[2, 2]","['parir']","[1]",2,1,3,0
7748,"['institut', 'levantamento', 'processo']","[1, 1, 1]","['compartilhar', 'ganhar', 'postagen']","[1, 1, 1]",3,3,6,0
7751,"[]","[]","['menino', 'menino', 'quinzena']","[2, 2, 1]",0,3,3,0
7753,"['recordar']","[1]","['checar', 'crech']","[1, 1]",1,2,3,0
7754,"['recordar']","[1]","['checar']","[1]",1,1,2,0
7755,"['situacao']","[1]","['checar']","[1]",1,1,2,0
7756,"[]","[]","['checar', 'crech', 'parir']","[1, 1, 1]",0,3,3,0
7757,"['periferia']","[1]","['checar']","[1]",1,1,2,0
7761,"['exercicio', 'quarentenar']","[1, 1]","[]","[]",2,0,2,0
7763,"[]","[]","[]","[]",0,0,0,0
7764,"['diagnosticar']","[1]","['arquivar', 'manchet']","[1, 1]",1,2,3,0
7765,"['parceria']","[1]","['verificar']","[1]",1,1,2,0
7769,"['aprovacao', 'disseminacao', 'saudar', 'supremo']","[1, 1, 1, 1]","['circular']","[1]",4,1,5,0
7770,"['bancada', 'revogar']","[1, 1]","['atribuir', 'circular', 'circular', 'cristao', 'cristao', 'maldiz']","[1, 2, 2, 2, 2, 1]",2,6,8,0
7773,"[]","[]","['greve', 'greve', 'greve', 'greve']","[4, 4, 4, 4]",0,4,4,0
7774,"['examinar', 'saudar']","[1, 1]","['circular', 'desmaiar', 'desmaiar', 'legendar']","[1, 2, 2, 1]",2,4,6,0
7775,"[]","[]","['renunciar', 'renunciar']","[2, 2]",0,2,2,0
7777,"['comorbidad', 'comorbidad']","[2, 2]","['circular', 'sobrar', 'sobrar']","[1, 2, 2]",2,3,5,0
7779,"['saudar']","[1]","[]","[]",1,0,1,0
7781,"['crise', 'plano']","[1, 1]","['atribuir', 'circular', 'desmentir', 'enderecar', 'enderecar', 'verificacao', 'verificar', 'verificar']","[1, 1, 1, 2, 2, 1, 2, 2]",2,8,10,0
7783,"['academico']","[1]","['imagem']","[1]",1,1,2,0
7785,"['companhia', 'companhia', 'companhia', 'proposto', 'sindicato']","[3, 3, 3, 1, 1]","['circular', 'circular', 'verdadeiro', 'verdadeiro']","[2, 2, 2, 2]",5,4,9,0
7786,"['avancar', 'estagio', 'infectar', 'preventivo', 'sigla', 'ventilacao']","[1, 1, 1, 1, 1, 1]","['enganoso', 'parir', 'parir']","[1, 2, 2]",6,3,9,0
7787,"[]","[]","['amplament', 'circular', 'compartilhar', 'fraudar', 'fraudar', 'fraudar', 'imagem', 'legendar', 'viralizado']","[1, 1, 1, 3, 3, 3, 1, 1, 1]",0,9,9,0
7789,"['convencao', 'decisao', 'panamericana', 'previsto', 'saudar', 'saudar']","[1, 1, 1, 1, 2, 2]","['boatar', 'circular', 'mencao']","[1, 1, 1]",6,3,9,0
7790,"['biliao', 'comissao', 'definitivo', 'europeu']","[1, 1, 1, 1]","['privacidad', 'telegram', 'telegram', 'telegram', 'usuario']","[1, 3, 3, 3, 1]",4,5,9,0
7793,"['emergenciai', 'genoma', 'prazo']","[1, 1, 1]","['compartilhar', 'parir', 'pelar', 'vezar', 'vezar']","[1, 1, 1, 2, 2]",3,5,8,0
7795,"['concorrent', 'legislativo', 'saudar', 'situacao']","[1, 1, 1, 1]","[]","[]",4,0,4,0
7796,"['instituto', 'pagamento']","[1, 1]","['sacar']","[1]",2,1,3,0
7797,"[]","[]","['atribuir']","[1]",0,1,1,0
7799,"[]","[]","[]","[]",0,0,0,0
7800,"['temporada']","[1]","['lixar', 'patrocinador', 'patrocinador', 'patrocinador', 'patrocinador']","[1, 4, 4, 4, 4]",1,5,6,0
7802,"['etapa', 'justicar']","[1, 1]","['adelio', 'bispar', 'compartilhar']","[1, 1, 1]",2,3,5,0
7804,"['dosar', 'dosar']","[2, 2]","[]","[]",2,0,2,0
7807,"[]","[]","[]","[]",0,0,0,0
7808,"['decisao', 'plenario', 'unanimidad']","[1, 1, 1]","['biblia', 'biblia', 'circular']","[2, 2, 1]",3,3,6,0
7810,"[]","[]","['drone', 'drone', 'parir', 'sacar']","[2, 2, 1, 1]",0,4,4,0
7811,"['situacao']","[1]","['compartilhar', 'compartilhar', 'imagem', 'indignar', 'rosario']","[2, 2, 1, 1, 1]",1,5,6,0
7813,"['comparacao', 'ministrar', 'souza']","[1, 1, 1]","['atribuir', 'escutar', 'gravacao', 'reivindicar']","[1, 1, 1, 1]",3,4,7,0
7815,"['companhia', 'supremo']","[1, 1]","['espalhar', 'quinzena', 'venezuelano']","[1, 1, 1]",2,3,5,0
7818,"[]","[]","['clicar', 'compartilhar', 'compartilhar', 'ganhar', 'instrucao']","[1, 2, 2, 1, 1]",0,5,5,0
7820,"['exministro', 'exministro', 'pslsp']","[2, 2, 1]","['circular', 'compartilhar']","[1, 1]",3,2,5,0
7821,"['companhia', 'domingo', 'reuter', 'transferencia']","[1, 1, 1, 1]","['circular', 'intitular']","[1, 1]",4,2,6,0
7822,"['parceiro', 'parceiro']","[2, 2]","[]","[]",2,0,2,0
7823,"['rotina']","[1]","['revoltar', 'versao', 'versao', 'versao', 'versao']","[1, 4, 4, 4, 4]",1,5,6,0
7824,"['anvisa', 'argumentar', 'diariament', 'fronteiro', 'passageiro', 'saudar', 'trafego']","[1, 1, 1, 1, 1, 1, 1]","['circular', 'humanar']","[1, 1]",7,2,9,0
7826,"['turistico', 'turistico']","[2, 2]","['circular', 'imagem', 'legendar']","[1, 1, 1]",2,3,5,0
7830,"['congresso', 'republico', 'tramitar']","[1, 1, 1]","[]","[]",3,0,3,0
7831,"['quedo', 'regiao', 'transmissao']","[1, 1, 1]","['circular', 'imagem', 'legendar', 'protestar']","[1, 1, 1, 1]",3,4,7,0
7832,"['articulacao', 'autorizacao', 'observar']","[1, 1, 1]","['atribuir', 'circular', 'enderecar', 'imagem', 'imagem', 'logotipo']","[1, 1, 1, 2, 2, 1]",3,6,9,0
7837,"['portavoz', 'saudar']","[1, 1]","['circular', 'circular', 'idioma']","[2, 2, 1]",2,3,5,0
7838,"[]","[]","['circular']","[1]",0,1,1,0
7839,"['conjuntar']","[1]","['circular']","[1]",1,1,2,0
7840,"['prever', 'rotina', 'saudar']","[1, 1, 1]","['atirar', 'atirar', 'atirar', 'atirar', 'atirar', 'atirar', 'circular']","[6, 6, 6, 6, 6, 6, 1]",3,7,10,0
7841,"['atuacao', 'concedido', 'desenvolvimento', 'montant', 'recurso']","[1, 1, 1, 1, 1]","['atribuir', 'misturar', 'verdadeiro', 'verificar']","[1, 1, 1, 1]",5,4,9,0
7842,"['prever', 'proporcao']","[1, 1]","['incendio']","[1]",2,1,3,0
7843,"['ambito', 'atuacao', 'lavagem', 'passageiro']","[1, 1, 1, 1]","['capturar', 'circular', 'compartilhar', 'espalhar', 'gravacao', 'intitular', 'legendar', 'reverso', 'visualizar']","[1, 1, 1, 1, 1, 1, 1, 1, 1]",4,9,13,0
7844,"['conformar', 'inovacao', 'ministrar']","[1, 1, 1]","['circular', 'enganoso', 'legendar']","[1, 1, 1]",3,3,6,0
7845,"['apurar', 'comissao', 'crise', 'crise', 'infectar', 'infectar', 'inquerito', 'mandatario', 'transmissao']","[1, 1, 2, 2, 2, 2, 1, 1, 1]","['realment']","[1]",9,1,10,0
7846,"['especialment', 'observar', 'preced', 'recuar', 'saudar']","[1, 1, 1, 1, 1]","['socialismo']","[1]",5,1,6,0
7847,"['congresso', 'decisao', 'depoimento', 'supremo']","[1, 1, 1, 1]","['circular', 'circular', 'manipular', 'manipular', 'venezuelano', 'venezuelano']","[2, 2, 2, 2, 2, 2]",4,6,10,0
7848,"[]","[]","['enganir', 'espalhar']","[1, 1]",0,2,2,0
7849,"['crise']","[1]","['circular']","[1]",1,1,2,0
7853,"[]","[]","['agredir', 'agredir', 'agredir', 'agredir', 'agredir', 'curioso', 'pego', 'pego', 'revoltar', 'safar']","[5, 5, 5, 5, 5, 1, 2, 2, 1, 1]",0,10,10,0
7855,"['economia', 'proposto', 'saudar']","[1, 1, 1]","['acidentar', 'circular']","[1, 1]",3,2,5,0
7858,"['bolsonarista']","[1]","[]","[]",1,0,1,0
7862,"[]","[]","['amigar', 'compartilhar', 'imagem']","[1, 1, 1]",0,3,3,0
7864,"['calendario', 'pagamento', 'respostar']","[1, 1, 1]","['circular', 'sacar', 'sacar']","[1, 2, 2]",3,3,6,0
7866,"[]","[]","[]","[]",0,0,0,0
7871,"[]","[]","[]","[]",0,0,0,0
7872,"[]","[]","['caixao', 'caixao', 'caixao', 'caixao', 'caixao', 'caixao', 'circular', 'compartilhar', 'ilustrar', 'imagem', 'imagem', 'imagem', 'sacar', 'sequer', 'vazio']","[6, 6, 6, 6, 6, 6, 1, 1, 1, 3, 3, 3, 1, 1, 1]",0,15,15,0
7873,"['afp', 'eventualment']","[1, 1]","['checar', 'circular', 'compartilhar', 'gravacao']","[1, 1, 1, 1]",2,4,6,0
7874,"['destacar', 'economia', 'parceria', 'subir', 'viagem']","[1, 1, 1, 1, 1]","[]","[]",5,0,5,0
7876,"['boletim', 'habitant', 'internacao', 'internacao', 'internar', 'internar', 'internar', 'internar', 'internar', 'internar', 'internar', 'internar', 'internar', 'internar', 'internar', 'internar', 'internar', 'saudar']","[1, 1, 2, 2, 13, 13, 13, 13, 13, 13, 13, 13, 13, 13, 13, 13, 13, 1]","['compartilhar']","[1]",18,1,19,0
7877,"['adulto', 'adulto']","[2, 2]","['desmentir', 'efarsa', 'enganar', 'espalhar', 'falsar', 'filmar']","[1, 1, 1, 1, 1, 1]",2,6,8,0
7878,"[]","[]","['sacar', 'sacar', 'vc']","[2, 2, 1]",0,3,3,0
7880,"['ministrar', 'ministrar']","[2, 2]","['faccao', 'mentiroso', 'vazar']","[1, 1, 1]",2,3,5,0
7881,"[]","[]","['circular', 'imagem', 'quinzena', 'sacar']","[1, 1, 1, 1]",0,4,4,0
7883,"[]","[]","[]","[]",0,0,0,0
7886,"['espanha', 'espanha', 'espanha', 'espanha', 'espanha', 'espanha', 'espanha']","[7, 7, 7, 7, 7, 7, 7]","['manchet', 'versao']","[1, 1]",7,2,9,0
7887,"[]","[]","['atribuir', 'compartilhar', 'faccao']","[1, 1, 1]",0,3,3,0
7890,"[]","[]","['espalhar', 'imagem']","[1, 1]",0,2,2,0
7891,"['autoridad', 'biliao', 'comissao', 'depoimento', 'destacar', 'exercicio', 'exministro', 'funcao', 'henriqu', 'justificativo', 'nelson', 'pastar', 'sessao', 'tcu', 'tcu']","[1, 1, 1, 1, 1, 1, 1, 1, 1, 1, 1, 1, 1, 2, 2]","['auditoria', 'indignacao']","[1, 1]",15,2,17,0
7893,"[]","[]","['filmar', 'filmar']","[2, 2]",0,2,2,0
7894,"['integro', 'parcelar', 'provisorio', 'recurso']","[1, 1, 1, 1]","['falsar', 'sacar', 'sacar', 'sacar', 'sacar']","[1, 4, 4, 4, 4]",4,5,9,0
7895,"[]","[]","['manipular']","[1]",0,1,1,0
7896,"['autoridad', 'distrito', 'julgamento', 'primario', 'santiago']","[1, 1, 1, 1, 1]","['circular', 'circular', 'menino', 'menino', 'mentiroso', 'soltura', 'soltura', 'versao']","[2, 2, 2, 2, 1, 2, 2, 1]",5,8,13,0
7898,"['folhar', 'mello', 'parceria', 'presidir', 'proposto', 'sabatino', 'treinamento']","[1, 1, 1, 1, 1, 1, 1]","['bandeiro', 'incendio']","[1, 1]",7,2,9,0
7899,"['infectar', 'investigacao', 'saudar']","[1, 1, 1]","['circular']","[1]",3,1,4,0
7900,"['ambientar', 'dificuldad', 'diminuicao', 'epidemiar', 'equipamento', 'etapa', 'fronteiro', 'funcionamento', 'higienizacao', 'infectar', 'infectar', 'minimizar', 'mudanca', 'necessario', 'saudar', 'saudar', 'saudar', 'situacao', 'suspensao', 'suspenso', 'transmissao', 'viagem']","[1, 1, 1, 1, 1, 1, 1, 1, 1, 2, 2, 1, 1, 1, 3, 3, 3, 1, 1, 1, 1, 1]","['abusar', 'compartilhar', 'estomago', 'estomago', 'garganta', 'garganta', 'garganta', 'garganta', 'garganta', 'verificacao', 'verificacao']","[1, 1, 2, 2, 5, 5, 5, 5, 5, 2, 2]",22,11,33,0
7904,"[]","[]","[]","[]",0,0,0,0
7906,"[]","[]","['enfim']","[1]",0,1,1,0
7907,"['espirito']","[1]","['amplament', 'cocaina', 'compartilhar', 'compartilhar', 'parir', 'quinzena', 'usuario', 'vezar']","[1, 1, 2, 2, 1, 1, 1, 1]",1,8,9,0
7911,"['regiao']","[1]","['clicar', 'motorista']","[1, 1]",1,2,3,0
7913,"['exministro', 'justicar']","[1, 1]","['capturar', 'compartilhar', 'minutar', 'postagen', 'usuario']","[1, 1, 1, 1, 1]",2,5,7,0
7915,"['decorrencia', 'desenvolvido', 'fase', 'instituto', 'instituto', 'internar', 'parceria', 'testagem']","[1, 1, 1, 2, 2, 1, 1, 1]","['circular', 'circular', 'cobaia']","[2, 2, 1]",8,3,11,0
7916,"['inicialment']","[1]","['compartilhar', 'quinzena']","[1, 1]",1,2,3,0
7917,"['congresso', 'exministro', 'spaulo']","[1, 1, 1]","['circular', 'imagem', 'legendar']","[1, 1, 1]",3,3,6,0
7921,"['boletim', 'dengu', 'dengu', 'dengu', 'dengu', 'epidemiologico', 'levantamento', 'notificar', 'pastar', 'periodo', 'periodo', 'reducao', 'reducao', 'saudar', 'suspeito']","[1, 4, 4, 4, 4, 1, 1, 1, 1, 2, 2, 2, 2, 1, 1]","['circular', 'postagen']","[1, 1]",15,2,17,0
7923,"[]","[]","['abencoar', 'enderecar', 'menino']","[1, 1, 1]",0,3,3,0
7925,"[]","[]","['enfim', 'enfim', 'menino']","[2, 2, 1]",0,3,3,0
7926,"['infraestrutura', 'infraestrutura', 'previsao']","[2, 2, 1]","['enganir', 'insinuar', 'insinuar']","[1, 2, 2]",3,3,6,0
7929,"[]","[]","[]","[]",0,0,0,0
7930,"['administrativo', 'processo', 'taxar']","[1, 1, 1]","['atribuir', 'circular', 'inscricao']","[1, 1, 1]",3,3,6,0
7932,"['aprovacao', 'economia', 'globonew', 'gued', 'gued', 'impactar', 'pagamento', 'regiao', 'vulneravel']","[1, 1, 1, 2, 2, 1, 1, 1, 1]","['circular', 'imagem', 'manchet', 'nordestino', 'nordestino']","[1, 1, 1, 2, 2]",9,5,14,0
7933,"['autoridad', 'planar', 'projeco']","[1, 1, 1]","['escravo', 'humanar']","[1, 1]",3,2,5,0
7934,"['demrj', 'desafiar', 'republico', 'republico']","[1, 1, 2, 2]","['imagem']","[1]",4,1,5,0
7935,"[]","[]","['inocentar', 'protestar', 'soltar']","[1, 1, 1]",0,3,3,0
7936,"['avancar']","[1]","['agredir']","[1]",1,1,2,0
7938,"['aprovacao', 'condicao', 'deltan', 'republico']","[1, 1, 1, 1]","['atribuir', 'atribuir', 'circular']","[2, 2, 1]",4,3,7,0
7942,"[]","[]","['atribuir', 'circular', 'imagem', 'imagem', 'imagem', 'legendar', 'parir', 'realment']","[1, 1, 3, 3, 3, 1, 1, 1]",0,8,8,0
7943,"['parceiro', 'renata', 'renata']","[1, 2, 2]","['bonner', 'lixar', 'sacar']","[1, 1, 1]",3,3,6,0
7946,"['deltan', 'intenso', 'intenso', 'possibilidad']","[1, 2, 2, 1]","['compartilhar', 'compartilhar', 'postagen']","[2, 2, 1]",4,3,7,0
7949,"[]","[]","['espalhar']","[1]",0,1,1,0
7950,"['regiao', 'transferir']","[1, 1]","['checar', 'circular']","[1, 1]",2,2,4,0
7951,"['contribuicao', 'desgastar', 'exercicio', 'minimizar', 'pratico', 'regrar']","[1, 1, 1, 1, 1, 1]","['anoso', 'compartilhar']","[1, 1]",6,2,8,0
7953,"['constituicao', 'legislativo', 'oliveira', 'opcao', 'pratico', 'prever', 'proposto', 'republico']","[1, 1, 1, 1, 1, 1, 1, 1]","['gravacao', 'gravacao']","[2, 2]",8,2,10,0
7957,"['companhia', 'desenvolvimento', 'importancia', 'martim', 'martim', 'rocha']","[1, 1, 1, 2, 2, 1]","['circular', 'circular', 'legendar']","[2, 2, 1]",6,3,9,0
7958,"['client', 'federar']","[1, 1]","['circular', 'gasolina', 'gasolina']","[1, 2, 2]",2,3,5,0
7960,"['quedo', 'recordar']","[1, 1]","['enganir']","[1]",2,1,3,0
7961,"['preservacao', 'recebido']","[1, 1]","['circular', 'compartilhar', 'fotografia', 'imagem', 'interaco', 'legendar', 'postagen', 'viralizada']","[1, 1, 1, 1, 1, 1, 1, 1]",2,8,10,0
7967,"['mexico', 'souza']","[1, 1]","['humanar', 'imagem', 'legendar', 'reverso']","[1, 1, 1, 1]",2,4,6,0
7972,"['epidemiar', 'epidemiar', 'prever', 'prever', 'taxar']","[2, 2, 2, 2, 1]","[]","[]",5,0,5,0
7973,"['araujo', 'saudar']","[1, 1]","['parir']","[1]",2,1,3,0
7974,"['inquerito']","[1]","['verificar']","[1]",1,1,2,0
7975,"[]","[]","['menino', 'vc']","[1, 1]",0,2,2,0
7978,"['investigacao', 'rigoroso']","[1, 1]","['carrefour', 'carrefour', 'carrefour', 'carrefour', 'espancar']","[4, 4, 4, 4, 1]",2,5,7,0
7980,"[]","[]","[]","[]",0,0,0,0
7981,"[]","[]","['soltar', 'soltar', 'soltar', 'soltar']","[4, 4, 4, 4]",0,4,4,0
7982,"['constituicao', 'cupula', 'edson', 'movimentacao', 'reuniao']","[1, 1, 1, 1, 1]","['realment', 'vagabundar']","[1, 1]",5,2,7,0
7983,"['decisao', 'funcao', 'jurista', 'supremo']","[1, 1, 1, 1]","['visualizacao']","[1]",4,1,5,0
7984,"[]","[]","['cedula', 'cedula', 'circular', 'imagem', 'legendar', 'sacar']","[2, 2, 1, 1, 1, 1]",0,6,6,0
7985,"['autoridad', 'gripezinha', 'quarentenar', 'rotina', 'saudar']","[1, 1, 1, 1, 1]","['assassinar', 'parir', 'pego']","[1, 1, 1]",5,3,8,0
7987,"['infectar', 'infectar']","[2, 2]","['parir', 'vezar']","[1, 1]",2,2,4,0
7988,"[]","[]","['imagem']","[1]",0,1,1,0
7989,"['domingo']","[1]","['amplament', 'cartaz', 'compartilhar']","[1, 1, 1]",1,3,4,0
7990,"['internar']","[1]","['circular', 'imagem']","[1, 1]",1,2,3,0
7994,"['superar']","[1]","['rosario', 'rosario', 'rosario', 'rosario', 'vc']","[4, 4, 4, 4, 1]",1,5,6,0
7996,"[]","[]","[]","[]",0,0,0,0
7998,"['internar']","[1]","['compartilhar', 'compartilhar', 'parir', 'parir', 'pelar']","[2, 2, 2, 2, 1]",1,5,6,0
8000,"[]","[]","[]","[]",0,0,0,0
8002,"[]","[]","['espalhar', 'imagem']","[1, 1]",0,2,2,0
8005,"['saudar']","[1]","[]","[]",1,0,1,0
8006,"['adotada', 'decisao', 'decisao', 'republico', 'restritivo', 'saudar']","[1, 2, 2, 1, 1, 1]","['circular', 'imagem', 'imagem', 'legendar']","[1, 2, 2, 1]",6,4,10,0
8007,"['avancar']","[1]","[]","[]",1,0,1,0
8008,"[]","[]","[]","[]",0,0,0,0
8009,"[]","[]","['copiar', 'disseminar', 'enfim', 'ganhar', 'usuario']","[1, 1, 1, 1, 1]",0,5,5,0
8013,"['jantar']","[1]","[]","[]",1,0,1,0
8015,"['saudar', 'visitant']","[1, 1]","['atribuir', 'circular']","[1, 1]",2,2,4,0
8016,"['congresso']","[1]","['pelar']","[1]",1,1,2,0
8017,"['afiar', 'articulacao', 'assintomatico', 'cepa', 'periodo', 'regiao', 'respiratorio', 'taxar']","[1, 1, 1, 1, 1, 1, 1, 1]","['espalhar', 'espalhar', 'nasal', 'parir', 'parir', 'parir', 'pelar', 'vezar', 'vezar']","[2, 2, 1, 3, 3, 3, 1, 2, 2]",8,9,17,0
8021,"['epidemiar', 'equipamento', 'estrategia', 'estrategia', 'voo']","[1, 1, 2, 2, 1]","['espalhar']","[1]",5,1,6,0
8023,"['geraldo']","[1]","['chorar', 'motorista']","[1, 1]",1,2,3,0
8024,"['cirurgico', 'definitivo', 'escalar']","[1, 1, 1]","['circular', 'compartilhar', 'compartilhar', 'compartilhar', 'imagem', 'imagem', 'usuario']","[1, 3, 3, 3, 2, 2, 1]",3,7,10,0
8025,"[]","[]","['compartilhar', 'humanar']","[1, 1]",0,2,2,0
8027,"['biliao', 'instituto', 'planar']","[1, 1, 1]","['dorio', 'dorio', 'dorio', 'enganar', 'ganhar', 'ganhar', 'ganhar', 'ganhar', 'ganhar', 'safar']","[3, 3, 3, 1, 5, 5, 5, 5, 5, 1]",3,10,13,0
8028,"[]","[]","['tumulo']","[1]",0,1,1,0
8029,"['cenario', 'cenario', 'importancia', 'infectar', 'infectar', 'infectar', 'possibilidad']","[2, 2, 1, 3, 3, 3, 1]","['imagem', 'imagem', 'viralizado']","[2, 2, 1]",7,3,10,0
8031,"['periodo', 'preventivo']","[1, 1]","[]","[]",2,0,2,0
8033,"['investigacao', 'rigoroso']","[1, 1]","['amigar', 'trafico']","[1, 1]",2,2,4,0
8036,"['adesao', 'desenvolvimento', 'logistico']","[1, 1, 1]","[]","[]",3,0,3,0
8038,"['passageiro', 'passageiro']","[2, 2]","[]","[]",2,0,2,0
8047,"[]","[]","[]","[]",0,0,0,0
8048,"['realizacao', 'republico']","[1, 1]","['parir', 'sobrar', 'versao', 'versao', 'versao']","[1, 1, 3, 3, 3]",2,5,7,0
8050,"['bolsonarista', 'henriqu', 'mello']","[1, 1, 1]","['checagem', 'lupa', 'lupa', 'lupa']","[1, 3, 3, 3]",3,4,7,0
8051,"['andrea', 'andrea', 'estimular', 'jorg', 'sessao', 'sessao', 'turistico']","[2, 2, 1, 1, 2, 2, 1]","['casamentar', 'circular']","[1, 1]",7,2,9,0
8052,"['absoluto', 'client']","[1, 1]","['compartilhar', 'imagem', 'imagem', 'parir', 'telegram', 'vezar', 'visualizar']","[1, 2, 2, 1, 1, 1, 1]",2,7,9,0
8053,"['hospitalizacao', 'hospitalizacao', 'mexico', 'reducao', 'saudar', 'significativo']","[2, 2, 1, 1, 1, 1]","['compartilhar', 'intitular']","[1, 1]",6,2,8,0
8054,"['dosar']","[1]","['interaco', 'pelar', 'postagen', 'segundar']","[1, 1, 1, 1]",1,4,5,0
8057,"[]","[]","['auditoria', 'auditoria', 'fraudar', 'verificacao']","[2, 2, 1, 1]",0,4,4,0
8059,"[]","[]","['parir', 'parir']","[2, 2]",0,2,2,0
8060,"[]","[]","['efarsa', 'enfim', 'vazar', 'verdadeiro']","[1, 1, 1, 1]",0,4,4,0
8062,"['alteracao', 'anticorpo', 'especifico', 'moderno']","[1, 1, 1, 1]","[]","[]",4,0,4,0
8064,"['consolidar', 'desenvolvimento', 'respostar', 'saudar', 'transmissao', 'transmissao']","[1, 1, 1, 1, 2, 2]","[]","[]",6,0,6,0
8065,"[]","[]","[]","[]",0,0,0,0
8074,"['circulacao', 'implementar', 'saudar']","[1, 1, 1]","[]","[]",3,0,3,0
8076,"['facilitar', 'instituto']","[1, 1]","['circular', 'disseminar', 'ganhar']","[1, 1, 1]",2,3,5,0
8079,"['anticorpo', 'anvisa', 'anvisa']","[1, 2, 2]","[]","[]",3,0,3,0
8081,"['adversario', 'governista', 'movimentacao', 'sabado', 'sabado']","[1, 1, 1, 2, 2]","['compartilhar', 'compartilhar', 'enganoso', 'imagem', 'imagem', 'imagem', 'interaco', 'parir', 'pelar', 'pelar', 'protestar', 'vazio']","[2, 2, 1, 3, 3, 3, 1, 1, 2, 2, 1, 1]",5,12,17,0
8082,"['infectar', 'infectar', 'suspeito', 'temor']","[2, 2, 1, 1]","[]","[]",4,0,4,0
8083,"['congresso', 'fux', 'fux', 'integro', 'julgamento', 'julgamento', 'ministrar', 'ministrar', 'mudanca', 'republico']","[1, 2, 2, 1, 2, 2, 2, 2, 1, 1]","[]","[]",10,0,10,0
8084,"['comparacao', 'economia', 'viagem', 'viagem']","[1, 1, 2, 2]","['circular', 'enganoso', 'manchet']","[1, 1, 1]",4,3,7,0
8085,"[]","[]","[]","[]",0,0,0,0
8088,"['previsao']","[1]","['barragem', 'barragem', 'circular', 'imagem', 'realment']","[2, 2, 1, 1, 1]",1,5,6,0
8089,"['antonio', 'fundacao', 'ministrar', 'queixar', 'tcu']","[1, 1, 1, 1, 1]","['agredir', 'agredir']","[2, 2]",5,2,7,0
8090,"[]","[]","[]","[]",0,0,0,0
8092,"[]","[]","['amplament', 'circular', 'compartilhar', 'imagem']","[1, 1, 1, 1]",0,4,4,0
8093,"['globonew', 'monitoramento', 'periodo', 'suspeito']","[1, 1, 1, 1]","['cbn', 'compartilhar', 'disseminar', 'falsar', 'verificar']","[1, 1, 1, 1, 1]",4,5,9,0
8097,"['client', 'posicionamento', 'saudar']","[1, 1, 1]","[]","[]",3,0,3,0
8101,"[]","[]","['clicar', 'clicar', 'imagem', 'imagem', 'vc']","[2, 2, 2, 2, 1]",0,5,5,0
8102,"['desenvolvido']","[1]","['checar']","[1]",1,1,2,0
8103,"['desenvolvido']","[1]","['checar']","[1]",1,1,2,0
8104,"['regrar', 'respostar']","[1, 1]","['carrefour', 'carrefour', 'clicar', 'clicar', 'compartilhar', 'compartilhar', 'enderecar', 'ganhar', 'ganhar', 'ganhar', 'ganhar', 'instrucao', 'macho', 'minutar', 'parabem', 'parabem', 'reivindicar', 'selecionar', 'sortir', 'sortir', 'usuario', 'usuario', 'vazio']","[2, 2, 2, 2, 2, 2, 1, 4, 4, 4, 4, 1, 1, 1, 2, 2, 1, 1, 2, 2, 2, 2, 1]",2,23,25,0
8107,"['habito']","[1]","['circular', 'filmar', 'pelar']","[1, 1, 1]",1,3,4,0
8108,"['biliao', 'fundacao', 'ministrar', 'saudar']","[1, 1, 1, 1]","['assinalar', 'circular', 'postagen']","[1, 1, 1]",4,3,7,0
8110,"[]","[]","['acidentar', 'desfilar', 'pelar']","[1, 1, 1]",0,3,3,0
8114,"[]","[]","['circular', 'sobrar']","[1, 1]",0,2,2,0
8115,"['afp']","[1]","['carrefour', 'carrefour', 'checagem', 'circular', 'desmentir', 'filmar', 'imagem', 'imagem', 'legendar', 'reverso']","[2, 2, 1, 1, 1, 1, 2, 2, 1, 1]",1,10,11,0
8116,"[]","[]","['chorar', 'chorar', 'chorar', 'circular', 'rouanet', 'rouanet']","[3, 3, 3, 1, 2, 2]",0,6,6,0
8117,"['adulto']","[1]","['circular', 'compartilhar', 'idioma', 'ilustrar', 'manchet', 'postagen', 'telegram']","[1, 1, 1, 1, 1, 1, 1]",1,7,8,0
8118,"['autoridad']","[1]","['circular', 'equador', 'legendar']","[1, 1, 1]",1,3,4,0
8119,"['fluminens', 'funcao', 'interrupcao', 'rotina', 'saudar']","[1, 1, 1, 1, 1]","['circular']","[1]",5,1,6,0
8120,"['acordo', 'administrativo', 'antonio', 'antonio', 'aurelio', 'aurelio', 'balancar', 'biliao', 'contrato', 'contrato', 'contrato', 'contrato', 'contrato', 'fluxo', 'fux', 'ideologico', 'improbidad', 'improbidad', 'inquerito', 'jorg', 'justicar', 'justicar', 'lewandowski', 'marinhar', 'ministrar', 'ministrar', 'ministrar', 'ministrar', 'movimentacao', 'onerar', 'pereira', 'pereira', 'plenario', 'processo', 'processo', 'processo', 'processo', 'queiroz', 'queixar', 'recurso', 'recurso', 'recurso', 'regiao', 'supremo', 'supremo', 'supremo', 'supremo', 'supremo', 'tesourar', 'transicao']","[1, 1, 2, 2, 2, 2, 1, 1, 5, 5, 5, 5, 5, 1, 1, 1, 2, 2, 1, 1, 2, 2, 1, 1, 4, 4, 4, 4, 1, 1, 2, 2, 1, 4, 4, 4, 4, 1, 1, 3, 3, 3, 1, 5, 5, 5, 5, 5, 1, 1]","['arquivar', 'arquivar', 'arquivar', 'arquivar', 'arquivar', 'arquivar', 'auditoria', 'trafico']","[6, 6, 6, 6, 6, 6, 1, 1]",50,8,58,0
8121,"['coreia', 'infectar', 'mutacao', 'precedent', 'prever', 'propagacao']","[1, 1, 1, 1, 1, 1]","['cartaz', 'compartilhar', 'filmar', 'filmar', 'legendar']","[1, 1, 2, 2, 1]",6,5,11,0
8122,"['rossi', 'situacao']","[1, 1]","['compartilhar', 'compartilhar', 'padrar']","[2, 2, 1]",2,3,5,0
8124,"[]","[]","['checar', 'numericament', 'parir']","[1, 1, 1]",0,3,3,0
8125,"['apreensao', 'rocha']","[1, 1]","['checar', 'numericament', 'pelar']","[1, 1, 1]",2,3,5,0
8126,"[]","[]","['checar', 'numericament', 'sequer']","[1, 1, 1]",0,3,3,0
8127,"[]","[]","['assassinar', 'checar', 'numericament']","[1, 1, 1]",0,3,3,0
8135,"['regiao', 'regiao']","[2, 2]","['realment']","[1]",2,1,3,0
8137,"['cooperacao']","[1]","['imagem', 'imagem', 'imagem', 'reverso', 'viralizado']","[3, 3, 3, 1, 1]",1,5,6,0
8138,"['constituicao', 'dedicar', 'interlocutor', 'planalto', 'possibilidad', 'republico', 'supremo']","[1, 1, 1, 1, 1, 1, 1]","['cartaz', 'circular', 'espalhar']","[1, 1, 1]",7,3,10,0
8140,"['bbc', 'mexico', 'mexico']","[1, 2, 2]","['imagem']","[1]",3,1,4,0
8141,"[]","[]","['circular']","[1]",0,1,1,0
8147,"['autoridad', 'federar']","[1, 1]","['circular', 'compartilhar', 'fraudar', 'fraudar', 'fraudar']","[1, 1, 3, 3, 3]",2,5,7,0
8150,"['epidemiologico', 'exigencia', 'negativar', 'notificar', 'orientacao', 'orientacao', 'pastar', 'reforcar', 'rejeitar', 'respiratorio', 'saudar', 'saudar', 'saudar', 'saudar', 'situacao', 'suspeito', 'vigilancia']","[1, 1, 1, 1, 2, 2, 1, 1, 1, 1, 4, 4, 4, 4, 1, 1, 1]","['disseminar', 'logotipo']","[1, 1]",17,2,19,0
8151,"['anticorpo', 'fase']","[1, 1]","['verificar']","[1]",2,1,3,0
8152,"[]","[]","['assassinar', 'assassinar', 'assassinar', 'maldiz', 'vc', 'vc']","[3, 3, 3, 1, 2, 2]",0,6,6,0
8153,"[]","[]","['fraudar']","[1]",0,1,1,0
8154,"['client', 'companhia', 'companhia', 'companhia', 'companhia', 'companhia', 'complicacao', 'condicao', 'discussao', 'economia', 'saudar', 'situacao', 'voo', 'voo', 'voo']","[1, 5, 5, 5, 5, 5, 1, 1, 1, 1, 1, 1, 3, 3, 3]","['cobaia', 'parir', 'parir', 'parir', 'parir', 'parir', 'pelar', 'quantum', 'sobrar', 'sortir']","[1, 5, 5, 5, 5, 5, 1, 1, 1, 1]",15,10,25,0
8156,"['machadar']","[1]","['compartilhar']","[1]",1,1,2,0
8158,"['prazo']","[1]","[]","[]",1,0,1,0
8160,"[]","[]","[]","[]",0,0,0,0
8162,"['indicador', 'kong', 'proliferacao']","[1, 1, 1]","['circular', 'imagem', 'imagem', 'imagem', 'imagem', 'legendar', 'legendar']","[1, 4, 4, 4, 4, 2, 2]",3,7,10,0
8163,"['acompanhamento', 'decisao', 'legislativo', 'supremo', 'supremo', 'supremo']","[1, 1, 1, 3, 3, 3]","['circular', 'desmentir', 'disseminar', 'imagem']","[1, 1, 1, 1]",6,4,10,0
8166,"['estatistico', 'geografia', 'ibg', 'instituto', 'instituto', 'levantamento', 'sobretudo']","[1, 1, 1, 2, 2, 1, 1]","['interaco']","[1]",7,1,8,0
8167,"[]","[]","[]","[]",0,0,0,0
8169,"['colegio', 'constituicao', 'curso', 'escalar', 'geografia', 'implementar', 'importacao', 'marinhar', 'movimentacao', 'privar', 'privar', 'reportar', 'republico', 'revisar', 'revisar', 'turistico']","[1, 1, 1, 1, 1, 1, 1, 1, 1, 2, 2, 1, 1, 2, 2, 1]","['compartilhar', 'compartilhar', 'compartilhar', 'menino', 'menino', 'sapato', 'socialismo', 'venezuelano', 'venezuelano']","[3, 3, 3, 2, 2, 1, 1, 2, 2]",16,9,25,0
8170,"[]","[]","['checagem', 'circular', 'efarsa']","[1, 1, 1]",0,3,3,0
8176,"['celebrar', 'celebrar', 'celebrar', 'exprefeito', 'necessidad', 'republico']","[3, 3, 3, 1, 1, 1]","['circular', 'disseminar', 'legendar', 'legendar', 'parabem']","[1, 1, 2, 2, 1]",6,5,11,0
8177,"['integrant', 'periodo', 'republico']","[1, 1, 1]","['circular', 'compartilhar']","[1, 1]",3,2,5,0
8178,"['adulto', 'bbc', 'especialment', 'infancia']","[1, 1, 1, 1]","['abusar', 'abusar', 'abusar', 'abusar', 'abusar']","[5, 5, 5, 5, 5]",4,5,9,0
8179,"['saudar']","[1]","['disfarcar']","[1]",1,1,2,0
8183,"['instituto', 'investigacao', 'jorg', 'planar', 'reducao', 'suspenso']","[1, 1, 1, 1, 1, 1]","['circular', 'circular', 'idioma']","[2, 2, 1]",6,3,9,0
8185,"['autoridad', 'consenso', 'defendido', 'estrategia']","[1, 1, 1, 1]","[]","[]",4,0,4,0
8187,"['atendido', 'saudar', 'saudar']","[1, 2, 2]","['circular', 'compartilhar', 'descricao', 'imagem', 'imagem', 'indignacao', 'usuario']","[1, 1, 1, 2, 2, 1, 1]",3,7,10,0
8189,"['mudanca', 'provisorio', 'regrar']","[1, 1, 1]","['compartilhar', 'enganoso', 'misturar', 'verificar']","[1, 1, 1, 1]",3,4,7,0
8192,"['depoimento', 'ventilador']","[1, 1]","[]","[]",2,0,2,0
8193,"['henriqu', 'henriqu', 'henriqu']","[3, 3, 3]","[]","[]",3,0,3,0
8194,"[]","[]","['estranhar']","[1]",0,1,1,0
8195,"[]","[]","['compartilhar', 'gravacao', 'postagen', 'verdadeiro']","[1, 1, 1, 1]",0,4,4,0
8196,"['constituicao']","[1]","['cedula', 'cedula', 'cedula', 'cedula', 'cedula', 'fraudar', 'ganhar']","[5, 5, 5, 5, 5, 1, 1]",1,7,8,0
8200,"['quarentenar', 'situacao']","[1, 1]","['circular', 'compartilhar', 'cristao', 'deitar', 'equador', 'espalhar', 'fotografia', 'imagem', 'legendar', 'postagen', 'reverso']","[1, 1, 1, 1, 1, 1, 1, 1, 1, 1, 1]",2,11,13,0
8201,"['colombio']","[1]","['equador']","[1]",1,1,2,0
8203,"[]","[]","['caixao', 'caixao', 'circular', 'deitar', 'imagem']","[2, 2, 1, 1, 1]",0,5,5,0
8204,"['autoridad', 'converso', 'etapa']","[1, 1, 1]","['atribuir', 'circular', 'falsar', 'imagem', 'telegram', 'telegram', 'telegram', 'verificacao']","[1, 1, 1, 1, 3, 3, 3, 1]",3,8,11,0
8205,"['alteracao', 'comissao', 'comissao', 'demrj', 'implementacao', 'necessario', 'suspensao']","[1, 2, 2, 1, 1, 1, 1]","['amplament', 'cnh', 'compartilhar', 'realment']","[1, 1, 1, 1]",7,4,11,0
8208,"['boletim', 'iniciativo', 'situacao', 'taxar']","[1, 1, 1, 1]","['compartilhar', 'desmaiar', 'ganhar', 'lembres', 'lembres', 'parir', 'parir', 'parir', 'pelar']","[1, 1, 1, 2, 2, 3, 3, 3, 1]",4,9,13,0
8211,"['colaborar']","[1]","['parir']","[1]",1,1,2,0
8214,"[]","[]","['circular', 'compartilhar', 'postagen']","[1, 1, 1]",0,3,3,0
8216,"[]","[]","['cadastramento']","[1]",0,1,1,0
8218,"['crise', 'quarentenar', 'situacao']","[1, 1, 1]","['compartilhar', 'padrar', 'padrar', 'torturar']","[1, 2, 2, 1]",3,4,7,0
8221,"[]","[]","['curioso', 'imenso']","[1, 1]",0,2,2,0
8223,"['roraima']","[1]","['espalhar', 'grupar', 'imagem']","[1, 1, 1]",1,3,4,0
8226,"[]","[]","['cedula', 'cedula', 'circular', 'compartilhar', 'imagem', 'intitular', 'legendar', 'postagen', 'reverso', 'viralizada']","[2, 2, 1, 1, 1, 1, 1, 1, 1, 1]",0,10,10,0
8228,"[]","[]","['circular']","[1]",0,1,1,0
8229,"['aliviar', 'saudar', 'situacao']","[1, 1, 1]","[]","[]",3,0,3,0
8232,"['anvisa', 'anvisa', 'necessario', 'risco']","[2, 2, 1, 1]","[]","[]",4,0,4,0
8236,"['decisao', 'planalto', 'proposto', 'republico']","[1, 1, 1, 1]","['circular', 'compartilhar', 'postagen']","[1, 1, 1]",4,3,7,0
8238,"['propagacao', 'reuniao']","[1, 1]","['checar', 'incendio']","[1, 1]",2,2,4,0
8239,"['consequencia', 'reuniao']","[1, 1]","['checar']","[1]",2,1,3,0
8240,"['comparacao', 'periodo', 'reuniao', 'semestr']","[1, 1, 1, 1]","['checar', 'verificar']","[1, 1]",4,2,6,0
8241,"['contrato', 'pagamento']","[1, 1]","['rouan', 'rouanet']","[1, 1]",2,2,4,0
8243,"['condicao', 'equivalent', 'reflexo']","[1, 1, 1]","['parir']","[1]",3,1,4,0
8246,"['capitar', 'sabado']","[1, 1]","[]","[]",2,0,2,0
8249,"['anvisa', 'instituto', 'lancamento', 'parceria', 'vigilancia']","[1, 1, 1, 1, 1]","['circular', 'compartilhar', 'replicar']","[1, 1, 1]",5,3,8,0
8250,"['belgica', 'desenvolvido', 'desenvolvido', 'investigacao', 'prazo', 'rejeitar', 'situacao', 'temporada']","[1, 2, 2, 1, 1, 1, 1, 1]","['abencoar', 'cobaia', 'humanar']","[1, 1, 1]",8,3,11,0
8251,"['balancar', 'balancar', 'balancar', 'palacio', 'palacio', 'palacio']","[3, 3, 3, 3, 3, 3]","['bandeiro', 'bandeiro', 'bandeiro']","[3, 3, 3]",6,3,9,0
8252,"['decorrencia', 'pastar', 'periodo', 'reuniao', 'viagem']","[1, 1, 1, 1, 1]","['boatar', 'circular', 'circular', 'ganhar', 'tampouco']","[1, 2, 2, 1, 1]",5,5,10,0
8253,"['domingo', 'exministro', 'henriqu', 'integro', 'lancamento', 'ministrar', 'ministrar', 'ministrar', 'saudar', 'supremo', 'supremo']","[1, 1, 1, 1, 1, 3, 3, 3, 1, 2, 2]","['circular', 'filmar', 'legendar']","[1, 1, 1]",11,3,14,0
8255,"[]","[]","['enganir']","[1]",0,1,1,0
8258,"['congresso', 'congresso']","[2, 2]","['circular', 'circular', 'legendar']","[2, 2, 1]",2,3,5,0
8261,"[]","[]","['clicar', 'compartilhar', 'compartilhar', 'instrucao']","[1, 2, 2, 1]",0,4,4,0
8262,"[]","[]","['compartilhar', 'espalhar', 'sobrar']","[1, 1, 1]",0,3,3,0
8263,"['facilitar', 'realizacao', 'saudar']","[1, 1, 1]","['cbn', 'circular', 'misturar', 'viralizado']","[1, 1, 1, 1]",3,4,7,0
8265,"['adotada', 'economia', 'impactar', 'minimizar', 'orientacao']","[1, 1, 1, 1, 1]","[]","[]",5,0,5,0
8267,"[]","[]","[]","[]",0,0,0,0
8268,"[]","[]","[]","[]",0,0,0,0
8270,"[]","[]","['atribuir', 'circular']","[1, 1]",0,2,2,0
8272,"['funcionamento', 'propagacao']","[1, 1]","['compartilhar', 'ganhar', 'invadir', 'privacidad']","[1, 1, 1, 1]",2,4,6,0
8273,"['parceria']","[1]","['efarsa']","[1]",1,1,2,0
8274,"[]","[]","[]","[]",0,0,0,0
8275,"['imunizacao', 'imunizacao', 'instituto', 'justicar', 'processo']","[2, 2, 1, 1, 1]","[]","[]",5,0,5,0
8276,"['crise', 'estrategia', 'funcao', 'quedo']","[1, 1, 1, 1]","['capturar', 'cocaina', 'trafico']","[1, 1, 1]",4,3,7,0
8277,"['folhar', 'folhar', 'necessidad']","[2, 2, 1]","['compartilhar', 'compartilhar', 'crer', 'dorio', 'enfim', 'enganar', 'enganar', 'ganhar', 'ganhar', 'lupa', 'nordestino', 'parir', 'safar', 'vc', 'vc', 'vc', 'vc', 'verdadeiro']","[2, 2, 1, 1, 1, 2, 2, 2, 2, 1, 1, 1, 1, 4, 4, 4, 4, 1]",3,18,21,0
8279,"['biliao', 'biliao', 'biliao', 'biliao', 'destinar']","[4, 4, 4, 4, 1]","['enganoso', 'parir', 'pelar', 'pelar', 'verificar']","[1, 1, 2, 2, 1]",5,5,10,0
8280,"[]","[]","['ganhar', 'sortear', 'versao']","[1, 1, 1]",0,3,3,0
8283,"['apreensao', 'prazo', 'prazo', 'reajustar', 'regrar', 'resolucao', 'vencimento']","[1, 2, 2, 1, 1, 1, 1]","['cnh', 'cnh', 'cnh', 'cnh', 'motorista']","[4, 4, 4, 4, 1]",7,5,12,0
8284,"['estimativo']","[1]","['compartilhar', 'pelar', 'pelar']","[1, 2, 2]",1,3,4,0
8288,"['anuncio']","[1]","['minutar', 'parir', 'vezar']","[1, 1, 1]",1,3,4,0
8290,"['ambientar', 'assistencia', 'assistencia', 'atuacao', 'biliao', 'destinar', 'itamar', 'preservacao', 'preservar', 'recurso', 'regulamentar', 'saudar']","[1, 2, 2, 1, 1, 1, 1, 1, 1, 1, 1, 1]","['gravacao']","[1]",12,1,13,0
8291,"['absoluto', 'afp', 'espanha', 'espanha']","[1, 1, 2, 2]","['compartilhar', 'imagem', 'parir', 'realment', 'segundar', 'verificar']","[1, 1, 1, 1, 1, 1]",4,6,10,0
8292,"['folhar', 'importacao', 'parceria', 'regiao', 'spaulo']","[1, 1, 1, 1, 1]","['atribuir', 'circular', 'circular', 'circular', 'compartilhar', 'gleisi', 'imagem']","[1, 3, 3, 3, 1, 1, 1]",5,7,12,0
8293,"['estimativo', 'estimular']","[1, 1]","['compartilhar', 'sobrar']","[1, 1]",2,2,4,0
8296,"['ministrar', 'presenca', 'supremo']","[1, 1, 1]","['compartilhar', 'postagen', 'visualizacao']","[1, 1, 1]",3,3,6,0
8297,"['extraordinario', 'infectar', 'reuter']","[1, 1, 1]","['circular', 'compartilhar', 'versao']","[1, 1, 1]",3,3,6,0
8300,"['ministrar', 'ministrar']","[2, 2]","['atribuir', 'atribuir', 'circular', 'circular', 'compartilhar', 'parabem']","[2, 2, 2, 2, 1, 1]",2,6,8,0
8304,"['bruto', 'economia', 'economia', 'economia', 'internar', 'pib', 'pib']","[1, 3, 3, 3, 1, 2, 2]","[]","[]",7,0,7,0
8306,"['converso', 'transmissao']","[1, 1]","['compartilhar', 'imagem', 'legendar', 'postagen']","[1, 1, 1, 1]",2,4,6,0
8310,"['ambientar', 'armazenamento', 'especifico', 'surtir']","[1, 1, 1, 1]","['assinalar', 'circular', 'compartilhar', 'postagen', 'tampouco', 'versao', 'viralizado']","[1, 1, 1, 1, 1, 1, 1]",4,7,11,0
8314,"[]","[]","['compartilhar', 'sortir']","[1, 1]",0,2,2,0
8315,"[]","[]","['imagem']","[1]",0,1,1,0
8318,"[]","[]","['circular', 'legendar', 'pelar', 'usuario', 'viralizada']","[1, 1, 1, 1, 1]",0,5,5,0
8319,"[]","[]","['crer', 'sacar']","[1, 1]",0,2,2,0
8321,"[]","[]","['visualizacao']","[1]",0,1,1,0
8323,"[]","[]","['compartilhar', 'fraudar', 'verdadeiro']","[1, 1, 1]",0,3,3,0
8325,"[]","[]","['circular', 'imagem', 'manipular']","[1, 1, 1]",0,3,3,0
8330,"['martim', 'mexico', 'respirador', 'respirador', 'respiratorio', 'subir', 'subir']","[1, 1, 2, 2, 1, 2, 2]","['assinalar', 'circular', 'compartilhar', 'gravacao', 'pego', 'postagen', 'puro', 'versao', 'viralizada', 'viralizado']","[1, 1, 1, 1, 1, 1, 1, 1, 1, 1]",7,10,17,0
8331,"['converso', 'facilitar', 'gabinet', 'gabinet', 'gabinet', 'gabinet', 'gabinet', 'investigacao', 'mexico', 'presenca', 'presenca', 'privilegiar', 'privilegiar', 'suspeito']","[1, 1, 5, 5, 5, 5, 5, 1, 1, 2, 2, 2, 2, 1]","['adelio', 'adelio', 'adelio', 'adelio', 'adelio', 'adelio', 'adelio', 'bispar', 'bispar', 'bispar', 'facada', 'gleisi', 'rosario', 'wylli', 'wylli', 'wylli', 'wylli', 'wylli', 'wylli', 'wylli', 'wylli', 'wylli', 'wylli', 'wylli', 'wylli']","[7, 7, 7, 7, 7, 7, 7, 3, 3, 3, 1, 1, 1, 12, 12, 12, 12, 12, 12, 12, 12, 12, 12, 12, 12]",14,25,39,0
8334,"['antonio', 'epidemiar', 'folhar', 'fundacao', 'vieira']","[1, 1, 1, 1, 1]","['circular', 'limao']","[1, 1]",5,2,7,0
8335,"['avancar', 'avancar', 'situacao']","[2, 2, 1]","['huawei', 'humanar']","[1, 1]",3,2,5,0
8336,"['caxia', 'duqu', 'fluminens', 'fluminens', 'parceria', 'previsto']","[1, 1, 2, 2, 1, 1]","['circular', 'compartilhar', 'gravacao', 'imagem', 'legendar', 'usuario', 'versao']","[1, 1, 1, 1, 1, 1, 1]",6,7,13,0
8341,"['acumular', 'economia', 'positivar', 'saudar']","[1, 1, 1, 1]","['falsar']","[1]",4,1,5,0
8342,"['saudar']","[1]","['amigar', 'estomago']","[1, 1]",1,2,3,0
8343,"['conservacao', 'expansao', 'instituto']","[1, 1, 1]","['circular', 'circular', 'incendio', 'incendio', 'legendar', 'manobrar']","[2, 2, 2, 2, 1, 1]",3,6,9,0
8347,"[]","[]","['fraudar', 'privacidad', 'verificar']","[1, 1, 1]",0,3,3,0
8348,"['constituicao', 'espanha', 'expressar', 'integrant']","[1, 1, 1, 1]","['cocaina']","[1]",4,1,5,0
8349,"[]","[]","['cristao', 'misericordia', 'perdao', 'perdao', 'perdao', 'tumulo', 'verdadeiro']","[1, 1, 3, 3, 3, 1, 1]",0,7,7,0
8350,"['comissao', 'reafirmar']","[1, 1]","['agredir', 'circular']","[1, 1]",2,2,4,0
8352,"['investigacao', 'julgamento', 'metropolitano', 'mudanca', 'regiao']","[1, 1, 1, 1, 1]","['boatar']","[1]",5,1,6,0
8354,"['arrecadar', 'arrecadar', 'arrecadar', 'economia', 'economia', 'necessario', 'sabado']","[3, 3, 3, 2, 2, 1, 1]","['parabem', 'parir', 'parir', 'parir', 'parir', 'pelar', 'versao', 'versao']","[1, 4, 4, 4, 4, 1, 2, 2]",7,8,15,0
8357,"['oliveira']","[1]","['chorar', 'espalhar', 'imagem']","[1, 1, 1]",1,3,4,0
8359,"[]","[]","['basto', 'botao', 'clicar', 'compartilhar', 'compartilhar', 'compartilhar', 'compartilhar', 'enderecar', 'preencher', 'verdadeiro']","[1, 1, 1, 4, 4, 4, 4, 1, 1, 1]",0,10,10,0
8361,"['biliao']","[1]","['imagem', 'imagem', 'mafia', 'mafia', 'mafia', 'mafia', 'mafia', 'mafia', 'mafia', 'mafia', 'mafia', 'mafia', 'mafia', 'mafia', 'mafia', 'mafia', 'mafia', 'parabem']","[2, 2, 15, 15, 15, 15, 15, 15, 15, 15, 15, 15, 15, 15, 15, 15, 15, 1]",1,18,19,0
8365,"['atuacao', 'supremo']","[1, 1]","['manchet']","[1]",2,1,3,0
8370,"['desenvolvimento', 'instituto', 'parceria']","[1, 1, 1]","['bandeiro', 'circular', 'fotografia', 'legendar', 'postagen']","[1, 1, 1, 1, 1]",3,5,8,0
8372,"['periodo']","[1]","['verificar']","[1]",1,1,2,0
8373,"['client', 'dosar']","[1, 1]","[]","[]",2,0,2,0
8374,"['apreensao']","[1]","[]","[]",1,0,1,0
8375,"[]","[]","['espalhar']","[1]",0,1,1,0
8376,"['alteracao', 'republico']","[1, 1]","['bandeiro', 'bandeiro', 'bandeiro', 'bandeiro', 'circular', 'dorio', 'dorio', 'fotografia', 'fotografia', 'legendar', 'postagen', 'safar']","[4, 4, 4, 4, 1, 2, 2, 2, 2, 1, 1, 1]",2,12,14,0
8377,"['curvo']","[1]","['arquivar', 'circular', 'desligar']","[1, 1, 1]",1,3,4,0
8379,"['painel', 'prever', 'surtir', 'surtir']","[1, 1, 2, 2]","['circular', 'imagem', 'imagem', 'imagem', 'manipular']","[1, 3, 3, 3, 1]",4,5,9,0
8380,"['adulto', 'especialment', 'implementar', 'observar', 'percepcao', 'saudar', 'saudar']","[1, 1, 1, 1, 1, 2, 2]","['realment']","[1]",7,1,8,0
8382,"['desenvolvimento', 'estagio', 'etapa', 'fase', 'infectar', 'saudar']","[1, 1, 1, 1, 1, 1]","[]","[]",6,0,6,0
8383,"[]","[]","[]","[]",0,0,0,0
8386,"[]","[]","['descricao']","[1]",0,1,1,0
8388,"[]","[]","['atirar']","[1]",0,1,1,0
8390,"[]","[]","['checar', 'numericament']","[1, 1]",0,2,2,0
8391,"['celso']","[1]","['checar', 'numericament']","[1, 1]",1,2,3,0
8392,"['celso']","[1]","['checar', 'numericament']","[1, 1]",1,2,3,0
8393,"['celso']","[1]","['checar', 'numericament', 'parir']","[1, 1, 1]",1,3,4,0
8394,"['celso']","[1]","['checar', 'numericament', 'parir']","[1, 1, 1]",1,3,4,0
8395,"['adversario']","[1]","['checar', 'numericament']","[1, 1]",1,2,3,0
8396,"['companhia', 'redondo']","[1, 1]","['checar', 'greve', 'numericament', 'parir']","[1, 1, 1, 1]",2,4,6,0
8397,"[]","[]","['checar', 'numericament']","[1, 1]",0,2,2,0
8398,"[]","[]","['checar', 'numericament', 'parir']","[1, 1, 1]",0,3,3,0
8400,"[]","[]","['drone', 'drone', 'drone', 'drone', 'drone', 'drone', 'imagem', 'missil']","[6, 6, 6, 6, 6, 6, 1, 1]",0,8,8,0
8402,"[]","[]","['camisa', 'espalhar', 'parir']","[1, 1, 1]",0,3,3,0
8403,"['feriar', 'privilegiar', 'situacao']","[1, 1, 1]","['boatar', 'boicotar', 'escravo', 'escravo', 'ganhar', 'trafico']","[1, 1, 2, 2, 1, 1]",3,6,9,0
8405,"[]","[]","[]","[]",0,0,0,0
8408,"['consenso', 'decisao', 'saudar', 'saudar']","[1, 1, 2, 2]","['abortar', 'abortar', 'abortar', 'basto', 'enganar', 'manipulacao', 'sequer']","[3, 3, 3, 1, 1, 1, 1]",4,7,11,0
8412,"['crise', 'intubacao', 'necessario', 'normalidad', 'ritmar', 'saudar', 'ventilacao', 'ventilacao']","[1, 1, 1, 1, 1, 1, 2, 2]","['compartilhar', 'copiar', 'garganta', 'instrucao', 'lembres']","[1, 1, 1, 1, 1]",8,5,13,0
8414,"[]","[]","['compartilhar', 'desmentir', 'espalhar']","[1, 1, 1]",0,3,3,0
8415,"['espanha']","[1]","['circular', 'cocaina', 'usuario', 'viralizado']","[1, 1, 1, 1]",1,4,5,0
8417,"['impactar']","[1]","['transposicao']","[1]",1,1,2,0
8421,"['congresso', 'sessao']","[1, 1]","['circular', 'compartilhar', 'ilustrar', 'invadir', 'postagen']","[1, 1, 1, 1, 1]",2,5,7,0
8423,"['assistencia', 'assistencia', 'decorrencia', 'estatistico', 'internar', 'respiratorio', 'saudar', 'saudar']","[2, 2, 1, 1, 1, 1, 2, 2]","['compartilhar', 'fraudar', 'fraudar', 'imagem', 'imagem']","[1, 2, 2, 2, 2]",8,5,13,0
8424,"[]","[]","['realment']","[1]",0,1,1,0
8425,"[]","[]","['disseminar', 'ganhar', 'usuario']","[1, 1, 1]",0,3,3,0
8426,"['aplicacao', 'desenvolvido', 'fase', 'imunizacao', 'infectar', 'instituto', 'parceria', 'respostar']","[1, 1, 1, 1, 1, 1, 1, 1]","['abortar', 'abortar', 'amplament', 'replicar', 'viralizado']","[2, 2, 1, 1, 1]",8,5,13,0
8428,"[]","[]","['compartilhar']","[1]",0,1,1,0
8429,"['passageiro']","[1]","['drone', 'drone', 'drone', 'drone', 'drone', 'filmar']","[5, 5, 5, 5, 5, 1]",1,6,7,0
8430,"['associacao', 'infectar', 'metropolitano', 'toquio']","[1, 1, 1, 1]","['compartilhar', 'parir', 'pelar']","[1, 1, 1]",4,3,7,0
8431,"['domingo', 'domingo']","[2, 2]","[]","[]",2,0,2,0
8433,"['acompanhamento', 'margem', 'periodo', 'periodo', 'pratico', 'previsto', 'previsto', 'prioritario', 'realizacao']","[1, 1, 2, 2, 1, 2, 2, 1, 1]","['circular', 'filmar', 'imagem', 'incendio', 'incendio', 'incendio', 'legendar', 'sacar']","[1, 1, 1, 3, 3, 3, 1, 1]",9,8,17,0
8435,"['fachin', 'pacheco', 'sentenca']","[1, 1, 1]","['rosario', 'soltar', 'soltura', 'versao', 'versao', 'versao']","[1, 1, 1, 3, 3, 3]",3,6,9,0
8436,"['contrato', 'contrato', 'esquema', 'justicar', 'justicar', 'lavagem', 'pagamento']","[2, 2, 1, 2, 2, 1, 1]","['secreto']","[1]",7,1,8,0
8437,"[]","[]","['realment']","[1]",0,1,1,0
8441,"['adicionar', 'autoridad', 'justificativo', 'pratico', 'privar']","[1, 1, 1, 1, 1]","['cbn', 'circular', 'circular']","[1, 2, 2]",5,3,8,0
8442,"['internar']","[1]","['circular', 'desmentir', 'falsar', 'imagem', 'pelar']","[1, 1, 1, 1, 1]",1,5,6,0
8443,"[]","[]","['copiar', 'invadir']","[1, 1]",0,2,2,0
8445,"['elaborar', 'fase', 'fase', 'saudar']","[1, 2, 2, 1]","['atribuir']","[1]",4,1,5,0
8449,"['economia', 'regiao', 'viagem']","[1, 1, 1]","['ganhar', 'humanar', 'mansao', 'sapato']","[1, 1, 1, 1]",3,4,7,0
8456,"['cenario']","[1]","['bandeiro', 'bandeiro', 'bandeiro', 'bandeiro', 'cristao', 'versao', 'versao', 'versao']","[4, 4, 4, 4, 1, 3, 3, 3]",1,8,9,0
8459,"['mantido']","[1]","['atribuir', 'compartilhar', 'pelar', 'pelar', 'segundar', 'sequer', 'supostament']","[1, 1, 2, 2, 1, 1, 1]",1,7,8,0
8462,"['apurar']","[1]","['versao', 'versao', 'versao']","[3, 3, 3]",1,3,4,0
8463,"['autorizacao', 'funcionamento', 'queixar']","[1, 1, 1]","['compartilhar', 'compartilhar', 'compartilhar', 'usuario']","[3, 3, 3, 1]",3,4,7,0
8465,"['intubacao']","[1]","['sobrar']","[1]",1,1,2,0
8466,"['atrasar', 'atrasar', 'atrasar', 'atrasar', 'biliao', 'consequencia', 'equipamento', 'escalar', 'esquema', 'justificativo', 'periodo', 'saudar', 'saudar', 'saudar', 'semestr', 'significativo']","[4, 4, 4, 4, 1, 1, 1, 1, 1, 1, 1, 3, 3, 3, 1, 1]","['adorar', 'boicotar', 'boicotar', 'chorar', 'desmentir', 'estranhar', 'soltar']","[1, 2, 2, 1, 1, 1, 1]",16,7,23,0
8467,"['equipamento', 'favorito']","[1, 1]","['clicar', 'clicar', 'compartilhar', 'compartilhar', 'ganhar', 'ganhar', 'instrucao', 'parabem', 'preencher']","[2, 2, 2, 2, 2, 2, 1, 1, 1]",2,9,11,0
8468,"['santiago']","[1]","['basto', 'circular', 'imagem', 'imagem', 'imagem', 'imagem', 'reverso']","[1, 1, 4, 4, 4, 4, 1]",1,7,8,0
8469,"['afp', 'campino', 'reuter']","[1, 1, 1]","['atribuir', 'carbono', 'carbono', 'checagem', 'circular', 'desmentir', 'dioxido', 'dioxido', 'humanar', 'sacar']","[1, 2, 2, 1, 1, 1, 2, 2, 1, 1]",3,10,13,0
8473,"['acumular']","[1]","[]","[]",1,0,1,0
8474,"['azevedo', 'carat', 'nogueira', 'pereira', 'ribeiro']","[1, 1, 1, 1, 1]","['compartilhar', 'socialismo', 'verdadeiro', 'wagner']","[1, 1, 1, 1]",5,4,9,0
8475,"['desenvolvido', 'prever']","[1, 1]","['atribuir', 'circular', 'espalhar', 'imagem', 'legendar']","[1, 1, 1, 1, 1]",2,5,7,0
8476,"['agravar', 'apostar', 'atrasar', 'barroso', 'barroso', 'colaboracao', 'equilibrio', 'facilitar', 'integrant', 'journal', 'pagamento', 'prorrogacao', 'reuniao', 'situacao', 'taxar']","[1, 1, 1, 2, 2, 1, 1, 1, 1, 1, 1, 1, 1, 1, 1]","['dorio', 'patrocinador']","[1, 1]",15,2,17,0
8477,"['justicar', 'oliveira', 'supremo', 'transferir']","[1, 1, 1, 1]","['arquivar', 'casamentar', 'casamentar', 'casamentar', 'parir', 'parir', 'parir']","[1, 3, 3, 3, 3, 3, 3]",4,7,11,0
8478,"['agravamento', 'respostar', 'restritivo']","[1, 1, 1]","['compartilhar', 'ilustrar', 'imagem', 'imagem', 'imagem', 'usuario']","[1, 1, 3, 3, 3, 1]",3,6,9,0
8479,"['situacao']","[1]","['circular', 'despejar', 'filmar', 'filmar', 'imagem', 'legendar', 'usuario', 'visualizacao']","[1, 1, 2, 2, 1, 1, 1, 1]",1,8,9,0
8480,"[]","[]","['biblia', 'biblia', 'desgracar', 'imagem', 'imagem', 'invadir', 'invadir', 'maldiz', 'parir', 'parir', 'parir', 'parir', 'pelar', 'pelar', 'torturar', 'wylli']","[2, 2, 1, 2, 2, 2, 2, 1, 4, 4, 4, 4, 2, 2, 1, 1]",0,16,16,0
8482,"['afp']","[1]","['checagem', 'compartilhar', 'replicar', 'versao']","[1, 1, 1, 1]",1,4,5,0
8485,"['necessario']","[1]","['incendio', 'inscricao']","[1, 1]",1,2,3,0
8486,"['reuniao']","[1]","['compartilhar', 'menino', 'menino', 'menino', 'versao', 'versao', 'versao']","[1, 3, 3, 3, 3, 3, 3]",1,7,8,0
8487,"['suprem', 'supremo']","[1, 1]","['amigar', 'espalhar']","[1, 1]",2,2,4,0
8492,"['equipamento', 'equipamento', 'justicar', 'substituicao']","[2, 2, 1, 1]","['gravacao']","[1]",4,1,5,0
8495,"['fabricacao', 'instituto']","[1, 1]","['circular']","[1]",2,1,3,0
8497,"[]","[]","['invadir', 'wylli', 'wylli', 'wylli']","[1, 3, 3, 3]",0,4,4,0
8500,"['distrito', 'observar', 'precaucao']","[1, 1, 1]","['amplament', 'circular', 'circular', 'compartilhar', 'compartilhar', 'gravacao', 'gravacao', 'gravacao', 'postagen', 'visualizar']","[1, 2, 2, 2, 2, 3, 3, 3, 1, 1]",3,10,13,0
8502,"['autoridad', 'desafiar', 'disseminacao', 'economia', 'saudar', 'superar']","[1, 1, 1, 1, 1, 1]","['atribuir', 'circular', 'circular', 'legendar', 'verificar']","[1, 2, 2, 1, 1]",6,5,11,0
8503,"[]","[]","['capturar', 'capturar']","[2, 2]",0,2,2,0
8504,"['apurar']","[1]","[]","[]",1,0,1,0
8506,"['desenvolvimento', 'desenvolvimento', 'necessario', 'necessario', 'presenca', 'respostar', 'respostar']","[2, 2, 2, 2, 1, 2, 2]","['circular', 'lazaro']","[1, 1]",7,2,9,0
8507,"['converso', 'dificultar', 'discussao', 'propagacao', 'restritivo', 'viagem']","[1, 1, 1, 1, 1, 1]","['circular', 'imagem']","[1, 1]",6,2,8,0
8509,"['ampliacao', 'avancar']","[1, 1]","['bandeiro', 'circular', 'imagem', 'imagem', 'imagem', 'legendar', 'legendar', 'protestar']","[1, 1, 3, 3, 3, 2, 2, 1]",2,8,10,0
8511,"['cnj']","[1]","['lazaro']","[1]",1,1,2,0
8512,"[]","[]","['compartilhar', 'realment', 'sobrar']","[1, 1, 1]",0,3,3,0
8513,"[]","[]","[]","[]",0,0,0,0
8519,"['circulacao', 'privar']","[1, 1]","[]","[]",2,0,2,0
8521,"[]","[]","['abortar', 'compartilhar', 'quinzena']","[1, 1, 1]",0,3,3,0
8522,"[]","[]","[]","[]",0,0,0,0
8523,"['elaborar']","[1]","['cbn', 'cbn', 'cbn', 'compartilhar', 'ganhar', 'secreto', 'soltar']","[3, 3, 3, 1, 1, 1, 1]",1,7,8,0
8526,"['autoridad', 'especialment', 'exministro', 'exministro', 'henriqu', 'ministrar', 'ministrar', 'saudar', 'saudar', 'supremo']","[1, 1, 2, 2, 1, 2, 2, 2, 2, 1]","['circular', 'compartilhar', 'imagem', 'supostament']","[1, 1, 1, 1]",10,4,14,0
8527,"['destacar', 'exjuiz', 'justicar', 'ministrar']","[1, 1, 1, 1]","['camiseta', 'camiseta', 'camiseta', 'circular', 'imagem', 'imagem', 'imagem', 'inscricao', 'manipular', 'safar']","[3, 3, 3, 1, 3, 3, 3, 1, 1, 1]",4,10,14,0
8528,"['ministrar']","[1]","[]","[]",1,0,1,0
8533,"['atuacao', 'atuacao', 'domingo', 'periodo', 'processo', 'suportar', 'suspeito', 'treinamento']","[2, 2, 1, 1, 1, 1, 1, 1]","['circular', 'circular', 'venezuelano']","[2, 2, 1]",8,3,11,0
8534,"['realizacao', 'realizacao', 'realizacao', 'realizacao']","[4, 4, 4, 4]","['clicar']","[1]",4,1,5,0
8535,"['especializar', 'folhar', 'sugestao']","[1, 1, 1]","['checagem', 'checagem', 'checagem', 'checagem', 'parir', 'parir', 'parir', 'sobrar']","[4, 4, 4, 4, 3, 3, 3, 1]",3,8,11,0
8538,"['iniciativo']","[1]","['basto', 'basto', 'clicar', 'versao']","[2, 2, 1, 1]",1,4,5,0
8539,"['regiao']","[1]","[]","[]",1,0,1,0
8542,"['regiao']","[1]","['assassinar', 'canadens', 'canadens', 'compartilhar', 'invadir', 'invadir', 'menino']","[1, 2, 2, 1, 2, 2, 1]",1,7,8,0
8543,"[]","[]","[]","[]",0,0,0,0
8545,"['conformar', 'fase', 'viagem']","[1, 1, 1]","['gravacao', 'tampouco']","[1, 1]",3,2,5,0
8546,"['argumentar']","[1]","['humanar', 'humanar', 'idioma', 'intitular', 'narrativo', 'parir', 'parir', 'parir', 'segundar', 'segundar', 'vezar']","[2, 2, 1, 1, 1, 3, 3, 3, 2, 2, 1]",1,11,12,0
8551,"['infancia', 'pslsp', 'reuniao']","[1, 1, 1]","['gretar', 'gretar']","[2, 2]",3,2,5,0
8555,"['bolsonarista', 'estrategia', 'plano']","[1, 1, 1]","['parir', 'verdadeiro']","[1, 1]",3,2,5,0
8557,"['pagamento']","[1]","['circular', 'circular', 'mentiroso']","[2, 2, 1]",1,3,4,0
8560,"[]","[]","['descricao', 'gretar', 'verdadeiro', 'verdadeiro']","[1, 1, 2, 2]",0,4,4,0
8568,"['adotada', 'alternativo', 'concreto', 'discussao', 'epidemiologico', 'estrategia', 'europeu', 'implementacao', 'individuar']","[1, 1, 1, 1, 1, 1, 1, 1, 1]","['pelar', 'pelar', 'postagen', 'usuario']","[2, 2, 1, 1]",9,4,13,0
8569,"[]","[]","[]","[]",0,0,0,0
8571,"['processo']","[1]","['circular', 'compartilhar', 'fraudar', 'imagem', 'imagem', 'reverso', 'viralizada']","[1, 1, 1, 2, 2, 1, 1]",1,7,8,0
8573,"[]","[]","['versao']","[1]",0,1,1,0
8576,"['colombio']","[1]","['circular', 'compartilhar', 'gravacao']","[1, 1, 1]",1,3,4,0
8577,"['internacao']","[1]","['espalhar', 'quinzena']","[1, 1]",1,2,3,0
8582,"[]","[]","['abortar', 'abortar', 'capturar', 'circular', 'compartilhar', 'idioma', 'imagem', 'postagen', 'usuario']","[2, 2, 1, 1, 1, 1, 1, 1, 1]",0,9,9,0
8585,"['apurar', 'irregularidad', 'opcao']","[1, 1, 1]","[]","[]",3,0,3,0
8588,"['folhar']","[1]","['imagem']","[1]",1,1,2,0
8589,"['calendario', 'vetar']","[1, 1]","[]","[]",2,0,2,0
8591,"[]","[]","['compartilhar', 'compartilhar']","[2, 2]",0,2,2,0
8594,"['autoridad', 'disseminacao', 'isolar', 'propagacao', 'saudar']","[1, 1, 1, 1, 1]","['circular', 'circular', 'legendar']","[2, 2, 1]",5,3,8,0
8597,"['alcolumbr', 'alcolumbr']","[2, 2]","['safar']","[1]",2,1,3,0
8600,"['supremo']","[1]","['ideologia', 'ideologia', 'ideologia', 'ideologia', 'menino', 'menino']","[4, 4, 4, 4, 2, 2]",1,6,7,0
8602,"[]","[]","['nordestino']","[1]",0,1,1,0
8605,"['ambientar', 'amplo', 'necessario', 'percepcao', 'reuniao', 'transferencia', 'transferencia', 'transmissao', 'transmissao']","[1, 1, 1, 1, 1, 2, 2, 2, 2]","['minutar', 'minutar']","[2, 2]",9,2,11,0
8606,"['arthur', 'saudar']","[1, 1]","['compartilhar', 'manipular']","[1, 1]",2,2,4,0
8607,"['ambito', 'comparacao', 'periodo']","[1, 1, 1]","['compartilhar', 'descricao', 'imagem', 'imagem']","[1, 1, 2, 2]",3,4,7,0
8609,"['cometido']","[1]","[]","[]",1,0,1,0
8610,"['constituicao', 'emendar', 'possibilidad', 'proposto', 'tramitacao']","[1, 1, 1, 1, 1]","[]","[]",5,0,5,0
8613,"['prtb']","[1]","['atribuir', 'atribuir', 'boatar', 'circular', 'compartilhar', 'desmentir', 'imagem', 'legendar', 'logotipo']","[2, 2, 1, 1, 1, 1, 1, 1, 1]",1,9,10,0
8617,"['estabilidad', 'ministrar', 'ministrar', 'supremo']","[1, 2, 2, 1]","['espalhar']","[1]",4,1,5,0
8618,"['parceria', 'realizacao']","[1, 1]","[]","[]",2,0,2,0
8619,"['apurar', 'destacar', 'diagnosticar', 'disseminacao', 'funcao', 'infectar', 'infectar', 'normalment', 'positivar', 'temporariament']","[1, 1, 1, 1, 1, 2, 2, 1, 1, 1]","['circular', 'versao']","[1, 1]",10,2,12,0
8620,"['anvisa', 'bolsonarista', 'enquadrar', 'fase', 'fase', 'mexico']","[1, 1, 1, 2, 2, 1]","['safar']","[1]",6,1,7,0
8622,"['adulto', 'autoridad', 'biliao', 'destacar', 'fase', 'preventivo', 'saudar']","[1, 1, 1, 1, 1, 1, 1]","['circular']","[1]",7,1,8,0
8623,"['cenario']","[1]","['dorio', 'dorio']","[2, 2]",1,2,3,0
8625,"['depoimento']","[1]","[]","[]",1,0,1,0
8628,"['regiao']","[1]","['capturar', 'capturar', 'circular', 'humanar', 'realment']","[2, 2, 1, 1, 1]",1,5,6,0
8632,"['constituicao', 'crise', 'recurso', 'transferencia']","[1, 1, 1, 1]","[]","[]",4,0,4,0
8635,"['augusto', 'compromisso', 'externo', 'florido', 'florido', 'internar', 'internar', 'internar', 'observacao', 'sall']","[1, 1, 1, 2, 2, 3, 3, 3, 1, 1]","['acidentar', 'acidentar', 'mansao']","[2, 2, 1]",10,3,13,0
8640,"[]","[]","[]","[]",0,0,0,0
8641,"['privar', 'provisorio', 'saudar', 'saudar', 'suspenso']","[1, 1, 2, 2, 1]","[]","[]",5,0,5,0
8642,"['instituto', 'souza', 'turma', 'turma', 'turma']","[1, 1, 3, 3, 3]","['ganhar', 'ganhar', 'preencher']","[2, 2, 1]",5,3,8,0
8645,"['aspecto', 'consolidar', 'consolidar', 'preliminar', 'preliminar', 'saudar']","[1, 2, 2, 2, 2, 1]","[]","[]",6,0,6,0
8646,"['autoridad']","[1]","[]","[]",1,0,1,0
8649,"[]","[]","['efarsa', 'realment', 'verdadeiro']","[1, 1, 1]",0,3,3,0
8651,"['domingo', 'hipertensao', 'rossi', 'sabado', 'servidor']","[1, 1, 1, 1, 1]","['circular', 'imagem', 'padrar', 'padrar', 'postagen']","[1, 1, 2, 2, 1]",5,5,10,0
8653,"['respostar']","[1]","['amigar', 'enfim', 'espalhar', 'limao', 'limao', 'limao', 'limao', 'limao', 'pego', 'pego']","[1, 1, 1, 5, 5, 5, 5, 5, 2, 2]",1,10,11,0
8654,"['exministro']","[1]","['amigar', 'chorar', 'compartilhar', 'compartilhar', 'imagem', 'imagem', 'pelar', 'tumulo']","[1, 1, 2, 2, 2, 2, 1, 1]",1,8,9,0
8655,"[]","[]","['compartilhar', 'misericordia']","[1, 1]",0,2,2,0
8659,"['discussao', 'mudanca', 'saudar', 'saudar']","[1, 1, 2, 2]","['circular', 'idioma', 'tampouco']","[1, 1, 1]",4,3,7,0
8660,"['bruto']","[1]","['circular', 'circular', 'despejar', 'imagem', 'imagem', 'legendar', 'postagen', 'venezuelano']","[2, 2, 1, 2, 2, 1, 1, 1]",1,8,9,0
8661,"['associacao', 'associacao', 'crise', 'normalment', 'possibilidad', 'queiroz', 'suspensao']","[2, 2, 1, 1, 1, 1, 1]","['circular', 'imagem']","[1, 1]",7,2,9,0
8662,"['autoridad', 'biliao', 'biliao', 'economia', 'espanha', 'habitant', 'habitant']","[1, 2, 2, 1, 1, 2, 2]","[]","[]",7,0,7,0
8664,"[]","[]","[]","[]",0,0,0,0
8666,"[]","[]","['biblia', 'compartilhar', 'imagem', 'quinzena']","[1, 1, 1, 1]",0,4,4,0
8668,"['carat', 'superar']","[1, 1]","['adelio', 'cristao']","[1, 1]",2,2,4,0
8669,"['araujo', 'araujo', 'ernesto', 'humberto', 'precisao', 'regiao', 'reuniao', 'vespera']","[2, 2, 1, 1, 1, 1, 1, 1]","['captar', 'captar', 'captar', 'imagem', 'incendio', 'incendio']","[3, 3, 3, 1, 2, 2]",8,6,14,0
8670,"[]","[]","['vezar']","[1]",0,1,1,0
8672,"['domingo']","[1]","['circular', 'imagem', 'imagem', 'imagem', 'legendar', 'legendar']","[1, 3, 3, 3, 2, 2]",1,6,7,0
8673,"['aplicacao', 'atrasar', 'circulacao', 'estrategico', 'funcao', 'instituto']","[1, 1, 1, 1, 1, 1]","['cartaz', 'circular']","[1, 1]",6,2,8,0
8674,"['argumentar', 'justicar']","[1, 1]","['assassinar', 'assassinar', 'soltar', 'soltura']","[2, 2, 1, 1]",2,4,6,0
8675,"['destinar', 'respostar']","[1, 1]","['ganhar', 'verificar']","[1, 1]",2,2,4,0
8676,"['companhia', 'companhia', 'companhia', 'destacar', 'metropolitano', 'passageiro', 'recuperacao', 'saneamento', 'saneamento']","[3, 3, 3, 1, 1, 1, 1, 2, 2]","['amplament', 'cbn', 'circular']","[1, 1, 1]",9,3,12,0
8677,"['alteracao', 'decisao', 'descumprir', 'enquadrar', 'exjuiz', 'exjuiz', 'guaruja', 'guaruja', 'julgamento', 'julgamento', 'proferir', 'proferir', 'recurso', 'sessao', 'sessao', 'supremo', 'triplex', 'triplex', 'turma']","[1, 1, 1, 1, 2, 2, 2, 2, 2, 2, 2, 2, 1, 2, 2, 1, 2, 2, 1]","['circular', 'circular']","[2, 2]",19,2,21,0
8678,"[]","[]","['missil', 'missil', 'vagabundar', 'versao', 'versao']","[2, 2, 1, 2, 2]",0,5,5,0
8679,"['inicialment']","[1]","['compartilhar', 'estomago', 'ganhar', 'gravacao', 'legendar', 'visualizar']","[1, 1, 1, 1, 1, 1]",1,6,7,0
8682,"['anvisa', 'autorizacao', 'desenvolvido', 'europeu', 'instituto', 'parceria', 'saudar', 'sigla', 'vigilancia']","[1, 1, 1, 1, 1, 1, 1, 1, 1]","['compartilhar', 'parir', 'parir', 'pelar', 'pelar', 'pelar', 'segundar', 'sobrar']","[1, 2, 2, 3, 3, 3, 1, 1]",9,8,17,0
8685,"['anuncio', 'provisorio', 'vulnerabilidad', 'vulneravel']","[1, 1, 1, 1]","['atribuir', 'cadastramento', 'cadastramento', 'cadastramento', 'circular', 'clicar', 'mencao']","[1, 3, 3, 3, 1, 1, 1]",4,7,11,0
8687,"['alcolumbr', 'alcolumbr', 'reuniao']","[2, 2, 1]","['secreto']","[1]",3,1,4,0
8688,"[]","[]","['compartilhar', 'compartilhar', 'parir', 'sobrar']","[2, 2, 1, 1]",0,4,4,0
8689,"['circulacao', 'companhia', 'exgovernador', 'recurso']","[1, 1, 1, 1]","['boatar', 'transposicao', 'versao']","[1, 1, 1]",4,3,7,0
8692,"['economia', 'ministrar', 'planar']","[1, 1, 1]","['parir', 'vagabundar']","[1, 1]",3,2,5,0
8693,"['autoridad', 'decisao', 'descumprimento', 'imunizacao', 'possibilidad', 'preventivo', 'prever', 'prever', 'prioritario', 'proposto', 'queiroz', 'queiroz', 'regrar', 'saudar', 'saudar']","[1, 1, 1, 1, 1, 1, 2, 2, 1, 1, 2, 2, 1, 2, 2]","['falsar']","[1]",15,1,16,0
8695,"['gued', 'gued', 'gued']","[3, 3, 3]","['sapato', 'sapato', 'sapato']","[3, 3, 3]",3,3,6,0
8696,"['prorrogar']","[1]","['expulsar']","[1]",1,1,2,0
8701,"['folhar', 'folhar', 'reuniao']","[2, 2, 1]","['circular', 'compartilhar', 'imagem', 'imagem', 'parabem', 'usuario', 'viralizada']","[1, 1, 2, 2, 1, 1, 1]",3,7,10,0
8702,"['client', 'companhia', 'companhia', 'companhia', 'companhia', 'companhia', 'complicacao', 'condicao', 'discussao', 'economia', 'saudar', 'situacao', 'voo', 'voo', 'voo']","[1, 5, 5, 5, 5, 5, 1, 1, 1, 1, 1, 1, 3, 3, 3]","['cobaia', 'sortir']","[1, 1]",15,2,17,0
8705,"['consequencia', 'interpretar']","[1, 1]","['invadir', 'vc']","[1, 1]",2,2,4,0
8706,"['folhar', 'milho']","[1, 1]","['lembres', 'misturar', 'misturar', 'vc']","[1, 2, 2, 1]",2,4,6,0
8708,"['comissao', 'depoimento', 'exministro', 'saudar', 'saudar']","[1, 1, 1, 2, 2]","['checar']","[1]",5,1,6,0
8709,"['comissao', 'depoimento', 'exministro', 'saudar', 'saudar']","[1, 1, 1, 2, 2]","['checar', 'pelar']","[1, 1]",5,2,7,0
8710,"['atuacao', 'comissao', 'decisao', 'depoimento', 'exministro', 'possibilidad', 'saudar', 'saudar', 'saudar', 'saudar']","[1, 1, 1, 1, 1, 1, 4, 4, 4, 4]","['checar']","[1]",10,1,11,0
8711,"['comissao', 'crise', 'depoimento', 'exministro', 'saudar', 'saudar', 'saudar']","[1, 1, 1, 1, 3, 3, 3]","['checar', 'parir', 'pelar']","[1, 1, 1]",7,3,10,0
8712,"['comissao', 'depoimento', 'exministro', 'saudar', 'saudar']","[1, 1, 1, 2, 2]","['checar', 'pelar']","[1, 1]",5,2,7,0
8713,"['comissao', 'depoimento', 'exministro', 'saudar', 'saudar']","[1, 1, 1, 2, 2]","['checar']","[1]",5,1,6,0
8714,"['comissao', 'depoimento', 'exministro', 'saudar', 'saudar']","[1, 1, 1, 2, 2]","['checar']","[1]",5,1,6,0
8715,"['comissao', 'depoimento', 'exministro', 'reuniao', 'risco', 'saudar', 'saudar', 'saudar']","[1, 1, 1, 1, 1, 3, 3, 3]","['checar']","[1]",8,1,9,0
8716,"['comissao', 'depoimento', 'exministro', 'saudar', 'saudar']","[1, 1, 1, 2, 2]","['checar']","[1]",5,1,6,0
8721,"['desenvolvimento', 'infectar', 'risco']","[1, 1, 1]","['enganoso', 'imagem', 'inscricao', 'insinuar', 'legendar', 'parir', 'parir']","[1, 1, 1, 1, 1, 2, 2]",3,7,10,0
8722,"['destinar', 'diagnosticar', 'enfrentamento', 'recurso', 'saudar']","[1, 1, 1, 1, 1]","['amigar', 'circular']","[1, 1]",5,2,7,0
8723,"['revisar']","[1]","[]","[]",1,0,1,0
8724,"['internacao', 'quedo', 'saudar']","[1, 1, 1]","['verdadeiro']","[1]",3,1,4,0
8728,"['prazo', 'regrar', 'regrar']","[1, 2, 2]","['compartilhar', 'compartilhar', 'copiar', 'imagem', 'lembres', 'lembres']","[2, 2, 1, 1, 2, 2]",3,6,9,0
8732,"['client', 'client', 'inquerito', 'mendonca']","[2, 2, 1, 1]","['circular', 'secreto']","[1, 1]",4,2,6,0
8736,"['crise', 'decisao', 'economia', 'economia', 'economia', 'economia', 'preocupacao']","[1, 1, 4, 4, 4, 4, 1]","['nobel', 'sobrar']","[1, 1]",7,2,9,0
8737,"['possibilidad', 'viagem']","[1, 1]","['atribuir', 'circular', 'desmentir', 'falsar', 'ganhar', 'gravacao', 'inscricao']","[1, 1, 1, 1, 1, 1, 1]",2,7,9,0
8738,"[]","[]","['basto', 'camisa', 'camiseta', 'enderecar', 'ganhar', 'ganhar', 'preencher']","[1, 1, 1, 1, 2, 2, 1]",0,7,7,0
8739,"['reuniao']","[1]","['circular', 'circular', 'imagem', 'visualizacao']","[2, 2, 1, 1]",1,4,5,0
8740,"['diariament', 'jantar']","[1, 1]","[]","[]",2,0,2,0
8744,"['palacio', 'periferia', 'planalto', 'regiao']","[1, 1, 1, 1]","['imagem', 'menino', 'pego']","[1, 1, 1]",4,3,7,0
8745,"['congresso']","[1]","['compartilhar']","[1]",1,1,2,0
8746,"['reconhecimento']","[1]","[]","[]",1,0,1,0
8747,"['bbc']","[1]","['circular', 'compartilhar', 'idioma', 'indignacao', 'usuario']","[1, 1, 1, 1, 1]",1,5,6,0
8749,"[]","[]","[]","[]",0,0,0,0
8751,"['antecipar', 'funcao', 'previsto']","[1, 1, 1]","['caixao']","[1]",3,1,4,0
8752,"[]","[]","['sequer']","[1]",0,1,1,0
8753,"[]","[]","[]","[]",0,0,0,0
8755,"['ambito', 'balancar']","[1, 1]","['compartilhar', 'pelar', 'pelar']","[1, 2, 2]",2,3,5,0
8757,"['consequencia', 'decisao', 'decisao', 'decisao', 'decorrencia', 'funcao', 'justicar']","[1, 3, 3, 3, 1, 1, 1]","[]","[]",7,0,7,0
8760,"[]","[]","['usuario']","[1]",0,1,1,0
8761,"['proporcao']","[1]","['pelar']","[1]",1,1,2,0
8763,"['afp', 'sputnik']","[1, 1]","['checar', 'circular', 'circular', 'compartilhar', 'imagem', 'imagem', 'imagem', 'reverso', 'verificacao']","[1, 2, 2, 1, 3, 3, 3, 1, 1]",2,9,11,0
8765,"['autorizacao', 'desenvolvido']","[1, 1]","['compartilhar', 'parir', 'parir', 'parir', 'parir']","[1, 4, 4, 4, 4]",2,5,7,0
8768,"['colegio']","[1]","[]","[]",1,0,1,0
8770,"[]","[]","[]","[]",0,0,0,0
8771,"['plantao', 'regiao', 'reuniao', 'suspeito']","[1, 1, 1, 1]","['espalhar', 'espalhar']","[2, 2]",4,2,6,0
8772,"['adicionar', 'adicionar', 'mudanca']","[2, 2, 1]","['circular', 'falsar', 'fraudar', 'usuario']","[1, 1, 1, 1]",3,4,7,0
8779,"['estatistico']","[1]","['desgracar']","[1]",1,1,2,0
8780,"[]","[]","['camiseta', 'camiseta', 'camiseta', 'clicar', 'clicar', 'compartilhar', 'compartilhar', 'enderecar', 'parir', 'parir', 'sapato', 'sapato', 'sapato', 'sapato', 'sapato']","[3, 3, 3, 2, 2, 2, 2, 1, 2, 2, 5, 5, 5, 5, 5]",0,15,15,0
8783,"['condicao', 'saudar', 'saudar']","[1, 2, 2]","['invadir', 'invadir', 'verdadeiro']","[2, 2, 1]",3,3,6,0
8785,"['autoridad', 'investigacao']","[1, 1]","['acidentar', 'catedr', 'incendio', 'incendio', 'parir']","[1, 1, 2, 2, 1]",2,5,7,0
8787,"['competicao', 'esquema', 'exministro', 'inquerito', 'justicar', 'justicar', 'justicar']","[1, 1, 1, 1, 3, 3, 3]","['atribuir', 'boatar', 'circular', 'espalhar']","[1, 1, 1, 1]",7,4,11,0
8793,"[]","[]","[]","[]",0,0,0,0
8796,"[]","[]","['escravo', 'espalhar', 'parir', 'parir', 'parir']","[1, 1, 3, 3, 3]",0,5,5,0
8797,"['piorar']","[1]","[]","[]",1,0,1,0
8800,"[]","[]","['cedula', 'circular', 'compartilhar', 'compartilhar', 'fraudar', 'imagem']","[1, 1, 2, 2, 1, 1]",0,6,6,0
8803,"['instituto', 'instituto', 'instituto', 'parceria', 'testagem']","[3, 3, 3, 1, 1]","['atribuir', 'cbn', 'compartilhar', 'sequer']","[1, 1, 1, 1]",5,4,9,0
8804,"['curvo']","[1]","['arquivar', 'circular']","[1, 1]",1,2,3,0
8805,"['desenvolvido', 'instituto', 'instituto', 'parceria']","[1, 2, 2, 1]","['circular']","[1]",4,1,5,0
8806,"[]","[]","[]","[]",0,0,0,0
8807,"['absoluto']","[1]","['assaltar', 'imagem']","[1, 1]",1,2,3,0
8808,"['saudar']","[1]","['circular', 'enganar', 'imagem']","[1, 1, 1]",1,3,4,0
8810,"['aglomeracao', 'aglomeracao', 'cerimonia', 'demandar', 'flavio', 'flavio', 'humberto', 'situacao']","[2, 2, 1, 1, 2, 2, 1, 1]","['circular', 'imagem', 'imagem', 'legendar']","[1, 2, 2, 1]",8,4,12,0
8812,"['integrant', 'pacheco', 'suportar']","[1, 1, 1]","['adorar', 'indignacao', 'parir', 'parir', 'parir', 'pelar', 'pelar']","[1, 1, 3, 3, 3, 2, 2]",3,7,10,0
8813,"['coordenar', 'forcatarefa', 'risco']","[1, 1, 1]","['insinuar', 'parir']","[1, 1]",3,2,5,0
8823,"['depressao', 'treinamento']","[1, 1]","['parir', 'sobrar']","[1, 1]",2,2,4,0
8824,"['coordenar', 'folhar', 'spaulo', 'spaulo']","[1, 1, 2, 2]","['circular', 'verdadeiro']","[1, 1]",4,2,6,0
8826,"['goncalo', 'passageiro']","[1, 1]","['assaltar', 'assaltar', 'circular', 'motorista', 'usuario', 'versao']","[2, 2, 1, 1, 1, 1]",2,6,8,0
8827,"['equipamento']","[1]","['clicar', 'clicar', 'compartilhar', 'compartilhar', 'huawei', 'huawei', 'huawei', 'huawei', 'instrucao', 'parabem', 'reivindicar', 'sortir']","[2, 2, 2, 2, 4, 4, 4, 4, 1, 1, 1, 1]",1,12,13,0
8829,"[]","[]","['realment']","[1]",0,1,1,0
8832,"['guaruja', 'guaruja', 'saudar', 'saudar', 'saudar', 'saudar', 'saudar', 'saudar', 'saudar', 'saudar', 'saudar', 'saudar']","[2, 2, 10, 10, 10, 10, 10, 10, 10, 10, 10, 10]","['abencoar', 'abencoar', 'compartilhar', 'compartilhar', 'compartilhar', 'compartilhar', 'compartilhar', 'compartilhar', 'compartilhar', 'compartilhar', 'escutar', 'escutar', 'ganhar', 'ganhar']","[2, 2, 8, 8, 8, 8, 8, 8, 8, 8, 2, 2, 2, 2]",12,14,26,0
8834,"[]","[]","['circular']","[1]",0,1,1,0
8835,"['antonio', 'dengu', 'suportar']","[1, 1, 1]","['circular']","[1]",3,1,4,0
8836,"['colaboracao', 'esquema', 'esquema', 'facilitar', 'jorg', 'journal', 'marinhar', 'marinhar', 'oliveira', 'pagamento', 'reuniao']","[1, 2, 2, 1, 1, 1, 2, 2, 1, 1, 1]","['desfilar']","[1]",11,1,12,0
8840,"['decisao', 'decisao', 'determinacao', 'dialogo', 'orientacao']","[2, 2, 1, 1, 1]","['bandeiro', 'bandeiro', 'bandeiro', 'circular', 'legendar', 'sacar']","[3, 3, 3, 1, 1, 1]",5,6,11,0
8842,"[]","[]","['circular', 'imagem', 'quinzena', 'sacar']","[1, 1, 1, 1]",0,4,4,0
8843,"['planar', 'proposto']","[1, 1]","['ganhar', 'ganhar', 'ganhar', 'ganhar', 'vc']","[4, 4, 4, 4, 1]",2,5,7,0
8852,"['conformar', 'orientacao', 'saudar', 'saudar']","[1, 1, 2, 2]","['cbn', 'cbn', 'circular', 'garganta', 'limao', 'limao', 'misturar']","[2, 2, 1, 1, 2, 2, 1]",4,7,11,0
8857,"['congresso', 'congresso', 'congresso']","[3, 3, 3]","['manobrar']","[1]",3,1,4,0
8858,"['respostar']","[1]","['fingir', 'perdao']","[1, 1]",1,2,3,0
8862,"[]","[]","[]","[]",0,0,0,0
8863,"['afp', 'calheiro', 'delacao', 'fachin', 'ministrar']","[1, 1, 1, 1, 1]","['checar', 'compartilhar', 'gleisi', 'gleisi', 'imagem', 'verificacao']","[1, 1, 2, 2, 1, 1]",5,6,11,0
8864,"['circulacao', 'condenacao', 'decisao', 'decisao', 'edson', 'fachin', 'justicar', 'ministrar', 'normalment', 'supremo', 'velocidad']","[1, 1, 2, 2, 1, 1, 1, 1, 1, 1, 1]","['circular', 'circular', 'imagem', 'imagem', 'legendar', 'reverso', 'sequer']","[2, 2, 2, 2, 1, 1, 1]",11,7,18,0
8869,"['fase', 'fase']","[2, 2]","['disseminar']","[1]",2,1,3,0
8870,"[]","[]","['biblia', 'compartilhar', 'imagem', 'imagem', 'parir', 'parir', 'parir', 'parir', 'verdadeiro']","[1, 1, 2, 2, 4, 4, 4, 4, 1]",0,9,9,0
8871,"['fase']","[1]","['enganoso', 'enganoso', 'legendar', 'verificacao']","[2, 2, 1, 1]",1,4,5,0
8879,"['autoridad', 'descumprir', 'orientacao', 'sabado', 'saudar']","[1, 1, 1, 1, 1]","['camisa', 'circular', 'imagem', 'legendar', 'libertador', 'reverso', 'tampouco']","[1, 1, 1, 1, 1, 1, 1]",5,7,12,0
8880,"['journal', 'suspenso']","[1, 1]","['compartilhar', 'estranhar', 'postagen']","[1, 1, 1]",2,3,5,0
8882,"['normalment', 'presenca', 'pulmonar', 'respiratorio']","[1, 1, 1, 1]","['carbono', 'carbono', 'cbn', 'circular', 'dioxido', 'dioxido']","[2, 2, 1, 1, 2, 2]",4,6,10,0
8883,"[]","[]","['maldiz']","[1]",0,1,1,0
8884,"[]","[]","['compartilhar', 'compartilhar', 'vc']","[2, 2, 1]",0,3,3,0
8885,"[]","[]","[]","[]",0,0,0,0
8892,"['especifico', 'internacao']","[1, 1]","['sobrar']","[1]",2,1,3,0
8895,"['conjuntar', 'exministro', 'exministro', 'ministrar', 'supremo']","[1, 2, 2, 1, 1]","['espalhar', 'imagem', 'imagem', 'versao']","[1, 2, 2, 1]",5,4,9,0
8896,"['conjuntar']","[1]","[]","[]",1,0,1,0
8900,"['abordagem']","[1]","['agredir', 'imagem']","[1, 1]",1,2,3,0
8902,"['avancar', 'descumprir', 'reforcar', 'reuniao', 'surtir']","[1, 1, 1, 1, 1]","['compartilhar', 'compartilhar', 'legendar', 'pego', 'postagen', 'supostament', 'usuario']","[2, 2, 1, 1, 1, 1, 1]",5,7,12,0
8905,"['possibilidad']","[1]","['usuario', 'usuario', 'usuario', 'vezar', 'visualizar']","[3, 3, 3, 1, 1]",1,5,6,0
8906,"['comissao', 'observar']","[1, 1]","['cedula', 'circular', 'fraudar', 'legendar', 'mesario']","[1, 1, 1, 1, 1]",2,5,7,0
8911,"['anticorpo', 'anticorpo', 'anticorpo', 'desenvolvido', 'especifico', 'instituto', 'pib', 'positivar', 'positivar']","[3, 3, 3, 1, 1, 1, 1, 2, 2]","['circular', 'enganar', 'insinuar', 'verdadeiro']","[1, 1, 1, 1]",9,4,13,0
8913,"['antecipar', 'condicao', 'crise', 'espirito', 'extensao', 'organizador', 'privar', 'reuniao', 'sabado']","[1, 1, 1, 1, 1, 1, 1, 1, 1]","['abencoar', 'abencoar', 'parir', 'parir', 'parir', 'parir', 'parir', 'parir', 'parir', 'parir', 'quantum', 'sobrar']","[2, 2, 8, 8, 8, 8, 8, 8, 8, 8, 1, 1]",9,12,21,0
8916,"['entendimento', 'mudanca', 'panamericana', 'posicionamento', 'prescricao', 'prescricao', 'saudar', 'saudar']","[1, 1, 1, 1, 2, 2, 2, 2]","['cbn', 'circular']","[1, 1]",8,2,10,0
8918,"[]","[]","['biblia']","[1]",0,1,1,0
8919,"['adotada', 'crise']","[1, 1]","['circular', 'imagem', 'imagem']","[1, 2, 2]",2,3,5,0
8920,"['irregularidad', 'revogar']","[1, 1]","[]","[]",2,0,2,0
8921,"['funcionamento', 'funcionamento']","[2, 2]","[]","[]",2,0,2,0
8923,"['alternativo', 'crise', 'crise', 'equipamento', 'fase', 'intenso']","[1, 2, 2, 1, 1, 1]","['circular', 'filmar', 'imagem', 'imagem']","[1, 1, 2, 2]",6,4,10,0
8931,"['associacao', 'associacao', 'economia', 'prever', 'reuniao']","[2, 2, 1, 1, 1]","['boatar', 'mencao', 'viralizado']","[1, 1, 1]",5,3,8,0
8932,"['economia', 'gued', 'ministrar', 'privar', 'tcu']","[1, 1, 1, 1, 1]","['espalhar', 'fraudar']","[1, 1]",5,2,7,0
8936,"['amplo', 'republico']","[1, 1]","['camisa', 'camisa', 'circular', 'circular', 'compartilhar', 'legendar']","[2, 2, 2, 2, 1, 1]",2,6,8,0
8940,"['agravamento', 'aumento', 'despesa', 'despesa', 'extraordinario', 'justicar', 'levantamento', 'movimentacao', 'periodo']","[1, 1, 2, 2, 1, 1, 1, 1, 1]","['circular', 'motorista', 'realment']","[1, 1, 1]",9,3,12,0
8943,"[]","[]","['circular', 'circular', 'imagem', 'incendio', 'legendar', 'usuario']","[2, 2, 1, 1, 1, 1]",0,6,6,0
8946,"['molecular']","[1]","[]","[]",1,0,1,0
8947,"['destacar', 'moderno', 'resolucao']","[1, 1, 1]","['bandeiro', 'circular', 'fingir', 'fingir', 'fingir', 'imagem', 'legendar', 'legendar', 'manipular']","[1, 1, 3, 3, 3, 1, 2, 2, 1]",3,9,12,0
8948,"[]","[]","[]","[]",0,0,0,0
8952,"['ambientar', 'reforcar', 'situacao', 'ufrj']","[1, 1, 1, 1]","['circular', 'circular', 'imagem', 'legendar']","[2, 2, 1, 1]",4,4,8,0
8953,"['biliao', 'observar', 'presenca']","[1, 1, 1]","['versao']","[1]",3,1,4,0
8955,"[]","[]","['ganhar']","[1]",0,1,1,0
8959,"['epicentro', 'surtir']","[1, 1]","['circular', 'imagem', 'imagem', 'legendar', 'reverso']","[1, 2, 2, 1, 1]",2,5,7,0
8960,"['domingo', 'exercicio', 'realizacao']","[1, 1, 1]","['circular', 'invadir', 'verdadeiro']","[1, 1, 1]",3,3,6,0
8961,"['adotada', 'avancar', 'conflito']","[1, 1, 1]","['circular', 'imagem', 'legendar', 'reverso', 'verificar']","[1, 1, 1, 1, 1]",3,5,8,0
8962,"[]","[]","['enganoso']","[1]",0,1,1,0
8964,"['porqu']","[1]","[]","[]",1,0,1,0
8965,"[]","[]","[]","[]",0,0,0,0
8970,"['flavia']","[1]","[]","[]",1,0,1,0
8972,"[]","[]","['facada']","[1]",0,1,1,0
8975,"['modelo', 'preservar', 'primeiroministro', 'primeiroministro']","[1, 1, 2, 2]","['circular', 'circular', 'desmentir']","[2, 2, 1]",4,3,7,0
8977,"['pagamento']","[1]","['gravacao', 'mencao', 'tampouco']","[1, 1, 1]",1,3,4,0
8979,"['compilar', 'correspondent', 'expectativa', 'inicialment']","[1, 1, 1, 1]","[]","[]",4,0,4,0
8980,"['acumular', 'sabado']","[1, 1]","[]","[]",2,0,2,0
8985,"['anvisa', 'instituto', 'prazo']","[1, 1, 1]","[]","[]",3,0,3,0
8986,"['coordenar', 'desenvolvimento', 'estimular', 'ideologico', 'inovacao', 'ministrar', 'recurso', 'recurso']","[1, 1, 1, 1, 1, 1, 2, 2]","['circular']","[1]",8,1,9,0
8988,"['afp', 'examinar', 'positivar']","[1, 1, 1]","['atribuir', 'boatar', 'circular', 'compartilhar', 'desmentir', 'enderecar', 'postagen', 'verificacao', 'versao']","[1, 1, 1, 1, 1, 1, 1, 1, 1]",3,9,12,0
8989,"['destinar', 'supremo']","[1, 1]","['circular', 'circular']","[2, 2]",2,2,4,0
8991,"['comportamento', 'destacar', 'estrategico']","[1, 1, 1]","['enganoso', 'fraudar', 'narrativo']","[1, 1, 1]",3,3,6,0
8992,"[]","[]","['parir']","[1]",0,1,1,0
8994,"[]","[]","[]","[]",0,0,0,0
8998,"['justicar', 'ministrar', 'ministrar']","[1, 2, 2]","['espalhar', 'parir', 'quinzena']","[1, 1, 1]",3,3,6,0
9002,"['moderno', 'transferir']","[1, 1]","['capturar', 'circular', 'enganar', 'parir', 'sobrar', 'usuario']","[1, 1, 1, 1, 1, 1]",2,6,8,0
9003,"['regiao']","[1]","['imagem', 'incendio', 'pelar', 'sobrar']","[1, 1, 1, 1]",1,4,5,0
9005,"['folhar', 'infectar', 'integrant']","[1, 1, 1]","['circular', 'limao', 'suco', 'suco', 'suco']","[1, 1, 3, 3, 3]",3,5,8,0
9006,"[]","[]","['circular', 'filmar', 'ganhar', 'legendar', 'sacar']","[1, 1, 1, 1, 1]",0,5,5,0
9010,"[]","[]","['espalhar', 'quinzena']","[1, 1]",0,2,2,0
9011,"['estrategia', 'fase', 'recebido']","[1, 1, 1]","['basto', 'compartilhar', 'compartilhar', 'fraudar', 'fraudar', 'fraudar', 'invadir']","[1, 2, 2, 3, 3, 3, 1]",3,7,10,0
9018,"['servidor']","[1]","['usuario', 'usuario', 'usuario', 'usuario']","[4, 4, 4, 4]",1,4,5,0
9019,"[]","[]","['circular', 'ganhar', 'quinzena', 'tampouco']","[1, 1, 1, 1]",0,4,4,0
9021,"['dificuldad', 'respiratorio', 'respiratorio']","[1, 2, 2]","['amplament', 'compartilhar']","[1, 1]",3,2,5,0
9032,"['colombio', 'conjuntar', 'supremo']","[1, 1, 1]","['atirar', 'socialismo']","[1, 1]",3,2,5,0
9033,"['atrasar', 'diariament', 'esforco', 'fase', 'fase', 'fase', 'fase', 'necessario', 'regiao', 'regiao', 'risco', 'saudar', 'saudar', 'saudar', 'saudar', 'taxar']","[1, 1, 1, 4, 4, 4, 4, 1, 2, 2, 1, 4, 4, 4, 4, 1]","['compartilhar', 'enfim', 'garganta', 'garganta', 'garganta', 'garganta', 'limao', 'limao', 'nasal', 'sapato', 'sortir', 'vitaminar', 'vitaminar', 'vitaminar']","[1, 1, 4, 4, 4, 4, 2, 2, 1, 1, 1, 3, 3, 3]",16,14,30,0
9035,"['economia', 'regulamentar']","[1, 1]","['circular', 'compartilhar', 'interaco']","[1, 1, 1]",2,3,5,0
9036,"[]","[]","['espalhar', 'imagem']","[1, 1]",0,2,2,0
9037,"['batalhar', 'economia', 'enxergar', 'milho', 'plantao', 'relaxar']","[1, 1, 1, 1, 1, 1]","['desgracar', 'ganhar', 'parabem']","[1, 1, 1]",6,3,9,0
9039,"['respirador', 'saudar']","[1, 1]","['filmar', 'lazaro']","[1, 1]",2,2,4,0
9042,"['transferencia']","[1]","['vc']","[1]",1,1,2,0
9045,"['recordar']","[1]","['compartilhar', 'parir', 'pelar', 'pelar']","[1, 1, 2, 2]",1,4,5,0
9047,"[]","[]","['checar']","[1]",0,1,1,0
9048,"[]","[]","['checar']","[1]",0,1,1,0
9050,"['folhar']","[1]","['lixar']","[1]",1,1,2,0
9052,"['domingo', 'equipamento', 'respirador', 'respirador', 'respirador', 'respirador', 'respirador', 'respirador', 'respirador', 'ventilacao']","[1, 1, 7, 7, 7, 7, 7, 7, 7, 1]","['pego']","[1]",10,1,11,0
9054,"['saudar', 'saudar', 'saudar']","[3, 3, 3]","[]","[]",3,0,3,0
9055,"['inquerito', 'internar']","[1, 1]","['fraudar', 'pelar', 'pelar']","[1, 2, 2]",2,3,5,0
9056,"['antonio', 'ufrj']","[1, 1]","[]","[]",2,0,2,0
9057,"['apoio', 'conformar', 'sabado']","[1, 1, 1]","[]","[]",3,0,3,0
9058,"['adotada', 'mudanca']","[1, 1]","['auditoria', 'checar', 'fraudar', 'fraudar', 'ganhar', 'pelar', 'pelar', 'segundar']","[1, 1, 2, 2, 1, 2, 2, 1]",2,8,10,0
9061,"[]","[]","[]","[]",0,0,0,0
9064,"['expansao', 'parceiro']","[1, 1]","['numericament']","[1]",2,1,3,0
9065,"[]","[]","['numericament', 'parir']","[1, 1]",0,2,2,0
9066,"['ambito', 'autoridad', 'biliao', 'biliao', 'justicar', 'republico', 'supremo', 'transferencia']","[1, 1, 2, 2, 1, 1, 1, 1]","['enganoso']","[1]",8,1,9,0
9068,"['domingo']","[1]","['compartilhar', 'compartilhar', 'compartilhar']","[3, 3, 3]",1,3,4,0
9075,"['anuncio', 'instituto', 'instituto', 'paralisar', 'parceria', 'saudar', 'suspensao', 'temporario']","[1, 2, 2, 1, 1, 1, 1, 1]","['circular', 'disfarcar']","[1, 1]",8,2,10,0
9079,"['justicar']","[1]","['acidentar', 'assaltar', 'cocaina', 'supostament']","[1, 1, 1, 1]",1,4,5,0
9080,"[]","[]","['enganoso', 'pelar', 'sobrar']","[1, 1, 1]",0,3,3,0
9087,"[]","[]","['circular']","[1]",0,1,1,0
9089,"['desenvolvido', 'opcao', 'pagamento', 'passageiro', 'passageiro', 'pratico', 'viagem']","[1, 1, 1, 2, 2, 1, 1]","['filmar', 'motorista', 'usuario', 'usuario']","[1, 1, 2, 2]",7,4,11,0
9091,"['associacao', 'autoridad', 'crise', 'distant', 'isolar', 'palacio', 'planalto']","[1, 1, 1, 1, 1, 1, 1]","['grupar', 'pelar', 'pelar', 'pelar']","[1, 3, 3, 3]",7,4,11,0
9092,"['heleno']","[1]","['circular', 'imagem', 'imagem', 'incendio', 'legendar', 'reverso']","[1, 2, 2, 1, 1, 1]",1,6,7,0
9094,"['azevedo', 'conformar', 'demandar', 'ministrar', 'necessidad', 'preventivo', 'saudar', 'significativo']","[1, 1, 1, 1, 1, 1, 1, 1]","['mesario', 'mesario']","[2, 2]",8,2,10,0
9095,"['sindicato']","[1]","['cartaz', 'circular', 'imagem']","[1, 1, 1]",1,3,4,0
9096,"['economia', 'infectar', 'reforcar']","[1, 1, 1]","['amigar', 'circular', 'compartilhar', 'espalhar', 'idioma', 'imagem', 'imagem', 'imagem', 'imagem', 'inscricao', 'inscricao', 'legendar', 'usuario', 'viralizada']","[1, 1, 1, 1, 1, 4, 4, 4, 4, 2, 2, 1, 1, 1]",3,14,17,0
9097,"['colombio', 'espanha']","[1, 1]","[]","[]",2,0,2,0
9098,"[]","[]","['clicar', 'compartilhar', 'compartilhar', 'ganhar', 'ganhar', 'ganhar', 'instrucao', 'sortear', 'sortear', 'sortir']","[1, 2, 2, 3, 3, 3, 1, 2, 2, 1]",0,10,10,0
9101,"['ricardo']","[1]","[]","[]",1,0,1,0
9103,"[]","[]","['circular', 'compartilhar', 'falsar']","[1, 1, 1]",0,3,3,0
9105,"['reforcar']","[1]","['amigar', 'amigar', 'casamentar', 'casamentar', 'compartilhar', 'filmar', 'filmar', 'filmar', 'imagem', 'imagem', 'legendar', 'legendar', 'viralizado']","[2, 2, 2, 2, 1, 3, 3, 3, 2, 2, 2, 2, 1]",1,13,14,0
9108,"['adicionar']","[1]","['circular', 'circular', 'deitar', 'imagem', 'imagem']","[2, 2, 1, 2, 2]",1,5,6,0
9111,"[]","[]","['disseminar', 'visualizar']","[1, 1]",0,2,2,0
9112,"['biliao', 'congresso', 'folhar', 'habitant', 'habitant', 'processo', 'turma']","[1, 1, 1, 2, 2, 1, 1]","['compartilhar', 'fraudar', 'ganhar', 'ganhar', 'segundar', 'segundar']","[1, 1, 2, 2, 2, 2]",7,6,13,0
9115,"[]","[]","[]","[]",0,0,0,0
9119,"['constatar', 'coreia', 'coreia', 'observar', 'periodo', 'quarentenar', 'transmissao']","[1, 2, 2, 1, 1, 1, 1]","['circular']","[1]",7,1,8,0
9121,"['cenario', 'saudar', 'situacao']","[1, 1, 1]","['gravacao', 'imagem', 'manipulacao']","[1, 1, 1]",3,3,6,0
9123,"['julgamento', 'julgamento', 'privar', 'privar', 'proposto']","[2, 2, 2, 2, 1]","['circular', 'circular', 'ideologia', 'ideologia', 'menino', 'menino', 'menino', 'menino', 'tampouco', 'verdadeiro']","[2, 2, 2, 2, 4, 4, 4, 4, 1, 1]",5,10,15,0
9124,"['economia', 'sugestao']","[1, 1]","['cedula', 'despejar']","[1, 1]",2,2,4,0
9125,"['inicialment']","[1]","['botao', 'compartilhar', 'disfarcar', 'imagem', 'legendar']","[1, 1, 1, 1, 1]",1,5,6,0
9127,"['atrasar', 'habito', 'incerteza', 'jantar', 'planar', 'saudar', 'viagem', 'viagem', 'viagem']","[1, 1, 1, 1, 1, 1, 3, 3, 3]","['camiseta', 'casamentar', 'disfarcar', 'indignar', 'postagen', 'sacar']","[1, 1, 1, 1, 1, 1]",9,6,15,0
9130,"['ministrar', 'ministrar', 'palacio', 'planalto', 'reuniao', 'ricardo', 'sall']","[2, 2, 1, 1, 1, 1, 1]","[]","[]",7,0,7,0
9132,"['biliao', 'biliao', 'biliao', 'biliao']","[4, 4, 4, 4]","[]","[]",4,0,4,0
9136,"['instituto', 'previo', 'saudar']","[1, 1, 1]","['atribuir', 'circular', 'terrorismo', 'terrorismo']","[1, 1, 2, 2]",3,4,7,0
9137,"['consenso', 'domingo', 'saudar', 'saudar']","[1, 1, 2, 2]","['verdadeiro']","[1]",4,1,5,0
9139,"[]","[]","[]","[]",0,0,0,0
9141,"['ambientar', 'californio', 'reforcar', 'ufrj', 'visitant']","[1, 1, 1, 1, 1]","['compartilhar']","[1]",5,1,6,0
9142,"[]","[]","['circular', 'circular', 'imagem', 'imagem', 'legendar', 'protestar', 'protestar', 'reverso', 'verificar']","[2, 2, 2, 2, 1, 2, 2, 1, 1]",0,9,9,0
9145,"[]","[]","['imagem']","[1]",0,1,1,0
9147,"['interino', 'interino', 'investigacao', 'ministrar', 'ministrar', 'ministrar', 'notificar', 'pastar', 'pastar', 'positivar', 'positivar', 'saudar', 'saudar', 'saudar', 'suspeito']","[2, 2, 1, 3, 3, 3, 1, 2, 2, 2, 2, 3, 3, 3, 1]","['atribuir', 'circular']","[1, 1]",15,2,17,0
9149,"['avancar', 'inclusao', 'inclusao']","[1, 2, 2]","[]","[]",3,0,3,0
9150,"['destinar', 'variacao']","[1, 1]","['circular', 'efarsa', 'verdadeiro']","[1, 1, 1]",2,3,5,0
9151,"[]","[]","['humanar']","[1]",0,1,1,0
9155,"['barroso', 'barroso', 'ccj', 'comissao', 'constituicao', 'justicar', 'ministrar']","[2, 2, 1, 1, 1, 1, 1]","['circular', 'circular', 'compartilhar', 'enfim', 'ganhar', 'postagen']","[2, 2, 1, 1, 1, 1]",7,6,13,0
9159,"['atrasar', 'comportamento', 'espirito', 'passageiro', 'quedo', 'tripulacao', 'tripulacao', 'voo', 'voo']","[1, 1, 1, 1, 1, 2, 2, 2, 2]","['crer', 'desligar', 'dubai']","[1, 1, 1]",9,3,12,0
9160,"['disseminacao', 'minimizar', 'umido']","[1, 1, 1]","['verdadeiro']","[1]",3,1,4,0
9164,"['entregu', 'regrar', 'respostar']","[1, 1, 1]","['clicar', 'clicar', 'compartilhar', 'compartilhar', 'enderecar', 'ganhar', 'ganhar', 'ganhar', 'huawei', 'huawei', 'huawei', 'huawei', 'instrucao', 'macho', 'macho', 'minutar', 'parabem', 'parabem', 'parabem', 'reivindicar', 'selecionar', 'sortir', 'usuario', 'usuario']","[2, 2, 2, 2, 1, 3, 3, 3, 4, 4, 4, 4, 1, 2, 2, 1, 3, 3, 3, 1, 1, 1, 2, 2]",3,24,27,0
9165,"['contemplar', 'planar', 'planar', 'proposto']","[1, 2, 2, 1]","['intitular', 'lupa']","[1, 1]",4,2,6,0
9167,"['autoridad', 'crise', 'florido', 'saudar']","[1, 1, 1, 1]","['postagen', 'postagen', 'verificar']","[2, 2, 1]",4,3,7,0
9168,"[]","[]","['caixao', 'circular', 'quinzena']","[1, 1, 1]",0,3,3,0
9171,"['folhar', 'quedo']","[1, 1]","['compartilhar']","[1]",2,1,3,0
9172,"['decorrencia', 'diminuicao', 'inglaterra', 'inglaterra', 'levantamento', 'periodo', 'taxar']","[1, 1, 2, 2, 1, 1, 1]","['atribuir', 'compartilhar', 'enganoso', 'quantum', 'sobrar']","[1, 1, 1, 1, 1]",7,5,12,0
9173,"['autoridad', 'enquadrar', 'justicar', 'periodo', 'prever', 'sentenca', 'sentenca', 'situacao', 'vespera']","[1, 1, 1, 1, 1, 2, 2, 1, 1]","['compartilhar', 'compartilhar']","[2, 2]",9,2,11,0
9176,"['boletim', 'distrito', 'federativo', 'saudar', 'taxar', 'taxar']","[1, 1, 1, 1, 2, 2]","['circular', 'postagen', 'supostament', 'vazio', 'viralizada']","[1, 1, 1, 1, 1]",6,5,11,0
9178,"['regiao', 'reuter']","[1, 1]","['circular', 'imagem', 'incendio', 'invadir', 'legendar']","[1, 1, 1, 1, 1]",2,5,7,0
9180,"['armazenamento', 'biliao']","[1, 1]","['clicar', 'clicar', 'compartilhar', 'compartilhar', 'ganhar', 'instrucao', 'parabem', 'reivindicar']","[2, 2, 2, 2, 1, 1, 1, 1]",2,8,10,0
9182,"['consequencia', 'negativar', 'positivar']","[1, 1, 1]","['sequer']","[1]",3,1,4,0
9185,"['almeida', 'antonio', 'ministrar', 'supremo']","[1, 1, 1, 1]","['circular', 'compartilhar', 'falsar', 'imagem', 'legendar', 'postagen', 'verdadeiro']","[1, 1, 1, 1, 1, 1, 1]",4,7,11,0
9187,"['deflagrar', 'reducao', 'reducao']","[1, 2, 2]","['circular', 'imagem']","[1, 1]",3,2,5,0
9188,"[]","[]","['bandeiro', 'circular', 'circular', 'expulsar', 'expulsar']","[1, 2, 2, 2, 2]",0,5,5,0
9189,"['fase', 'investigacao', 'mantido', 'monitoramento', 'oficialment', 'suspeito']","[1, 1, 1, 1, 1, 1]","['checagem', 'manipulacao', 'verificar']","[1, 1, 1]",6,3,9,0
9191,"['michael', 'observar', 'positivar']","[1, 1, 1]","['circular', 'compartilhar', 'compartilhar', 'torrar']","[1, 2, 2, 1]",3,4,7,0
9192,"[]","[]","['amplament', 'compartilhar', 'parir', 'pelar']","[1, 1, 1, 1]",0,4,4,0
9193,"['decisao', 'supremo']","[1, 1]","['adelio', 'bispar', 'compartilhar']","[1, 1, 1]",2,3,5,0
9197,"['saudar', 'saudar']","[2, 2]","[]","[]",2,0,2,0
9200,"['avancar']","[1]","['clicar', 'clicar', 'clicar', 'ganhar', 'ganhar', 'ganhar', 'ganhar', 'preencher', 'selecionar', 'selecionar', 'sortear']","[3, 3, 3, 4, 4, 4, 4, 1, 2, 2, 1]",1,11,12,0
9202,"['almeida', 'depoimento', 'depoimento', 'domingo', 'integrant', 'margem', 'margem', 'periferia']","[1, 2, 2, 1, 1, 2, 2, 1]","[]","[]",8,0,8,0
9204,"['infectar']","[1]","['amplament', 'compartilhar', 'patrocinador', 'viralizado']","[1, 1, 1, 1]",1,4,5,0
9206,"['ministrar']","[1]","['parabem', 'parabem']","[2, 2]",1,2,3,0
9209,"['aglomeracao', 'client', 'diariament', 'infectar', 'jantar']","[1, 1, 1, 1, 1]","['cbn', 'compartilhar', 'imagem', 'legendar', 'usuario']","[1, 1, 1, 1, 1]",5,5,10,0
9216,"['domingo']","[1]","['pego', 'pego']","[2, 2]",1,2,3,0
9217,"['adulto', 'pastar']","[1, 1]","['deitar', 'soltar']","[1, 1]",2,2,4,0
9218,"['barroso', 'ministrar', 'subir']","[1, 1, 1]","['desfilar', 'parir']","[1, 1]",3,2,5,0
9219,"['realizacao', 'suspensao']","[1, 1]","['cadastramento', 'circular']","[1, 1]",2,2,4,0
9223,"['carat', 'congresso', 'desvio', 'entregu', 'ministrar', 'pratico', 'suspeicao', 'suspenso']","[1, 1, 1, 1, 1, 1, 1, 1]","['chorar', 'escravo', 'ganhar', 'socialismo']","[1, 1, 1, 1]",8,4,12,0
9227,"[]","[]","['circular', 'filmar', 'imagem', 'imagem', 'parir', 'quantum']","[1, 1, 2, 2, 1, 1]",0,6,6,0
9229,"['periodo', 'periodo', 'periodo', 'periodo']","[4, 4, 4, 4]","['cadastramento']","[1]",4,1,5,0
9230,"['regrar', 'respostar']","[1, 1]","['enderecar', 'ganhar', 'ganhar', 'parabem', 'parabem', 'parir', 'parir', 'questionario', 'selecionar', 'sobrar', 'sortir', 'sortir']","[1, 2, 2, 2, 2, 2, 2, 1, 1, 1, 2, 2]",2,12,14,0
9233,"[]","[]","['circular', 'cobaia', 'cobaia', 'cobaia', 'compartilhar', 'dorio', 'dorio', 'fotografia', 'imagem', 'legendar']","[1, 3, 3, 3, 1, 2, 2, 1, 1, 1]",0,10,10,0
9234,"[]","[]","['arquivar']","[1]",0,1,1,0
9238,"[]","[]","['ganhar']","[1]",0,1,1,0
9239,"['recurso', 'recurso']","[2, 2]","['filmar', 'filmar', 'filmar', 'rouanet', 'rouanet', 'rouanet', 'rouanet']","[3, 3, 3, 4, 4, 4, 4]",2,7,9,0
9240,"[]","[]","['filmar', 'humanar', 'parir', 'quinzena']","[1, 1, 1, 1]",0,4,4,0
9242,"['autoridad', 'autoridad', 'domicilio', 'esquema', 'estrategia', 'europeu', 'europeu', 'sabado', 'saudar']","[2, 2, 1, 1, 1, 2, 2, 1, 1]","['lixar', 'lixar']","[2, 2]",9,2,11,0
9243,"['esquema', 'esquema', 'wilson']","[2, 2, 1]","['compartilhar']","[1]",3,1,4,0
9245,"['decisao', 'montant', 'quarentenar', 'totalizar', 'totalizar']","[1, 1, 1, 2, 2]","['adorar', 'sacar']","[1, 1]",5,2,7,0
9246,"[]","[]","['circular', 'compartilhar', 'imagem']","[1, 1, 1]",0,3,3,0
9248,"['cupula', 'saudar']","[1, 1]","['circular', 'compartilhar', 'crer', 'imagem']","[1, 1, 1, 1]",2,4,6,0
9250,"['infectar', 'positivar', 'positivar']","[1, 2, 2]","['circular', 'compartilhar', 'usuario']","[1, 1, 1]",3,3,6,0
9252,"['dosar', 'dosar', 'saudar', 'volumar']","[2, 2, 1, 1]","['circular', 'imagem', 'legendar', 'versao']","[1, 1, 1, 1]",4,4,8,0
9255,"['congresso', 'descumprimento', 'secretariager']","[1, 1, 1]","['basto', 'circular', 'imagem', 'imagem', 'imagem', 'logotipo']","[1, 1, 3, 3, 3, 1]",3,6,9,0
9257,"['infectar', 'instituto']","[1, 1]","[]","[]",2,0,2,0
9261,"['benjamin', 'circulacao', 'crise', 'necessidad', 'planar', 'primeiroministro']","[1, 1, 1, 1, 1, 1]","['circular']","[1]",6,1,7,0
9262,"['estatistico', 'infectar', 'medeiro', 'oliveira', 'oliveira', 'proporcao', 'reuniao', 'reuniao', 'videoconferencia']","[1, 1, 1, 2, 2, 1, 2, 2, 1]","['circular', 'filmar', 'imagem', 'legendar']","[1, 1, 1, 1]",9,4,13,0
9264,"['ambientar']","[1]","[]","[]",1,0,1,0
9267,"['adicionar', 'araujo', 'ministrar', 'supremo']","[1, 1, 1, 1]","['circular']","[1]",4,1,5,0
9268,"[]","[]","['acidentar', 'circular', 'desfilar']","[1, 1, 1]",0,3,3,0
9273,"['desembarcar', 'economia', 'logistico', 'parceria', 'passageiro', 'regiao', 'regiao', 'regiao', 'republico', 'turistico']","[1, 1, 1, 1, 1, 3, 3, 3, 1, 1]","['nordestino']","[1]",10,1,11,0
9274,"['globonew', 'instituto']","[1, 1]","['parir']","[1]",2,1,3,0
9275,"[]","[]","[]","[]",0,0,0,0
9277,"['imunizacao', 'nomeacao']","[1, 1]","[]","[]",2,0,2,0
9281,"[]","[]","['lixar', 'manipular']","[1, 1]",0,2,2,0
9283,"['academico', 'saudar']","[1, 1]","['compartilhar', 'implantar']","[1, 1]",2,2,4,0
9285,"['condicao', 'regiao', 'surtir']","[1, 1, 1]","['atirar', 'compartilhar', 'soldar']","[1, 1, 1]",3,3,6,0
9286,"['internar']","[1]","['realment']","[1]",1,1,2,0
9289,"['academico', 'lavagem', 'ribeiro', 'ribeiro']","[1, 1, 2, 2]","['atribuir', 'postagen']","[1, 1]",4,2,6,0
9292,"['autoridad', 'biliao', 'crise', 'destinar', 'economia', 'economia', 'economia', 'escalar', 'estrategia', 'estrategia', 'isolar', 'moderno', 'moderno']","[1, 1, 1, 1, 3, 3, 3, 1, 2, 2, 1, 2, 2]","['escravo', 'ganhar', 'manipular', 'manobrar', 'mentiroso', 'parabem', 'realment']","[1, 1, 1, 1, 1, 1, 1]",13,7,20,0
9293,"['fronteiro', 'interpretar', 'projeco']","[1, 1, 1]","['amplament', 'canadens', 'capturar', 'cedula', 'cedula', 'circular', 'fraudar', 'fraudar', 'replicar', 'usuario']","[1, 1, 1, 2, 2, 1, 2, 2, 1, 1]",3,10,13,0
9295,"['distrito', 'especialment', 'temporada', 'temporada']","[1, 1, 2, 2]","['arvor', 'arvor', 'compartilhar', 'limao', 'lixar', 'melancia', 'sacar', 'vazio']","[2, 2, 1, 1, 1, 1, 1, 1]",4,8,12,0
9298,"[]","[]","[]","[]",0,0,0,0
9299,"['definitivo', 'moderno', 'mudanca', 'oficialment', 'reuniao']","[1, 1, 1, 1, 1]","['biblia', 'biblia', 'biblia', 'biblia', 'biblia']","[5, 5, 5, 5, 5]",5,5,10,0
9301,"['araujo', 'ernesto']","[1, 1]","[]","[]",2,0,2,0
9302,"['contrato', 'iniciativo', 'parceria', 'parceria', 'privar']","[1, 1, 2, 2, 1]","[]","[]",5,0,5,0
9303,"['anuncio', 'opcao']","[1, 1]","['clicar', 'inscricao', 'intitular', 'usuario', 'versao']","[1, 1, 1, 1, 1]",2,5,7,0
9304,"['epidemiar', 'inglaterra']","[1, 1]","['circular', 'legendar']","[1, 1]",2,2,4,0
9310,"[]","[]","['compartilhar']","[1]",0,1,1,0
9311,"['celebrar', 'julgamento', 'justicar', 'justicar', 'periodo', 'periodo']","[1, 1, 2, 2, 2, 2]","['circular']","[1]",6,1,7,0
9312,"['alerj', 'fabricio', 'flavio', 'flavio', 'flavio', 'gabinet', 'investigacao', 'justicar', 'justicar', 'legislativo', 'oliveira', 'planalto', 'queiroz', 'rachadinha']","[1, 1, 3, 3, 3, 1, 1, 2, 2, 1, 1, 1, 1, 1]","['adelio', 'bispar', 'circular']","[1, 1, 1]",14,3,17,0
9315,"[]","[]","['atribuir', 'compartilhar', 'imagem']","[1, 1, 1]",0,3,3,0
9318,"['celso', 'mello', 'mello', 'ministrar', 'supremo']","[1, 2, 2, 1, 1]","[]","[]",5,0,5,0
9320,"[]","[]","['implantar', 'maldiz', 'parir', 'parir']","[1, 1, 2, 2]",0,4,4,0
9322,"[]","[]","['adelio', 'assassinar', 'bispar']","[1, 1, 1]",0,3,3,0
9324,"['saudar']","[1]","['enganoso', 'pelar', 'pelar']","[1, 2, 2]",1,3,4,0
9325,"['ambientar']","[1]","[]","[]",1,0,1,0
9329,"['fundamentar', 'instituto']","[1, 1]","['gravacao', 'verificar']","[1, 1]",2,2,4,0
9330,"['publicitario']","[1]","[]","[]",1,0,1,0
9337,"[]","[]","[]","[]",0,0,0,0
9342,"['barroso', 'consultoria', 'decisao', 'fundacao', 'ministrar', 'necessidad', 'oswaldo']","[1, 1, 1, 1, 1, 1, 1]","['circular', 'compartilhar']","[1, 1]",7,2,9,0
9349,"[]","[]","['botao', 'copiar', 'parir', 'parir']","[1, 1, 2, 2]",0,4,4,0
9351,"[]","[]","['espalhar', 'garganta', 'garganta']","[1, 2, 2]",0,3,3,0
9353,"['comparacao', 'periodo', 'periodo', 'respiratorio']","[1, 2, 2, 1]","['circular', 'circular', 'compartilhar']","[2, 2, 1]",4,3,7,0
9357,"['prever']","[1]","['ganhar', 'ganhar']","[2, 2]",1,2,3,0
9360,"['gestant']","[1]","['compartilhar', 'imagem']","[1, 1]",1,2,3,0
9361,"[]","[]","['camisa', 'gravacao', 'imagem', 'lixar', 'postagen', 'usuario', 'visualizar']","[1, 1, 1, 1, 1, 1, 1]",0,7,7,0
9365,"[]","[]","[]","[]",0,0,0,0
9366,"[]","[]","['assaltar', 'rosario']","[1, 1]",0,2,2,0
9367,"['consumidor', 'equipamento', 'regiao', 'superar']","[1, 1, 1, 1]","['barragem', 'circular', 'imagem', 'imagem', 'legendar']","[1, 1, 2, 2, 1]",4,5,9,0
9368,"[]","[]","['circular']","[1]",0,1,1,0
9370,"['surtir']","[1]","['espalhar', 'imagem']","[1, 1]",1,2,3,0
9371,"['respostar', 'taxar']","[1, 1]","[]","[]",2,0,2,0
9372,"['atuacao', 'contrato', 'desvio']","[1, 1, 1]","['compartilhar', 'misturar']","[1, 1]",3,2,5,0
9373,"['abba', 'abba', 'autoridad', 'autoridad', 'autoridad', 'presidir']","[2, 2, 3, 3, 3, 1]","['circular', 'legendar']","[1, 1]",6,2,8,0
9376,"['afp', 'consecutivo', 'margem']","[1, 1, 1]","['amplament', 'circular', 'fraudar', 'fraudar', 'manipulacao', 'postagen', 'usuario']","[1, 1, 2, 2, 1, 1, 1]",3,7,10,0
9378,"['desempenhar', 'irregularidad', 'suspeito']","[1, 1, 1]","['checar', 'insinuar', 'manipular', 'parir', 'sobrar', 'sobrar']","[1, 1, 1, 1, 2, 2]",3,6,9,0
9380,"['precandidato']","[1]","[]","[]",1,0,1,0
9382,"['iniciativo']","[1]","['boicotar', 'circular', 'imagem', 'legendar', 'legendar']","[1, 1, 1, 2, 2]",1,5,6,0
9383,"['humberto']","[1]","['gleisi']","[1]",1,1,2,0
9386,"['fundacao']","[1]","['circular', 'compartilhar', 'compartilhar', 'postagen', 'replicar', 'viralizado']","[1, 2, 2, 1, 1, 1]",1,6,7,0
9387,"['supremo']","[1]","['compartilhar', 'humanar', 'manchet', 'pelar', 'segundar']","[1, 1, 1, 1, 1]",1,5,6,0
9388,"['epidemiar', 'opcao']","[1, 1]","['compartilhar', 'compartilhar', 'quinzena', 'usuario']","[2, 2, 1, 1]",2,4,6,0
9390,"[]","[]","['mentiroso', 'vc']","[1, 1]",0,2,2,0
9392,"['cenario', 'curvo', 'destacar', 'diminuicao', 'disseminacao', 'fase', 'prazo', 'quarentenar', 'situacao']","[1, 1, 1, 1, 1, 1, 1, 1, 1]","[]","[]",9,0,9,0
9396,"['justicar', 'ministrar']","[1, 1]","['circular']","[1]",2,1,3,0
9397,"['reuniao']","[1]","['cristao', 'grupar', 'imagem', 'pelar']","[1, 1, 1, 1]",1,4,5,0
9400,"['regiao', 'regiao', 'sabado']","[2, 2, 1]","['capturar', 'capturar', 'estomago', 'invadir']","[2, 2, 1, 1]",3,4,7,0
9405,"[]","[]","['amplament', 'compartilhar', 'visualizacao']","[1, 1, 1]",0,3,3,0
9406,"['sabado', 'sabado']","[2, 2]","[]","[]",2,0,2,0
9408,"['justicar']","[1]","['capturar', 'capturar', 'capturar', 'capturar', 'capturar', 'capturar', 'lazaro', 'lazaro', 'lazaro', 'lazaro', 'soltar', 'versao', 'versao', 'versao', 'versao', 'versao']","[6, 6, 6, 6, 6, 6, 4, 4, 4, 4, 1, 5, 5, 5, 5, 5]",1,16,17,0
9411,"['domingo', 'internar', 'internar', 'internar', 'internar', 'previsao', 'previsao', 'previsao']","[1, 4, 4, 4, 4, 3, 3, 3]","[]","[]",8,0,8,0
9412,"['atrasar', 'autoridad']","[1, 1]","['compartilhar', 'ideologia', 'tumulo', 'tumulo', 'tumulo']","[1, 1, 3, 3, 3]",2,5,7,0
9414,"[]","[]","['efarsa', 'fotografia', 'humanar']","[1, 1, 1]",0,3,3,0
9416,"[]","[]","[]","[]",0,0,0,0
9418,"['comunitario', 'disseminacao', 'plantao']","[1, 1, 1]","['supostament']","[1]",3,1,4,0
9419,"['infectar', 'saudar']","[1, 1]","['circular']","[1]",2,1,3,0
9423,"['equivalent']","[1]","['cadastramento', 'clicar', 'compartilhar', 'compartilhar', 'compartilhar', 'questionario', 'sacar', 'sacar']","[1, 1, 3, 3, 3, 1, 2, 2]",1,8,9,0
9426,"['acordo', 'decisao', 'esquema', 'ministrar']","[1, 1, 1, 1]","['falsar', 'filmar', 'fraudar', 'ganhar', 'minutar', 'parir', 'parir', 'parir', 'parir', 'pelar', 'sobrar', 'sobrar', 'vc']","[1, 1, 1, 1, 1, 4, 4, 4, 4, 1, 2, 2, 1]",4,13,17,0
9427,"[]","[]","['curioso', 'disseminar', 'espalhar', 'imagem', 'postagen']","[1, 1, 1, 1, 1]",0,5,5,0
9429,"[]","[]","[]","[]",0,0,0,0
9433,"['comissao', 'esquema', 'inquerito', 'inquerito', 'integrant', 'journal', 'justicar', 'pagamento', 'pratico', 'ramagem', 'reuniao']","[1, 1, 2, 2, 1, 1, 1, 1, 1, 1, 1]","[]","[]",11,0,11,0
9434,"[]","[]","['dorio']","[1]",0,1,1,0
9441,"[]","[]","['checar', 'circular']","[1, 1]",0,2,2,0
9444,"['institut']","[1]","['checar', 'vazio', 'vazio', 'wylli', 'wylli']","[1, 2, 2, 2, 2]",1,5,6,0
9448,"['boletim']","[1]","[]","[]",1,0,1,0
9449,"['desenvolvimento', 'destinar', 'epidemiar', 'folhar', 'fundeb', 'fundeb', 'fundeb', 'impactar', 'pagamento', 'significativo']","[1, 1, 1, 1, 3, 3, 3, 1, 1, 1]","[]","[]",10,0,10,0
9452,"['acumular', 'lavagem', 'lavagem']","[1, 2, 2]","[]","[]",3,0,3,0
9454,"['anvisa', 'autoridad', 'converso', 'estagio', 'recuperacao']","[1, 1, 1, 1, 1]","['verificar']","[1]",5,1,6,0
9455,"['consorcio', 'fase', 'fase', 'intervalar', 'levantamento', 'transmissao']","[1, 2, 2, 1, 1, 1]","['checar', 'pelar', 'pelar', 'pelar', 'segundar', 'sobrar']","[1, 3, 3, 3, 1, 1]",6,6,12,0
9456,"['transicao']","[1]","['bandeiro', 'circular', 'greve', 'imagem', 'legendar']","[1, 1, 1, 1, 1]",1,5,6,0
9458,"['espirito', 'espirito']","[2, 2]","['espalhar', 'misericordia', 'rosario']","[1, 1, 1]",2,3,5,0
9459,"['humberto', 'humberto']","[2, 2]","['despejar', 'despejar', 'imagem', 'postagen', 'postagen', 'venezuelano']","[2, 2, 1, 2, 2, 1]",2,6,8,0
9460,"[]","[]","['circular', 'compartilhar', 'imagem']","[1, 1, 1]",0,3,3,0
9464,"[]","[]","[]","[]",0,0,0,0
9467,"['justicar', 'justicar', 'ministrar', 'ministrar', 'ministrar', 'ministrar']","[2, 2, 4, 4, 4, 4]","['assassinar', 'compartilhar', 'curioso', 'imagem', 'imagem', 'usuario']","[1, 1, 1, 2, 2, 1]",6,6,12,0
9468,"[]","[]","['cocaina', 'cocaina', 'escutar', 'manchet', 'quantum', 'segundar']","[2, 2, 1, 1, 1, 1]",0,6,6,0
9470,"['associacao', 'quadro', 'ribeiro', 'ribeiro', 'saudar']","[1, 1, 2, 2, 1]","['cbn', 'circular', 'vitaminar', 'vitaminar', 'vitaminar', 'vitaminar']","[1, 1, 4, 4, 4, 4]",5,6,11,0
9471,"['autorizacao', 'curso', 'determinacao', 'prever', 'regulamentar']","[1, 1, 1, 1, 1]","['boatar', 'circular', 'circular', 'legendar', 'revoltar']","[1, 2, 2, 1, 1]",5,5,10,0
9473,"[]","[]","['compartilhar', 'compartilhar', 'missil']","[2, 2, 1]",0,3,3,0
9476,"['recarregar']","[1]","['ganhar']","[1]",1,1,2,0
9477,"['client', 'impactar']","[1, 1]","['circular', 'pego', 'sacar']","[1, 1, 1]",2,3,5,0
9481,"['saudar']","[1]","['desmentir', 'imagem']","[1, 1]",1,2,3,0
9483,"['reabertura', 'regiao']","[1, 1]","['compartilhar', 'inscricao', 'motorista', 'preencher']","[1, 1, 1, 1]",2,4,6,0
9486,"[]","[]","['espalhar', 'imagem', 'quinzena']","[1, 1, 1]",0,3,3,0
9487,"['interferencia', 'saudar']","[1, 1]","['parir', 'vc', 'versao', 'versao', 'versao']","[1, 1, 3, 3, 3]",2,5,7,0
9490,"['antonio', 'converso', 'dificuldad', 'proposto']","[1, 1, 1, 1]","[]","[]",4,0,4,0
9492,"['equipamento', 'observar', 'situacao', 'subir']","[1, 1, 1, 1]","['circular', 'filmar', 'gravacao', 'imagem', 'legendar']","[1, 1, 1, 1, 1]",4,5,9,0
9499,"[]","[]","['casamentar']","[1]",0,1,1,0
9500,"['avancar', 'comparacao', 'comparacao', 'comparacao', 'painel']","[1, 3, 3, 3, 1]","['circular', 'imagem', 'imagem', 'imagem', 'imagem', 'legendar']","[1, 4, 4, 4, 4, 1]",5,6,11,0
9502,"['anuncio', 'bandeirant', 'inclusao', 'palacio', 'pslsp', 'saudar']","[1, 1, 1, 1, 1, 1]","['gravacao']","[1]",6,1,7,0
9503,"['exercicio']","[1]","['espalhar', 'imagem', 'imagem', 'parir']","[1, 2, 2, 1]",1,4,5,0
9507,"[]","[]","['soldar']","[1]",0,1,1,0
9509,"['conjuntar', 'desenvolvimento']","[1, 1]","['camisa', 'camisa', 'circular', 'compartilhar', 'imagem', 'menino']","[2, 2, 1, 1, 1, 1]",2,6,8,0
9510,"['facilitar', 'planar']","[1, 1]","['visualizacao']","[1]",2,1,3,0
9512,"['sabado']","[1]","['clicar', 'clicar', 'compartilhar', 'ganhar', 'ganhar', 'instrucao', 'macho', 'minutar', 'parabem', 'reivindicar', 'usuario', 'usuario']","[2, 2, 1, 2, 2, 1, 1, 1, 1, 1, 2, 2]",1,12,13,0
9514,"['contencao', 'fundacao', 'orientacao', 'variacao']","[1, 1, 1, 1]","['circular', 'circular', 'compartilhar', 'compartilhar', 'imagem', 'misturar', 'misturar', 'zincar', 'zincar', 'zincar']","[2, 2, 2, 2, 1, 2, 2, 3, 3, 3]",4,10,14,0
9520,"['aprovacao', 'sessao']","[1, 1]","['abortar', 'abortar', 'cartaz', 'circular', 'humanar']","[2, 2, 1, 1, 1]",2,5,7,0
9522,"[]","[]","['realment']","[1]",0,1,1,0
9526,"['augusto', 'depressao']","[1, 1]","['chorar', 'estampar', 'lixar', 'reivindicar']","[1, 1, 1, 1]",2,4,6,0
9528,"['adesao', 'barroso', 'congresso', 'congresso', 'congresso', 'congresso', 'congresso', 'congresso', 'constituicao', 'exigencia', 'exigencia', 'exigencia', 'exigencia', 'federar', 'federar', 'federar', 'federar', 'ministrar', 'organizador', 'orientacao', 'prazo', 'previsao', 'privar']","[1, 1, 6, 6, 6, 6, 6, 6, 1, 4, 4, 4, 4, 4, 4, 4, 4, 1, 1, 1, 1, 1, 1]","['ganhar', 'implantar', 'parir', 'parir', 'parir', 'parir', 'parir', 'parir', 'parir', 'parir', 'pelar']","[1, 1, 8, 8, 8, 8, 8, 8, 8, 8, 1]",23,11,34,0
9529,"['congresso', 'cupula', 'dificuldad', 'emendar', 'enfrentamento', 'enfrentamento', 'estatistico', 'proposto', 'resistencia', 'reuniao', 'sessao', 'sessao']","[1, 1, 1, 1, 2, 2, 1, 1, 1, 1, 2, 2]","['compartilhar', 'gleisi', 'revoltar', 'vazar', 'verdadeiro']","[1, 1, 1, 1, 1]",12,5,17,0
9532,"['pagamento', 'parcelar']","[1, 1]","['clicar']","[1]",2,1,3,0
9534,"['piorar', 'publicitario']","[1, 1]","[]","[]",2,0,2,0
9536,"[]","[]","['abencoar', 'versao', 'versao']","[1, 2, 2]",0,3,3,0
9537,"['domingo', 'resistencia']","[1, 1]","['arquivar', 'compartilhar', 'legendar']","[1, 1, 1]",2,3,5,0
9538,"[]","[]","[]","[]",0,0,0,0
9541,"['apurar']","[1]","['compartilhar', 'realment']","[1, 1]",1,2,3,0
9544,"[]","[]","['espalhar', 'imagem', 'quinzena']","[1, 1, 1]",0,3,3,0
9545,"['afp', 'ambito', 'comparacao', 'condenacao', 'supremo', 'viagem']","[1, 1, 1, 1, 1, 1]","['atribuir', 'checar', 'circular', 'enganar', 'verificacao']","[1, 1, 1, 1, 1]",6,5,11,0
9547,"['imunizacao']","[1]","['enganoso']","[1]",1,1,2,0
9549,"['destinar', 'enfrentamento', 'infectar', 'saudar']","[1, 1, 1, 1]","[]","[]",4,0,4,0
9550,"['anvisa', 'diretoria', 'fase', 'imunizacao', 'pslsp', 'saudar', 'vigilancia']","[1, 1, 1, 1, 1, 1, 1]","['parir', 'parir', 'pelar', 'pelar', 'pelar', 'pelar', 'verificar']","[2, 2, 4, 4, 4, 4, 1]",7,7,14,0
9551,"['molecular', 'previo']","[1, 1]","[]","[]",2,0,2,0
9552,"['cooperacao', 'distrito', 'regiao']","[1, 1, 1]","[]","[]",3,0,3,0
9561,"[]","[]","[]","[]",0,0,0,0
9562,"[]","[]","['circular', 'ganhar', 'interaco', 'postagen']","[1, 1, 1, 1]",0,4,4,0
9563,"['atrasar', 'elaborar', 'epidemiar', 'reabertura', 'transmissao']","[1, 1, 1, 1, 1]","['circular', 'imagem', 'imagem', 'imagem', 'imagem', 'legendar', 'legendar', 'lembres', 'realment']","[1, 4, 4, 4, 4, 2, 2, 1, 1]",5,9,14,0
9565,"[]","[]","[]","[]",0,0,0,0
9566,"['colombio']","[1]","['capturar', 'imagem', 'postagen', 'usuario', 'viralizado']","[1, 1, 1, 1, 1]",1,5,6,0
9567,"['irregularidad', 'justicar']","[1, 1]","['cedula', 'cedula', 'fraudar']","[2, 2, 1]",2,3,5,0
9568,"['necessario', 'recurso', 'recurso', 'saudar', 'situacao']","[1, 2, 2, 1, 1]","['arquivar', 'captar', 'captar', 'rouanet']","[1, 2, 2, 1]",5,4,9,0
9569,"[]","[]","[]","[]",0,0,0,0
9570,"[]","[]","['ganhar', 'ganhar']","[2, 2]",0,2,2,0
9571,"['conformar', 'dosar', 'dosar', 'dosar', 'esquema']","[1, 3, 3, 3, 1]","['garganta']","[1]",5,1,6,0
9576,"['conjunto', 'domingo', 'forcatarefa', 'infectar', 'infectar', 'infectar', 'infectar', 'infectar', 'quarentenar', 'quarentenar', 'recurso', 'surtir', 'triagem']","[1, 1, 1, 5, 5, 5, 5, 5, 2, 2, 1, 1, 1]","['terrorismo', 'terrorismo']","[2, 2]",13,2,15,0
9579,"[]","[]","['clicar', 'clicar', 'compartilhar', 'compartilhar', 'ganhar', 'ganhar', 'ganhar']","[2, 2, 2, 2, 3, 3, 3]",0,7,7,0
9580,"['dosar', 'internar', 'opcao', 'sputnik', 'sputnik']","[1, 1, 1, 2, 2]","[]","[]",5,0,5,0
9581,"[]","[]","['verdadeiro']","[1]",0,1,1,0
9583,"['autoridad', 'positivar', 'saudar', 'surtir', 'wilson', 'witzel']","[1, 1, 1, 1, 1, 1]","['circular']","[1]",6,1,7,0
9584,"['crescimento', 'desempenhar', 'destacar', 'funcao', 'henriqu', 'jurista', 'ministrar', 'palacio', 'periodo', 'planar', 'plano', 'situacao']","[1, 1, 1, 1, 1, 1, 1, 1, 1, 1, 1, 1]","['assaltar', 'compartilhar', 'facada', 'imagem']","[1, 1, 1, 1]",12,4,16,0
9586,"[]","[]","['enganoso']","[1]",0,1,1,0
9587,"['exportacao', 'sigla']","[1, 1]","['capturar', 'circular', 'compartilhar', 'imagem', 'imagem', 'usuario']","[1, 1, 1, 2, 2, 1]",2,6,8,0
9588,"[]","[]","['imagem', 'quinzena', 'vezar']","[1, 1, 1]",0,3,3,0
9590,"['internar', 'modelo']","[1, 1]","['manipular', 'realment', 'torturar']","[1, 1, 1]",2,3,5,0
9591,"[]","[]","['espalhar', 'imagem', 'pelar']","[1, 1, 1]",0,3,3,0
9592,"['condicao', 'economia']","[1, 1]","['circular']","[1]",2,1,3,0
9593,"['converso', 'regiao']","[1, 1]","[]","[]",2,0,2,0
9596,"['comprometido', 'deteccao', 'estimular', 'infectar']","[1, 1, 1, 1]","['circular', 'compartilhar', 'postagen', 'replicar']","[1, 1, 1, 1]",4,4,8,0
9599,"['concreto']","[1]","['acidentar', 'circular', 'imagem', 'imagem', 'imagem', 'reverso']","[1, 1, 3, 3, 3, 1]",1,6,7,0
9600,"[]","[]","['arquivar', 'versao']","[1, 1]",0,2,2,0
9602,"[]","[]","[]","[]",0,0,0,0
9604,"['instituto', 'instituto', 'previo']","[2, 2, 1]","['verificar']","[1]",3,1,4,0
9605,"[]","[]","['menino', 'menino']","[2, 2]",0,2,2,0
9606,"['diretoria', 'treinamento']","[1, 1]","['compartilhar', 'motorista']","[1, 1]",2,2,4,0
9608,"['globonew', 'globonew']","[2, 2]","['capturar', 'capturar', 'circular', 'imagem', 'imagem']","[2, 2, 1, 2, 2]",2,5,7,0
9610,"['barroso', 'barroso', 'barroso', 'ministrar', 'ministrar', 'ministrar', 'ministrar', 'reuniao']","[3, 3, 3, 4, 4, 4, 4, 1]","['filmar', 'parir', 'parir', 'parir', 'parir', 'parir', 'pelar', 'segundar']","[1, 5, 5, 5, 5, 5, 1, 1]",8,8,16,0
9611,"['exercicio', 'respiratorio', 'taxar']","[1, 1, 1]","['compartilhar', 'inscricao', 'inscricao', 'instrucao']","[1, 2, 2, 1]",3,4,7,0
9612,"['apoio', 'privar']","[1, 1]","['manobrar']","[1]",2,1,3,0
9613,"[]","[]","['basto', 'botao', 'clicar', 'compartilhar', 'compartilhar', 'enderecar', 'preencher']","[1, 1, 1, 2, 2, 1, 1]",0,7,7,0
9614,"['fundacao', 'oswaldo', 'saudar', 'saudar']","[1, 1, 2, 2]","['circular', 'garganta']","[1, 1]",4,2,6,0
9616,"['fundacao']","[1]","['boatar', 'cbn', 'checagem', 'circular', 'circular', 'desmentir', 'versao']","[1, 1, 1, 2, 2, 1, 1]",1,7,8,0
9619,"['avancar', 'especialment', 'instituto']","[1, 1, 1]","['espalhar', 'ilustrar', 'nobel', 'nobel']","[1, 1, 2, 2]",3,4,7,0
9620,"['domingo', 'metropolitano']","[1, 1]","['agredir', 'catedr', 'catedr', 'compartilhar', 'legendar', 'legendar', 'versao']","[1, 2, 2, 1, 2, 2, 1]",2,7,9,0
9621,"['mudanca']","[1]","['espalhar', 'parir']","[1, 1]",1,2,3,0
9622,"[]","[]","['legendar', 'sobrar', 'visualizacao']","[1, 1, 1]",0,3,3,0
9624,"['apurar', 'comissao', 'humberto', 'inquerito', 'processo', 'processo']","[1, 1, 1, 1, 2, 2]","['circular']","[1]",6,1,7,0
9626,"['articulacao', 'congresso', 'conjuntar', 'constituicao', 'delacao', 'elaborar', 'folhar', 'organizador', 'preservar']","[1, 1, 1, 1, 1, 1, 1, 1, 1]","['adelio', 'bispar', 'espalhar']","[1, 1, 1]",9,3,12,0
9627,"[]","[]","['compartilhar']","[1]",0,1,1,0
9628,"['ambientar', 'depoimento', 'desafio', 'especialment', 'especialment', 'recurso', 'reuniao', 'situacao', 'suportar']","[1, 1, 1, 2, 2, 1, 1, 1, 1]","['imenso']","[1]",9,1,10,0
9629,"[]","[]","['circular', 'compartilhar', 'imagem', 'lembres', 'sacar', 'vitaminar', 'vitaminar', 'vitaminar', 'vitaminar', 'zincar', 'zincar']","[1, 1, 1, 1, 1, 4, 4, 4, 4, 2, 2]",0,11,11,0
9635,"['aglomeracao', 'periodo', 'quarentenar']","[1, 1, 1]","['compartilhar', 'mansao']","[1, 1]",3,2,5,0
9636,"['adulto', 'adulto', 'adulto', 'adulto', 'comportament', 'comportamento', 'comportamento', 'justicar', 'justicar', 'justicar', 'lancamento', 'saudar', 'supremo']","[4, 4, 4, 4, 1, 2, 2, 3, 3, 3, 1, 1, 1]","['basto', 'misericordia']","[1, 1]",13,2,15,0
9637,"[]","[]","[]","[]",0,0,0,0
9639,"['intensivo', 'internacao', 'internacao', 'internar', 'pastar', 'saudar']","[1, 2, 2, 1, 1, 1]","['cbn', 'circular']","[1, 1]",6,2,8,0
9641,"['regiao']","[1]","['imagem', 'quinzena']","[1, 1]",1,2,3,0
9643,"['consolidar']","[1]","['misturar']","[1]",1,1,2,0
9644,"['fase', 'instituto', 'instituto', 'instituto', 'parceria', 'parceria', 'parceria', 'sabado', 'suspensao', 'suspenso', 'suspenso', 'testagem']","[1, 3, 3, 3, 3, 3, 3, 1, 1, 2, 2, 1]","[]","[]",12,0,12,0
9645,"['biliao', 'tesourar', 'transferir']","[1, 1, 1]","[]","[]",3,0,3,0
9650,"[]","[]","[]","[]",0,0,0,0
9651,"['avancar', 'entregu', 'regiao']","[1, 1, 1]","['basto', 'compartilhar', 'inscricao', 'preencher']","[1, 1, 1, 1]",3,4,7,0
9658,"['desembarcar', 'desembarcar', 'desembarcar', 'justicar']","[3, 3, 3, 1]","['enfim']","[1]",4,1,5,0
9660,"[]","[]","['sacar']","[1]",0,1,1,0
9661,"['aprovacao', 'balancar', 'bolsonarista', 'levantamento']","[1, 1, 1, 1]","['parir']","[1]",4,1,5,0
9664,"['epidemiar', 'respiratorio', 'respiratorio', 'saudar']","[1, 2, 2, 1]","['compartilhar']","[1]",4,1,5,0
9665,"['aplicacao', 'companhia', 'decisao', 'fronteiro', 'roraima', 'sarampo', 'sarampo', 'saudar', 'sigla']","[1, 1, 1, 1, 1, 2, 2, 1, 1]","['venezuelano', 'venezuelano']","[2, 2]",9,2,11,0
9666,"['aplicacao', 'dedicar', 'estrategia', 'portavoz', 'quarentenar', 'saudar']","[1, 1, 1, 1, 1, 1]","['compartilhar', 'enganoso']","[1, 1]",6,2,8,0
9667,"['biliao', 'biliao', 'instituto', 'parceria', 'plano']","[2, 2, 1, 1, 1]","['circular', 'replicar']","[1, 1]",5,2,7,0
9671,"['autoridad', 'desembarcar', 'processo', 'quarentenar']","[1, 1, 1, 1]","[]","[]",4,0,4,0
9672,"['belgica']","[1]","['compartilhar', 'protestar']","[1, 1]",1,2,3,0
9675,"['afp', 'bbc', 'bbc']","[1, 2, 2]","['checagem', 'compartilhar', 'gravacao', 'gravacao', 'legendar', 'postagen', 'replicar', 'usuario', 'usuario', 'verificacao', 'visualizar']","[1, 1, 2, 2, 1, 1, 1, 2, 2, 1, 1]",3,11,14,0
9676,"[]","[]","['enfim', 'misericordia']","[1, 1]",0,2,2,0
9677,"[]","[]","[]","[]",0,0,0,0
9679,"['desenvolvido']","[1]","['amplament', 'compartilhar', 'espalhar', 'invadir']","[1, 1, 1, 1]",1,4,5,0
9680,"['dialogo', 'fluminens', 'necessario', 'posicionamento', 'realizacao']","[1, 1, 1, 1, 1]","['circular', 'compartilhar']","[1, 1]",5,2,7,0
9683,"['decorrencia', 'habitant', 'metropolitano', 'regiao', 'sorocaba']","[1, 1, 1, 1, 1]","['circular']","[1]",5,1,6,0
9686,"['aglomeracao', 'aglomeracao', 'antonio', 'crise', 'dialogo', 'enfrentamento', 'iniciativo', 'nogueira', 'opcao', 'reducao', 'saudar', 'saudar', 'situacao']","[2, 2, 1, 1, 1, 1, 1, 1, 1, 1, 2, 2, 1]","['dorio']","[1]",13,1,14,0
9687,"['integrant', 'saudar']","[1, 1]","['circular', 'compartilhar', 'parir', 'pelar', 'pelar']","[1, 1, 1, 2, 2]",2,5,7,0
9689,"['ministrar', 'ministrar']","[2, 2]","['socialismo', 'socialismo', 'torrar', 'torrar', 'versao']","[2, 2, 2, 2, 1]",2,5,7,0
9690,"[]","[]","['botao', 'cuspir', 'cuspir', 'cuspir', 'espalhar', 'filmar']","[1, 3, 3, 3, 1, 1]",0,6,6,0
9692,"['ministrar', 'revogar']","[1, 1]","['espalhar']","[1]",2,1,3,0
9693,"['companhia', 'moderno', 'respiratorio']","[1, 1, 1]","['assinalar', 'circular', 'clicar', 'parir', 'postagen', 'sobrar', 'telegram', 'usuario', 'versao', 'vezar', 'viralizado', 'visualizar']","[1, 1, 1, 1, 1, 1, 1, 1, 1, 1, 1, 1]",3,12,15,0
9694,"['colaboracao', 'comissao', 'confederacao', 'equilibrio', 'ernesto', 'facilitar', 'integrant', 'journal', 'lesao', 'pagamento', 'reuniao']","[1, 1, 1, 1, 1, 1, 1, 1, 1, 1, 1]","['libertador']","[1]",11,1,12,0
9695,"['genoma', 'instituto', 'saudar', 'sequenciamento']","[1, 1, 1, 1]","['circular', 'compartilhar', 'humanar', 'humanar']","[1, 1, 2, 2]",4,4,8,0
9696,"['cronica']","[1]","['amplament', 'circular', 'compartilhar', 'compartilhar', 'ganhar', 'gravacao', 'legendar', 'manipular']","[1, 1, 2, 2, 1, 1, 1, 1]",1,8,9,0
9697,"['propagacao', 'restritivo', 'turma']","[1, 1, 1]","['circular', 'gravacao', 'parir', 'pelar', 'postagen', 'usuario']","[1, 1, 1, 1, 1, 1]",3,6,9,0
9699,"['atrasar', 'esforco', 'fase', 'fase', 'fase', 'necessario', 'observar', 'regiao', 'regiao', 'saudar', 'saudar']","[1, 1, 3, 3, 3, 1, 1, 2, 2, 2, 2]","['garganta', 'garganta', 'limao', 'limao', 'nasal', 'sortir', 'vitaminar']","[2, 2, 2, 2, 1, 1, 1]",11,7,18,0
9705,"['ambito', 'condenacao', 'quedo', 'supremo']","[1, 1, 1, 1]","['compartilhar', 'estampar', 'imagem', 'postagen', 'soltar', 'supostament', 'versao']","[1, 1, 1, 1, 1, 1, 1]",4,7,11,0
9707,"['prorrogar', 'restritivo']","[1, 1]","['compartilhar']","[1]",2,1,3,0
9708,"['converso', 'irregularidad']","[1, 1]","['circular', 'desmentir', 'enganoso', 'fraudar', 'parir', 'pelar', 'pelar', 'verificacao']","[1, 1, 1, 1, 1, 2, 2, 1]",2,8,10,0
9712,"['supremo']","[1]","[]","[]",1,0,1,0
9715,"[]","[]","['dubai', 'dubai', 'dubai', 'dubai', 'dubai', 'incendio', 'pego', 'pego']","[5, 5, 5, 5, 5, 1, 2, 2]",0,8,8,0
9716,"['consequencia', 'curso', 'decisao', 'expansao', 'necessario', 'turma']","[1, 1, 1, 1, 1, 1]","['circular', 'falsar']","[1, 1]",6,2,8,0
9717,"['entregu']","[1]","['cedula', 'cedula', 'circular', 'compartilhar', 'fraudar', 'imagem', 'imagem', 'legendar', 'legendar', 'manobrar', 'tampouco']","[2, 2, 1, 1, 1, 2, 2, 2, 2, 1, 1]",1,11,12,0
9722,"['inclusao', 'mudanca', 'orientacao', 'processo']","[1, 1, 1, 1]","['circular']","[1]",4,1,5,0
9723,"['mexico', 'preparacao', 'saudar', 'saudar', 'suspeito']","[1, 1, 2, 2, 1]","['circular', 'circular', 'deitar', 'imagem', 'imagem', 'imagem', 'imagem', 'reverso', 'versao']","[2, 2, 1, 4, 4, 4, 4, 1, 1]",5,9,14,0
9726,"['administrativo', 'amplo', 'conduta', 'conformar', 'distrit', 'internar', 'pagamento', 'punicao', 'servidor', 'servidor', 'servidor', 'suspensao']","[1, 1, 1, 1, 1, 1, 1, 1, 3, 3, 3, 1]","['circular', 'fraudar']","[1, 1]",12,2,14,0
9728,"['afp', 'diagnosticar', 'exercicio', 'respiratorio']","[1, 1, 1, 1]","['atribuir', 'checar', 'verificacao']","[1, 1, 1]",4,3,7,0
9730,"[]","[]","['circular', 'interaco', 'legendar', 'postagen', 'protestar', 'realment']","[1, 1, 1, 1, 1, 1]",0,6,6,0
9734,"['europeu']","[1]","['segundar']","[1]",1,1,2,0
9735,"['apurar', 'atuam', 'comissao', 'comissao', 'decisao', 'depoimento', 'enfrentamento', 'logistico', 'saudar', 'sessao']","[1, 1, 2, 2, 1, 1, 1, 1, 1, 1]","['enganoso', 'lupa', 'parir', 'parir', 'suco']","[1, 1, 2, 2, 1]",10,5,15,0
9737,"['client', 'pagamento']","[1, 1]","['quinzena']","[1]",2,1,3,0
9738,"[]","[]","['circular', 'compartilhar', 'legendar']","[1, 1, 1]",0,3,3,0
9739,"['situacao']","[1]","['atirar', 'cristao', 'parir', 'pelar', 'versao']","[1, 1, 1, 1, 1]",1,5,6,0
9741,"['folhar']","[1]","['expulsar', 'telejorn']","[1, 1]",1,2,3,0
9743,"['caxia', 'duqu', 'subir']","[1, 1, 1]","[]","[]",3,0,3,0
9744,"[]","[]","['limao']","[1]",0,1,1,0
9746,"[]","[]","['compartilhar']","[1]",0,1,1,0
9749,"['decorrent', 'estagio', 'renata', 'respiratorio', 'respiratorio']","[1, 1, 1, 2, 2]","['compartilhar', 'inscricao', 'inscricao']","[1, 2, 2]",5,3,8,0
9750,"[]","[]","['cartaz', 'espalhar', 'imagem', 'quinzena']","[1, 1, 1, 1]",0,4,4,0
9756,"['recordar']","[1]","[]","[]",1,0,1,0
9757,"['liderar', 'republico']","[1, 1]","['circular', 'enganoso', 'imagem', 'imagem', 'usuario', 'verdadeiro', 'verdadeiro', 'viralizada']","[1, 1, 2, 2, 1, 2, 2, 1]",2,8,10,0
9759,"['arthur', 'concedido', 'instituto', 'pagamento', 'regrar']","[1, 1, 1, 1, 1]","['assassinar', 'assassinar', 'circular', 'compartilhar', 'desmentir', 'desmentir', 'motorista', 'motorista', 'motorista']","[2, 2, 1, 1, 2, 2, 3, 3, 3]",5,9,14,0
9762,"['mudanca', 'possibilidad']","[1, 1]","[]","[]",2,0,2,0
9765,"['domingo']","[1]","['agredir', 'circular', 'compartilhar', 'fotografo', 'fotografo', 'imagem', 'imagem', 'imagem']","[1, 1, 1, 2, 2, 3, 3, 3]",1,8,9,0
9766,"['anuncio', 'oficialment']","[1, 1]","['amplament', 'circular', 'imagem', 'indignacao', 'usuario']","[1, 1, 1, 1, 1]",2,5,7,0
9767,"[]","[]","['casamentar', 'casamentar', 'rouanet']","[2, 2, 1]",0,3,3,0
9768,"[]","[]","[]","[]",0,0,0,0
9770,"['carat', 'consequencia', 'dialogo', 'folhar', 'marinhar', 'respostar']","[1, 1, 1, 1, 1, 1]","['abusar', 'abusar', 'enfim', 'enfim', 'ideologia', 'ideologia', 'ideologia', 'rosario', 'rouanet', 'verdadeiro', 'wylli']","[2, 2, 2, 2, 3, 3, 3, 1, 1, 1, 1]",6,11,17,0
9771,"['liderar', 'passageiro', 'prazo']","[1, 1, 1]","['safar']","[1]",3,1,4,0
9778,"['instalacao', 'preocupacao']","[1, 1]","['imagem', 'vazio']","[1, 1]",2,2,4,0
9779,"[]","[]","['imagem', 'postagen']","[1, 1]",0,2,2,0
9780,"['instituto', 'instituto', 'parceria', 'parceria', 'piorar']","[2, 2, 2, 2, 1]","['telejorn', 'telejorn']","[2, 2]",5,2,7,0
9781,"['autoridad', 'integrant', 'integrant', 'republico', 'transmissao']","[1, 2, 2, 1, 1]","[]","[]",5,0,5,0
9782,"['bbc']","[1]","[]","[]",1,0,1,0
9785,"['internar', 'mandatario']","[1, 1]","['espalhar', 'falsar', 'falsar', 'invadir', 'quinzena']","[1, 2, 2, 1, 1]",2,5,7,0
9790,"[]","[]","['compartilhar', 'compartilhar', 'curioso', 'curioso', 'imagem', 'imagem', 'imagem', 'verdadeiro']","[2, 2, 2, 2, 3, 3, 3, 1]",0,8,8,0
9791,"['observar', 'reducao']","[1, 1]","['imagem']","[1]",2,1,3,0
9795,"[]","[]","[]","[]",0,0,0,0
9797,"['importancia', 'preconceito']","[1, 1]","[]","[]",2,0,2,0
9799,"['consequencia']","[1]","['expulsar', 'expulsar', 'facada', 'renunciar', 'wylli']","[2, 2, 1, 1, 1]",1,5,6,0
9801,"['temporario']","[1]","['compartilhar', 'inscricao']","[1, 1]",1,2,3,0
9804,"[]","[]","['espalhar', 'patrocinador']","[1, 1]",0,2,2,0
9805,"['situacao']","[1]","['tampouco']","[1]",1,1,2,0
9809,"['ambientar']","[1]","['circular', 'fotografia', 'fotografo', 'idioma', 'imagem', 'verificacao']","[1, 1, 1, 1, 1, 1]",1,6,7,0
9811,"['anuncio', 'comissao']","[1, 1]","['circular', 'sacar', 'sacar']","[1, 2, 2]",2,3,5,0
9817,"['advocaciager', 'condicao', 'converso', 'distrito', 'distrito', 'domingo', 'excecao', 'passageiro', 'passageiro', 'presenciar', 'rocha', 'rocha', 'temor', 'tripulacao', 'viagem']","[1, 1, 1, 2, 2, 1, 1, 2, 2, 1, 2, 2, 1, 1, 1]","['verdadeiro']","[1]",15,1,16,0
9818,"[]","[]","['invadir']","[1]",0,1,1,0
9819,"['excecao', 'regrar']","[1, 1]","['enganir', 'nordestino', 'nordestino', 'nordestino']","[1, 3, 3, 3]",2,4,6,0
9820,"['supremo']","[1]","['circular', 'compartilhar', 'faccao', 'imagem']","[1, 1, 1, 1]",1,4,5,0
9821,"[]","[]","[]","[]",0,0,0,0
9822,"['afp']","[1]","['checar', 'circular', 'compartilhar', 'legendar', 'usuario', 'verificacao']","[1, 1, 1, 1, 1, 1]",1,6,7,0
9823,"['escalar']","[1]","['abencoar', 'circular', 'compartilhar', 'gravacao', 'idioma', 'imagem', 'legendar', 'parabem', 'sacar', 'usuario']","[1, 1, 1, 1, 1, 1, 1, 1, 1, 1]",1,10,11,0
9824,"['enxergar', 'painel', 'velocidad']","[1, 1, 1]","[]","[]",3,0,3,0
9825,"['equipamento', 'instituto', 'instituto', 'intensivo', 'respirador']","[1, 2, 2, 1, 1]","['circular', 'circular', 'gravacao', 'imagem', 'imagem', 'vazio', 'vazio']","[2, 2, 1, 2, 2, 2, 2]",5,7,12,0
9826,"['desenvolvido']","[1]","['humanar', 'verificar']","[1, 1]",1,2,3,0
9827,"['afp', 'segredar']","[1, 1]","['caixao', 'caixao', 'checar', 'compartilhar', 'fraudar', 'gravacao', 'ilustrar', 'imagem', 'legendar', 'postagen', 'verificar']","[2, 2, 1, 1, 1, 1, 1, 1, 1, 1, 1]",2,11,13,0
9828,"['previo']","[1]","['curioso', 'verificacao']","[1, 1]",1,2,3,0
9829,"[]","[]","[]","[]",0,0,0,0
9831,"['biliao', 'dialogo', 'republico']","[1, 1, 1]","['checar', 'numericament', 'parir', 'parir', 'parir', 'parir']","[1, 1, 4, 4, 4, 4]",3,6,9,0
9832,"[]","[]","['checar', 'numericament']","[1, 1]",0,2,2,0
9833,"[]","[]","['checar', 'numericament']","[1, 1]",0,2,2,0
9834,"['prtb']","[1]","['checar', 'numericament']","[1, 1]",1,2,3,0
9839,"['arthur', 'dedicar', 'lira']","[1, 1, 1]","['circular', 'compartilhar', 'postagen', 'usuario']","[1, 1, 1, 1]",3,4,7,0
9840,"['orientacao', 'pagamento', 'reforcar']","[1, 1, 1]","['circular', 'imagem']","[1, 1]",3,2,5,0
9842,"['crise', 'crise']","[2, 2]","['circular', 'circular', 'soldar']","[2, 2, 1]",2,3,5,0
9845,"['parceiro', 'pratico']","[1, 1]","['basto', 'nordestino', 'protestar']","[1, 1, 1]",2,3,5,0
9846,"['quedo', 'reducao', 'saudar', 'saudar']","[1, 1, 2, 2]","[]","[]",4,0,4,0
9847,"['domingo']","[1]","[]","[]",1,0,1,0
9848,"[]","[]","['curioso']","[1]",0,1,1,0
9857,"['concreto']","[1]","[]","[]",1,0,1,0
9861,"['saudar']","[1]","['basto']","[1]",1,1,2,0
9862,"['privar', 'provisorio', 'regrar', 'saudar', 'suspenso']","[1, 1, 1, 1, 1]","['circular']","[1]",5,1,6,0
9865,"['primeiroministro']","[1]","[]","[]",1,0,1,0
9867,"['client']","[1]","['botao', 'clicar', 'clicar', 'ganhar', 'ganhar']","[1, 2, 2, 2, 2]",1,5,6,0
9870,"['academiar', 'academiar', 'pastar', 'pratico']","[2, 2, 1, 1]","[]","[]",4,0,4,0
9872,"['biliao', 'destinar', 'recurso']","[1, 1, 1]","['atribuir', 'circular', 'compartilhar', 'postagen']","[1, 1, 1, 1]",3,4,7,0
9874,"[]","[]","[]","[]",0,0,0,0
9875,"['esquema', 'intenso']","[1, 1]","['desmaiar']","[1]",2,1,3,0
9879,"[]","[]","['amplament', 'atribuir', 'circular', 'parir', 'supostament']","[1, 1, 1, 1, 1]",0,5,5,0
9881,"[]","[]","[]","[]",0,0,0,0
9882,"['autoridad', 'autoridad', 'integrant']","[2, 2, 1]","['checagem', 'efarsa', 'lupa', 'parir', 'parir', 'verificar']","[1, 1, 1, 2, 2, 1]",3,6,9,0
9884,"[]","[]","['clicar', 'clicar']","[2, 2]",0,2,2,0
9887,"['mello', 'republico']","[1, 1]","['compartilhar', 'espalhar', 'imagem', 'quinzena']","[1, 1, 1, 1]",2,4,6,0
9889,"['observar']","[1]","['circular', 'imagem', 'legendar']","[1, 1, 1]",1,3,4,0
9890,"['cooperacao', 'cooperacao', 'cooperacao', 'crise', 'exercicio', 'investigacao', 'justicar', 'justicar', 'reforcar', 'republico']","[3, 3, 3, 1, 1, 1, 2, 2, 1, 1]","['atribuir', 'circular', 'circular', 'descricao']","[1, 2, 2, 1]",10,4,14,0
9891,"['suspenso']","[1]","['copiar']","[1]",1,1,2,0
9892,"['comissao', 'comissao', 'sigla']","[2, 2, 1]","['fraudar', 'fraudar', 'fraudar']","[3, 3, 3]",3,3,6,0
9895,"[]","[]","['efarsa', 'lupa', 'mentiroso', 'verificacao', 'verificar']","[1, 1, 1, 1, 1]",0,5,5,0
9897,"['antecipar']","[1]","['circular', 'circular', 'falsar', 'fraudar', 'fraudar', 'legendar', 'manipular']","[2, 2, 1, 2, 2, 1, 1]",1,7,8,0
9900,"['decisao']","[1]","['compartilhar', 'fotografia', 'imagem']","[1, 1, 1]",1,3,4,0
9903,"['constatar', 'dedicar', 'espanha', 'infeccioso', 'palacio', 'risco', 'saudar', 'superar']","[1, 1, 1, 1, 1, 1, 1, 1]","['sequer']","[1]",8,1,9,0
9906,"['destinar']","[1]","['inocentar']","[1]",1,1,2,0
9907,"['rejeicao', 'rejeitar']","[1, 1]","['cedula', 'cedula', 'cedula', 'cedula', 'compartilhar', 'fraudar', 'fraudar', 'fraudar', 'ilustrar', 'inscricao', 'manipulacao', 'versao']","[4, 4, 4, 4, 1, 3, 3, 3, 1, 1, 1, 1]",2,12,14,0
9908,"[]","[]","['assassinar', 'assassinar', 'assassinar', 'assassinar', 'assassinar', 'assassinar', 'camisa', 'camiseta', 'camiseta', 'estranhar', 'lixar', 'vc']","[6, 6, 6, 6, 6, 6, 1, 2, 2, 1, 1, 1]",0,12,12,0
9911,"[]","[]","['circular']","[1]",0,1,1,0
9912,"['decisao', 'destacar', 'revogar', 'suspensao']","[1, 1, 1, 1]","['pelar', 'sobrar', 'sobrar', 'verificar']","[1, 2, 2, 1]",4,4,8,0
9913,"['entregu', 'etapa', 'etapa', 'regrar', 'respostar']","[1, 2, 2, 1, 1]","['clicar', 'clicar', 'compartilhar', 'compartilhar', 'enderecar', 'ganhar', 'ganhar', 'instrucao', 'lembres', 'minutar', 'parabem', 'parabem', 'parabem', 'parabem', 'parabem', 'parabem', 'reivindicar', 'selecionar', 'sortir', 'sortir', 'verificar']","[2, 2, 2, 2, 1, 2, 2, 1, 1, 1, 6, 6, 6, 6, 6, 6, 1, 1, 2, 2, 1]",5,21,26,0
9918,"[]","[]","['compartilhar', 'estomago', 'melancia', 'melancia', 'melancia', 'melancia', 'melancia', 'melancia', 'melancia', 'melancia', 'melancia', 'melancia', 'melancia', 'melancia', 'puro']","[1, 1, 12, 12, 12, 12, 12, 12, 12, 12, 12, 12, 12, 12, 1]",0,15,15,0
9919,"[]","[]","[]","[]",0,0,0,0
9922,"['desembarcar', 'guarulho', 'gued', 'presenca', 'turista']","[1, 1, 1, 1, 1]","['dorio', 'dorio', 'dorio', 'dorio', 'protestar']","[4, 4, 4, 4, 1]",5,5,10,0
9923,"['instituto', 'instituto']","[2, 2]","['circular', 'usuario', 'usuario', 'usuario']","[1, 3, 3, 3]",2,4,6,0
9924,"['orientacao', 'planar']","[1, 1]","['basto', 'copiar', 'deitar']","[1, 1, 1]",2,3,5,0
9928,"['disseminacao', 'infectar', 'intensivo', 'isolar', 'prazo', 'temporada']","[1, 1, 1, 1, 1, 1]","[]","[]",6,0,6,0
9930,"['instituto', 'instituto', 'instituto', 'quarentenar', 'souza', 'turma']","[3, 3, 3, 1, 1, 1]","['basto', 'circular', 'circular', 'falsar', 'ganhar']","[1, 2, 2, 1, 1]",6,5,11,0
9931,"['entregu', 'etapa', 'etapa', 'etapa', 'regrar', 'respostar']","[1, 3, 3, 3, 1, 1]","['clicar', 'clicar', 'compartilhar', 'compartilhar', 'enderecar', 'ganhar', 'ganhar', 'ganhar', 'instrucao', 'lembres', 'parabem', 'parabem', 'parabem', 'parabem', 'selecionar', 'sortir', 'sortir', 'usuario', 'vazio', 'verificar']","[2, 2, 2, 2, 1, 3, 3, 3, 1, 1, 4, 4, 4, 4, 1, 2, 2, 1, 1, 1]",6,20,26,0
9933,"['ambientar', 'escalar', 'saudar', 'transmissao']","[1, 1, 1, 1]","['circular']","[1]",4,1,5,0
9936,"['argumentar', 'destacar', 'henri', 'insuficient', 'periodo']","[1, 1, 1, 1, 1]","['wagner']","[1]",5,1,6,0
9939,"['consumidor']","[1]","['circular', 'visualizacao']","[1, 1]",1,2,3,0
9940,"['saudar']","[1]","['filmar', 'filmar', 'filmar']","[3, 3, 3]",1,3,4,0
9941,"['michael']","[1]","['camisa', 'circular', 'imagem']","[1, 1, 1]",1,3,4,0
9942,"[]","[]","['parir', 'pelar']","[1, 1]",0,2,2,0
9943,"['quarentenar']","[1]","['compartilhar', 'fotografo', 'imagem', 'imagem', 'imagem', 'imagem', 'legendar', 'legendar', 'manipulacao']","[1, 1, 4, 4, 4, 4, 2, 2, 1]",1,9,10,0
9944,"[]","[]","[]","[]",0,0,0,0
9945,"['tesourar']","[1]","['imagem', 'quinzena', 'versao']","[1, 1, 1]",1,3,4,0
9947,"['gabinet']","[1]","['revoltar']","[1]",1,1,2,0
9948,"[]","[]","['assassinar']","[1]",0,1,1,0
9950,"[]","[]","[]","[]",0,0,0,0
9951,"[]","[]","['compartilhar', 'inscricao', 'inscricao']","[1, 2, 2]",0,3,3,0
9952,"['boletim', 'obtido']","[1, 1]","['compartilhar', 'fraudar', 'fraudar']","[1, 2, 2]",2,3,5,0
9954,"['autorizacao', 'lewandowski', 'ministrar', 'processo', 'requerimento', 'supremo']","[1, 1, 1, 1, 1, 1]","['cbn', 'circular', 'dubai']","[1, 1, 1]",6,3,9,0
9955,"[]","[]","[]","[]",0,0,0,0
9956,"['comissao', 'constituicao', 'demrj', 'domingo', 'legislativo', 'prever', 'previsao', 'previsto', 'proposto', 'punicao']","[1, 1, 1, 1, 1, 1, 1, 1, 1, 1]","['compartilhar', 'realment', 'sequer']","[1, 1, 1]",10,3,13,0
9962,"[]","[]","['deitar', 'visualizacao']","[1, 1]",0,2,2,0
9963,"['antonio']","[1]","[]","[]",1,0,1,0
9965,"[]","[]","[]","[]",0,0,0,0
9966,"['avancar', 'intenso', 'normalment', 'possibilidad', 'quilometro', 'quilometro', 'regiao', 'regiao', 'regiao']","[1, 1, 1, 1, 2, 2, 3, 3, 3]","['imagem']","[1]",9,1,10,0
9968,"['araujo', 'ernesto', 'ministrar', 'mudanca']","[1, 1, 1, 1]","['capturar', 'ideologia']","[1, 1]",4,2,6,0
9969,"['aplicacao', 'letalidad']","[1, 1]","[]","[]",2,0,2,0
9972,"['articulacao', 'distrito', 'esquema', 'esquema', 'reuniao']","[1, 1, 2, 2, 1]","['greve']","[1]",5,1,6,0
9973,"['desenvolvido', 'elaborar', 'instituto', 'moderno', 'respostar']","[1, 1, 1, 1, 1]","['circular', 'humanar', 'postagen']","[1, 1, 1]",5,3,8,0
9974,"['saudar']","[1]","['circular', 'compartilhar', 'gravacao', 'ilustrar', 'legendar', 'protestar', 'vc']","[1, 1, 1, 1, 1, 1, 1]",1,7,8,0
9975,"[]","[]","['atribuir', 'sobrar', 'versao']","[1, 1, 1]",0,3,3,0
9976,"['restritivo']","[1]","['circular', 'compartilhar', 'imagem', 'parir', 'postagen', 'protestar']","[1, 1, 1, 1, 1, 1]",1,6,7,0
9979,"['situacao']","[1]","['parir', 'parir']","[2, 2]",1,2,3,0
9985,"[]","[]","['narrativo']","[1]",0,1,1,0
9986,"['crise', 'fronteiro', 'mexico', 'previsao']","[1, 1, 1, 1]","['atribuir', 'circular', 'compartilhar', 'versao']","[1, 1, 1, 1]",4,4,8,0
9987,"[]","[]","['parir', 'pelar']","[1, 1]",0,2,2,0
9988,"['boletim', 'flexibilizacao', 'internacao', 'privar', 'reducao']","[1, 1, 1, 1, 1]","['atribuir', 'circular']","[1, 1]",5,2,7,0
9989,"['biliao', 'congresso', 'consultoria', 'dificuldad', 'economia', 'economia', 'escalar', 'especializar', 'gued', 'levantamento', 'ministrar', 'pagamento', 'periodo', 'preocupacao', 'regiao']","[1, 1, 1, 1, 2, 2, 1, 1, 1, 1, 1, 1, 1, 1, 1]","['espalhar']","[1]",15,1,16,0
9993,"['imunizacao']","[1]","['boatar']","[1]",1,1,2,0
9994,"['investigacao', 'necessidad', 'reducao', 'reducao', 'revisar', 'transmissao']","[1, 1, 2, 2, 1, 1]","['checar', 'parir', 'parir', 'pelar', 'sobrar', 'sobrar']","[1, 2, 2, 1, 2, 2]",6,6,12,0
9995,"['crise', 'enxergar', 'enxergar', 'necessidad', 'percepcao', 'quarentenar', 'situacao']","[1, 2, 2, 1, 1, 1, 1]","['amigar', 'lixar', 'padrar', 'sobrar', 'torturar']","[1, 1, 1, 1, 1]",7,5,12,0
9996,"['belgica', 'fase', 'insuficient', 'mudanca', 'reducao']","[1, 1, 1, 1, 1]","['compartilhar', 'realment']","[1, 1]",5,2,7,0
9998,"[]","[]","['incendio', 'pego', 'versao']","[1, 1, 1]",0,3,3,0
10007,"['sabado']","[1]","['atribuir', 'circular', 'circular', 'desmaiar', 'pelar', 'supostament', 'usuario', 'vezar']","[1, 2, 2, 1, 1, 1, 1, 1]",1,8,9,0
10009,"[]","[]","['circular', 'compartilhar', 'imagem', 'parir', 'segundar']","[1, 1, 1, 1, 1]",0,5,5,0
10011,"[]","[]","['arquivar']","[1]",0,1,1,0
10013,"['autoridad', 'importancia', 'proliferacao', 'propagacao', 'reducao', 'respiratorio', 'saudar', 'saudar', 'saudar', 'saudar']","[1, 1, 1, 1, 1, 1, 4, 4, 4, 4]","['carbono', 'cbn', 'circular', 'dioxido']","[1, 1, 1, 1]",10,4,14,0
10014,"['diagnosticar', 'diagnosticar', 'justicar', 'necessidad', 'orientacao', 'planar']","[2, 2, 1, 1, 1, 1]","['circular']","[1]",6,1,7,0
10015,"['deslocamento', 'domingo', 'observar']","[1, 1, 1]","['filmar']","[1]",3,1,4,0
10018,"[]","[]","['manobrar']","[1]",0,1,1,0
10019,"[]","[]","['circular']","[1]",0,1,1,0
10021,"[]","[]","['circular', 'efarsa', 'realment', 'verdadeiro']","[1, 1, 1, 1]",0,4,4,0
10022,"['folhar', 'sabado', 'spaulo']","[1, 1, 1]","['bandeiro', 'circular', 'fotografo', 'imagem', 'imagem', 'imagem', 'legendar', 'protestar']","[1, 1, 1, 3, 3, 3, 1, 1]",3,8,11,0
10023,"[]","[]","['circular', 'circular', 'clicar', 'clicar']","[2, 2, 2, 2]",0,4,4,0
10025,"['realizacao']","[1]","['abortar', 'abortar']","[2, 2]",1,2,3,0
10027,"['enfermagem', 'imunizacao', 'instituto']","[1, 1, 1]","['circular']","[1]",3,1,4,0
10028,"['manutencao']","[1]","['lembres']","[1]",1,1,2,0
10029,"[]","[]","['ganhar', 'realment']","[1, 1]",0,2,2,0
10030,"['colombio', 'integrant']","[1, 1]","[]","[]",2,0,2,0
10031,"[]","[]","['soltar']","[1]",0,1,1,0
10032,"['letalidad', 'taxar']","[1, 1]","['verificar']","[1]",2,1,3,0
10033,"['colunista', 'folhar', 'justicar', 'spaulo', 'suspenso']","[1, 1, 1, 1, 1]","['atribuir', 'espalhar', 'gleisi', 'implantar']","[1, 1, 1, 1]",5,4,9,0
10036,"['consequencia', 'quedo', 'recurso']","[1, 1, 1]","['tampouco']","[1]",3,1,4,0
10037,"['reportar']","[1]","['adorar', 'humanar', 'sacar', 'vc']","[1, 1, 1, 1]",1,4,5,0
10043,"['mudanca', 'vigilancia']","[1, 1]","['gretar', 'usuario']","[1, 1]",2,2,4,0
10044,"[]","[]","['vazar']","[1]",0,1,1,0
10045,"['imunizacao']","[1]","['amigar', 'assinalar', 'circular', 'circular', 'fingir', 'gravacao', 'idioma', 'insinuar', 'legendar', 'postagen', 'usuario']","[1, 1, 2, 2, 1, 1, 1, 1, 1, 1, 1]",1,11,12,0
10047,"[]","[]","['rosario']","[1]",0,1,1,0
10049,"['aspecto', 'concreto', 'dificuldad', 'estatistico', 'quilometro', 'situacao']","[1, 1, 1, 1, 1, 1]","['circular', 'tumulo', 'tumulo']","[1, 2, 2]",6,3,9,0
10051,"['afastamento', 'federativo', 'gued', 'republico', 'republico']","[1, 1, 1, 2, 2]","[]","[]",5,0,5,0
10054,"[]","[]","['amplament', 'atribuir', 'bandeiro', 'compartilhar', 'crer', 'desfilar', 'desfilar', 'fotografia', 'imagem', 'legendar', 'parabem', 'usuario', 'usuario', 'verdadeiro']","[1, 1, 1, 1, 1, 2, 2, 1, 1, 1, 1, 2, 2, 1]",0,14,14,0
10055,"[]","[]","['espalhar']","[1]",0,1,1,0
10056,"['palacio', 'planalto', 'presenca']","[1, 1, 1]","[]","[]",3,0,3,0
10057,"['apreensao', 'recordar']","[1, 1]","['patrocinador', 'trafico']","[1, 1]",2,2,4,0
10060,"['habitant', 'internacao', 'internacao', 'saudar']","[1, 2, 2, 1]","['zincar']","[1]",4,1,5,0
10065,"[]","[]","['efarsa']","[1]",0,1,1,0
10066,"['cenario', 'enfatizar', 'prever']","[1, 1, 1]","[]","[]",3,0,3,0
10071,"[]","[]","[]","[]",0,0,0,0
10072,"['respectivament']","[1]","['boatar', 'circular', 'ganhar', 'gretar', 'gretar', 'gretar', 'gretar', 'ilustrar', 'imagem', 'menino', 'nobel']","[1, 1, 1, 4, 4, 4, 4, 1, 1, 1, 1]",1,11,12,0
10073,"['afp', 'ministrar', 'ministrar', 'ministrar', 'plenario', 'supremo', 'supremo']","[1, 3, 3, 3, 1, 2, 2]","['atirar', 'checar', 'compartilhar', 'gravacao', 'usuario', 'verificacao', 'viralizado', 'visualizar']","[1, 1, 1, 1, 1, 1, 1, 1]",7,8,15,0
10079,"['araujo', 'bancada', 'bancada', 'decisao']","[1, 2, 2, 1]","['circular', 'imagem', 'imagem', 'imagem', 'soltar', 'telejorn', 'telejorn']","[1, 3, 3, 3, 1, 2, 2]",4,7,11,0
10080,"['acumular', 'conformar']","[1, 1]","['enganoso', 'fotografia', 'greve', 'greve', 'imagem', 'lixar', 'lixar', 'lixar', 'telejorn', 'verdadeiro']","[1, 1, 2, 2, 1, 3, 3, 3, 1, 1]",2,10,12,0
10084,"['calendario', 'excecao', 'necessidad']","[1, 1, 1]","[]","[]",3,0,3,0
10087,"['dengu', 'julgamento', 'republico']","[1, 1, 1]","['parabem']","[1]",3,1,4,0
10089,"['flavio', 'queiroz']","[1, 1]","['cocaina', 'cocaina', 'cocaina', 'trafico']","[3, 3, 3, 1]",2,4,6,0
10091,"['avancar', 'paralelo', 'reforcar', 'suspeito']","[1, 1, 1, 1]","['desmentir', 'fraudar', 'fraudar', 'fraudar', 'sobrar']","[1, 3, 3, 3, 1]",4,5,9,0
10092,"['toquio']","[1]","['circular', 'sapato']","[1, 1]",1,2,3,0
10093,"['assistencia', 'parceria', 'realizacao']","[1, 1, 1]","['basto', 'enderecar', 'inscricao', 'inscricao', 'preencher', 'preencher', 'sacar']","[1, 1, 2, 2, 2, 2, 1]",3,7,10,0
10094,"[]","[]","[]","[]",0,0,0,0
10095,"['infectar']","[1]","['circular', 'fotografo', 'imagem', 'imagem', 'legendar']","[1, 1, 2, 2, 1]",1,5,6,0
10098,"[]","[]","['compartilhar', 'incendio']","[1, 1]",0,2,2,0
10105,"['aurelio', 'lewandowski']","[1, 1]","['amigar', 'circular', 'compartilhar', 'postagen', 'usuario']","[1, 1, 1, 1, 1]",2,5,7,0
10106,"['observar']","[1]","[]","[]",1,0,1,0
10107,"['incerteza', 'pereira', 'positivar']","[1, 1, 1]","['circular', 'compartilhar', 'fotografia', 'imagem', 'imagem', 'legendar']","[1, 1, 1, 2, 2, 1]",3,6,9,0
10108,"['plano']","[1]","[]","[]",1,0,1,0
10112,"['pagamento']","[1]","[]","[]",1,0,1,0
10113,"['atuacao', 'funcao', 'rocha', 'sabatino']","[1, 1, 1, 1]","['checar', 'lupa']","[1, 1]",4,2,6,0
10114,"[]","[]","['circular', 'legendar']","[1, 1]",0,2,2,0
10116,"[]","[]","['compartilhar', 'gravacao', 'legendar', 'postagen', 'renunciar', 'vezar']","[1, 1, 1, 1, 1, 1]",0,6,6,0
10117,"['cronica', 'dialogo', 'estrategia']","[1, 1, 1]","['circular', 'postagen', 'replicar', 'torturar', 'usuario']","[1, 1, 1, 1, 1]",3,5,8,0
10119,"['ricardo']","[1]","['acidentar', 'espalhar', 'imagem']","[1, 1, 1]",1,3,4,0
10120,"[]","[]","['chorar', 'parir', 'parir', 'vazio', 'versao', 'versao', 'versao', 'versao', 'versao', 'versao', 'versao']","[1, 2, 2, 1, 7, 7, 7, 7, 7, 7, 7]",0,11,11,0
10121,"[]","[]","['fraudar']","[1]",0,1,1,0
10124,"[]","[]","[]","[]",0,0,0,0
10125,"['fundamentar']","[1]","['caixao', 'caixao', 'caixao', 'caixao', 'caixao', 'circular', 'imagem']","[5, 5, 5, 5, 5, 1, 1]",1,7,8,0
10126,"[]","[]","[]","[]",0,0,0,0
10127,"['converso', 'diagnosticar', 'infectar', 'saudar']","[1, 1, 1, 1]","['circular', 'imagem', 'postagen', 'usuario', 'usuario']","[1, 1, 1, 2, 2]",4,5,9,0
10131,"[]","[]","[]","[]",0,0,0,0
10132,"['nelson', 'nelson']","[2, 2]","['chorar', 'verdadeiro']","[1, 1]",2,2,4,0
10133,"['decisao', 'decisao', 'economia', 'economia', 'gued', 'ministrar', 'reuniao', 'situacao']","[2, 2, 2, 2, 1, 1, 1, 1]","['circular', 'imagem', 'wagner', 'wagner']","[1, 1, 2, 2]",8,4,12,0
10134,"['oferecido']","[1]","['imagem', 'lixar', 'lixar', 'misturar']","[1, 2, 2, 1]",1,4,5,0
10136,"['regiao']","[1]","['espalhar', 'incendio', 'quinzena', 'segundar', 'sobrar']","[1, 1, 1, 1, 1]",1,5,6,0
10138,"[]","[]","['pego']","[1]",0,1,1,0
10141,"['rejeitar']","[1]","[]","[]",1,0,1,0
10142,"['destinar', 'destinar', 'passageiro', 'tripulacao', 'viagem']","[2, 2, 1, 1, 1]","[]","[]",5,0,5,0
10145,"[]","[]","[]","[]",0,0,0,0
10146,"['fluminens', 'sessao']","[1, 1]","['assaltar', 'assassinar', 'circular', 'ganhar', 'imagem', 'replicar']","[1, 1, 1, 1, 1, 1]",2,6,8,0
10148,"['contribuicao']","[1]","['enganir', 'insinuar', 'realment']","[1, 1, 1]",1,3,4,0
10151,"['condicao', 'respirador', 'respostar']","[1, 1, 1]","['chorar', 'chorar', 'chorar', 'chorar', 'chorar']","[5, 5, 5, 5, 5]",3,5,8,0
10152,"['instituto', 'periodo', 'significativo']","[1, 1, 1]","[]","[]",3,0,3,0
10156,"['mudanca', 'mudanca', 'mudanca', 'mudanca', 'mudanca', 'mudanca', 'mudanca', 'mudanca']","[8, 8, 8, 8, 8, 8, 8, 8]","['abencoar', 'biblia', 'biblia', 'crer', 'crer', 'crer', 'cristao', 'cristao', 'cristao', 'cristao', 'escutar', 'obama']","[1, 2, 2, 3, 3, 3, 4, 4, 4, 4, 1, 1]",8,12,20,0
10160,"['balancar']","[1]","[]","[]",1,0,1,0
10162,"['monitoramento', 'possibilidad', 'sudest', 'sudest']","[1, 1, 2, 2]","['parir']","[1]",4,1,5,0
10163,"[]","[]","['clicar', 'crech', 'motorista']","[1, 1, 1]",0,3,3,0
10165,"['prever']","[1]","['cedula', 'cedula', 'cedula', 'cedula', 'cedula', 'cedula', 'fraudar', 'fraudar', 'secreto', 'verdadeiro']","[6, 6, 6, 6, 6, 6, 2, 2, 1, 1]",1,10,11,0
10166,"[]","[]","['espalhar', 'minutar', 'quinzena']","[1, 1, 1]",0,3,3,0
10168,"['planar', 'saudar']","[1, 1]","['assaltar', 'assassinar', 'boatar', 'estranhar', 'humanar', 'menino']","[1, 1, 1, 1, 1, 1]",2,6,8,0
10169,"[]","[]","['circular', 'falsar', 'gasolina', 'sobrar']","[1, 1, 1, 1]",0,4,4,0
10171,"['infectar']","[1]","['deitar']","[1]",1,1,2,0
10172,"['infraestrutura']","[1]","['circular', 'legendar']","[1, 1]",1,2,3,0
10175,"['comissao', 'periodo', 'reforcar', 'saudar']","[1, 1, 1, 1]","['verificar']","[1]",4,1,5,0
10176,"[]","[]","['espalhar', 'parir']","[1, 1]",0,2,2,0
10178,"[]","[]","['compartilhar', 'espalhar']","[1, 1]",0,2,2,0
10180,"['estimativo', 'observar', 'reducao', 'revisar']","[1, 1, 1, 1]","['parir', 'parir', 'realment']","[2, 2, 1]",4,3,7,0
10181,"['biliao', 'impacto', 'importancia', 'saudar', 'surtir', 'suspensao', 'suspensao', 'suspenso']","[1, 1, 1, 1, 1, 2, 2, 1]","['cadastramento', 'sacar']","[1, 1]",8,2,10,0
10186,"['contribuicao']","[1]","['compartilhar', 'nobel', 'quinzena']","[1, 1, 1]",1,3,4,0
10187,"[]","[]","['descricao']","[1]",0,1,1,0
10188,"[]","[]","['compartilhar', 'compartilhar']","[2, 2]",0,2,2,0
10189,"['pacheco', 'pacheco', 'processo', 'processo', 'processo', 'processo']","[2, 2, 4, 4, 4, 4]","['parir', 'vc']","[1, 1]",6,2,8,0
10190,"['respiratorio']","[1]","['autopsia', 'limao', 'suco']","[1, 1, 1]",1,3,4,0
10192,"['belgica', 'delacao', 'delacao', 'delacao', 'possibilidad', 'proposto', 'proposto']","[1, 3, 3, 3, 1, 2, 2]","['verdadeiro']","[1]",7,1,8,0
10195,"['milho']","[1]","['clicar', 'clicar', 'compartilhar', 'compartilhar', 'compartilhar', 'ganhar', 'parabem', 'parabem', 'reivindicar', 'usuario', 'usuario']","[2, 2, 3, 3, 3, 1, 2, 2, 1, 2, 2]",1,11,12,0
10197,"[]","[]","['gravacao', 'imagem', 'verificar']","[1, 1, 1]",0,3,3,0
10198,"['recurso', 'totalizar']","[1, 1]","['capturar', 'capturar', 'capturar', 'compartilhar', 'imagem', 'supostament']","[3, 3, 3, 1, 1, 1]",2,6,8,0
10200,"['biliao', 'crescimento', 'crise', 'desenvolvimento', 'destacar', 'economia', 'economia', 'europeu', 'infraestrutura', 'materiaprima', 'pagamento']","[1, 1, 1, 1, 1, 2, 2, 1, 1, 1, 1]","['compartilhar', 'dorio', 'dorio', 'escravo', 'escravo', 'invadir', 'invadir', 'invadir', 'itamina', 'realment', 'suco']","[1, 2, 2, 2, 2, 3, 3, 3, 1, 1, 1]",11,11,22,0
10201,"['demandar', 'pagamento']","[1, 1]","['compartilhar', 'compartilhar', 'compartilhar', 'preencher', 'realment']","[3, 3, 3, 1, 1]",2,5,7,0
10208,"['bolsonarista']","[1]","['compartilhar', 'parir']","[1, 1]",1,2,3,0
10209,"['andrew', 'posturar']","[1, 1]","['circular', 'imagem']","[1, 1]",2,2,4,0
10211,"['cupula', 'pslsp', 'reuniao', 'viagem']","[1, 1, 1, 1]","['circular', 'compartilhar', 'gravacao', 'postagen', 'vazar']","[1, 1, 1, 1, 1]",4,5,9,0
10214,"['anvisa', 'aprovacao', 'desenvolvido', 'instituto', 'interrupcao', 'parceria', 'vigilancia']","[1, 1, 1, 1, 1, 1, 1]","['atribuir', 'circular', 'compartilhar', 'postagen', 'postagen', 'usuario']","[1, 1, 1, 2, 2, 1]",7,6,13,0
10215,"['federar']","[1]","['imagem', 'mafia']","[1, 1]",1,2,3,0
10216,"['adotada', 'defendido', 'republico']","[1, 1, 1]","[]","[]",3,0,3,0
10221,"['autoridad', 'discussao', 'orientacao']","[1, 1, 1]","['disseminar', 'filmar', 'ganhar']","[1, 1, 1]",3,3,6,0
10225,"['acompanham', 'rocha', 'saudar', 'saudar']","[1, 1, 2, 2]","['abencoar', 'abencoar', 'abencoar', 'abencoar', 'copiar', 'desgracar', 'enfim', 'misericordia', 'misericordia', 'misericordia', 'padrar']","[4, 4, 4, 4, 1, 1, 1, 3, 3, 3, 1]",4,11,15,0
10226,"['despesa', 'distrito', 'esquema']","[1, 1, 1]","[]","[]",3,0,3,0
10227,"['coreia', 'coreia', 'fronteiro']","[2, 2, 1]","['circular', 'imagem', 'imagem', 'imagem', 'imagem', 'manipular', 'manobrar']","[1, 4, 4, 4, 4, 1, 1]",3,7,10,0
10229,"['argumentar', 'propagacao', 'quarentenar', 'realizacao']","[1, 1, 1, 1]","['circular', 'legendar', 'postagen', 'visualizar']","[1, 1, 1, 1]",4,4,8,0
10234,"['deltan', 'respectivament', 'supremo']","[1, 1, 1]","['circular', 'imagem', 'imagem', 'manchet']","[1, 2, 2, 1]",3,4,7,0
10236,"['desafiar']","[1]","['atribuir', 'circular', 'visualizacao']","[1, 1, 1]",1,3,4,0
10237,"['presidir', 'reconhecimento']","[1, 1]","['dorio']","[1]",2,1,3,0
10238,"[]","[]","['circular', 'circular']","[2, 2]",0,2,2,0
10239,"['alerj', 'alerj', 'alerj', 'julgamento', 'julgamento', 'julgamento', 'palacio', 'palacio', 'palacio', 'palacio', 'palacio', 'palacio', 'palacio', 'wilson', 'wilson', 'wilson', 'wilson', 'witzel', 'witzel', 'witzel', 'witzel']","[3, 3, 3, 3, 3, 3, 7, 7, 7, 7, 7, 7, 7, 4, 4, 4, 4, 4, 4, 4, 4]","[]","[]",21,0,21,0
10242,"['europeu', 'iniciativo', 'saudar', 'universitario']","[1, 1, 1, 1]","['checagem', 'circular', 'circular', 'fotografo', 'gravacao', 'imagem', 'imagem', 'imagem', 'imagem', 'imagem', 'inscricao', 'verificar']","[1, 2, 2, 1, 1, 5, 5, 5, 5, 5, 1, 1]",4,12,16,0
10250,"['regrar', 'respostar']","[1, 1]","['enderecar', 'ganhar', 'ganhar', 'parabem', 'parabem', 'questionario', 'selecionar', 'sobrar', 'sortir', 'sortir']","[1, 2, 2, 2, 2, 1, 1, 1, 2, 2]",2,10,12,0
10251,"['gabinet', 'oliveira']","[1, 1]","['adelio', 'bispar', 'compartilhar', 'grupar', 'pelar', 'postagen', 'quinzena', 'rosario']","[1, 1, 1, 1, 1, 1, 1, 1]",2,8,10,0
10257,"['internar', 'saudar']","[1, 1]","['desmentir', 'imagem', 'pelar', 'pelar', 'pelar', 'segundar']","[1, 1, 3, 3, 3, 1]",2,6,8,0
10261,"['inquerito', 'magistrado', 'opcao']","[1, 1, 1]","['parir', 'pelar', 'pelar', 'segundar']","[1, 2, 2, 1]",3,4,7,0
10263,"['afp', 'ambito', 'comparacao', 'condenacao', 'supremo', 'viagem']","[1, 1, 1, 1, 1, 1]","['atribuir', 'checar', 'circular', 'enganar', 'parir', 'parir', 'pelar', 'sobrar', 'verificacao']","[1, 1, 1, 1, 2, 2, 1, 1, 1]",6,9,15,0
10264,"['rocha']","[1]","['compartilhar', 'compartilhar']","[2, 2]",1,2,3,0
10268,"['ministrar', 'ministrar', 'saudar']","[2, 2, 1]","['assinalar', 'circular', 'compartilhar', 'fotografia', 'imagem', 'imagem', 'imagem', 'reverso']","[1, 1, 1, 1, 3, 3, 3, 1]",3,8,11,0
10269,"['ribeiro']","[1]","['assassinar', 'circular']","[1, 1]",1,2,3,0
10273,"['companhia', 'marinhar']","[1, 1]","['espalhar']","[1]",2,1,3,0
10275,"['conformar']","[1]","['realment']","[1]",1,1,2,0
10276,"['crise', 'isolar', 'isolar']","[1, 2, 2]","['casamentar', 'casamentar', 'casamentar']","[3, 3, 3]",3,3,6,0
10277,"['aplicacao']","[1]","['camiseta', 'circular', 'fotografo', 'ganhar', 'imagem', 'imagem', 'inscricao', 'legendar', 'verdadeiro', 'versao']","[1, 1, 1, 1, 2, 2, 1, 1, 1, 1]",1,10,11,0
10278,"['espanha']","[1]","['espalhar']","[1]",1,1,2,0
10279,"[]","[]","['adelio', 'adelio', 'adelio', 'adelio', 'bispar', 'bispar', 'bispar', 'bispar', 'lixar']","[4, 4, 4, 4, 4, 4, 4, 4, 1]",0,9,9,0
10280,"['demandar', 'escassez', 'inicialment', 'privar', 'saudar', 'saudar', 'wilson']","[1, 1, 1, 1, 2, 2, 1]","['checar', 'pelar', 'pelar']","[1, 2, 2]",7,3,10,0
10281,"['epidemiar', 'epidemiar', 'surtir']","[2, 2, 1]","['compartilhar', 'espalhar']","[1, 1]",3,2,5,0
10282,"['contagioso', 'infectar', 'necessidad', 'necessidad', 'necessidad', 'necessidad', 'normalment', 'normalment', 'reabrir', 'viagem']","[1, 1, 4, 4, 4, 4, 2, 2, 1, 1]","['realment']","[1]",10,1,11,0
10283,"['suspeito', 'suspeito']","[2, 2]","['bandeiro']","[1]",2,1,3,0
10287,"[]","[]","[]","[]",0,0,0,0
10288,"[]","[]","['amplament', 'cedula', 'circular', 'gravacao', 'gravacao', 'usuario', 'visualizacao']","[1, 1, 1, 2, 2, 1, 1]",0,7,7,0
10289,"['henriqu']","[1]","['assassinar', 'assassinar', 'camisa', 'camisa', 'camisa', 'estampar']","[2, 2, 3, 3, 3, 1]",1,6,7,0
10290,"['reuter']","[1]","['circular', 'fotografo', 'imagem', 'imagem', 'imagem']","[1, 1, 3, 3, 3]",1,5,6,0
10291,"['internar']","[1]","[]","[]",1,0,1,0
10294,"['necessario']","[1]","['caixao', 'caixao', 'caixao', 'caixao', 'caixao', 'compartilhar', 'imagem', 'imagem', 'vazio', 'vazio']","[5, 5, 5, 5, 5, 1, 2, 2, 2, 2]",1,10,11,0
10296,"[]","[]","[]","[]",0,0,0,0
10297,"['conjuntar']","[1]","['circular', 'circular', 'compartilhar', 'fotografia', 'fotografia', 'fraudar', 'imagem']","[2, 2, 1, 2, 2, 1, 1]",1,7,8,0
10298,"['disseminacao', 'revisar', 'saudar', 'saudar', 'transmissao']","[1, 1, 2, 2, 1]","['capturar', 'circular', 'interaco', 'intitular', 'parir', 'realment', 'usuario', 'versao', 'versao']","[1, 1, 1, 1, 1, 1, 1, 2, 2]",5,9,14,0
10299,"['republico']","[1]","['atribuir', 'verificar']","[1, 1]",1,2,3,0
10300,"['disseminacao', 'necessidad']","[1, 1]","['efarsa', 'espalhar']","[1, 1]",2,2,4,0
10302,"['aspecto', 'contrato', 'contrato', 'contrato', 'irregularidad', 'suspensao']","[1, 3, 3, 3, 1, 1]","['compartilhar', 'verdadeiro']","[1, 1]",6,2,8,0
10303,"['comparacao', 'globonew', 'precedent', 'renata']","[1, 1, 1, 1]","['circular', 'legendar', 'protestar']","[1, 1, 1]",4,3,7,0
10305,"[]","[]","['inocentar', 'inocentar', 'inocentar', 'inocentar', 'maldiz', 'menino', 'menino', 'realment']","[4, 4, 4, 4, 1, 2, 2, 1]",0,8,8,0
10307,"['opcao', 'opcao']","[2, 2]","['basto', 'compartilhar', 'inscricao', 'preencher', 'selecionar']","[1, 1, 1, 1, 1]",2,5,7,0
10308,"['investigacao', 'pereira', 'rigoroso']","[1, 1, 1]","['amigar', 'amigar', 'atribuir', 'cbn', 'circular', 'compartilhar', 'desmentir', 'postagen', 'trafico']","[2, 2, 1, 1, 1, 1, 1, 1, 1]",3,9,12,0
10312,"[]","[]","['sortear']","[1]",0,1,1,0
10314,"[]","[]","['desmentir']","[1]",0,1,1,0
10315,"['contrato']","[1]","['circular']","[1]",1,1,2,0
10316,"[]","[]","['circular', 'imagem', 'legendar', 'usuario']","[1, 1, 1, 1]",0,4,4,0
10320,"['converso', 'vulneravel']","[1, 1]","['circular', 'circular', 'disseminar', 'fraudar', 'ganhar', 'gravacao', 'realment']","[2, 2, 1, 1, 1, 1, 1]",2,7,9,0
10324,"['colaborar', 'estrategia']","[1, 1]","[]","[]",2,0,2,0
10325,"['infectar']","[1]","['parabem']","[1]",1,1,2,0
10328,"[]","[]","['enganoso', 'parir', 'realment', 'sobrar']","[1, 1, 1, 1]",0,4,4,0
10329,"['infeccioso', 'inglaterra']","[1, 1]","[]","[]",2,0,2,0
10334,"['escalar']","[1]","['amplament', 'circular', 'compartilhar', 'garganta', 'garganta', 'garganta', 'humanar', 'postagen', 'viralizada']","[1, 1, 1, 3, 3, 3, 1, 1, 1]",1,9,10,0
10335,"['bolsonarista', 'europeu', 'habitant', 'imunizacao', 'ritmar']","[1, 1, 1, 1, 1]","['parir', 'sobrar']","[1, 1]",5,2,7,0
10337,"['especifico', 'estatistico', 'proporcao', 'regiao', 'sudest']","[1, 1, 1, 1, 1]","['compartilhar', 'grupar', 'grupar', 'parir', 'realment', 'selecionar']","[1, 2, 2, 1, 1, 1]",5,6,11,0
10338,"['viagem']","[1]","['circular', 'compartilhar', 'filmar', 'gravacao', 'imagem', 'imagem', 'legendar']","[1, 1, 1, 1, 2, 2, 1]",1,7,8,0
10343,"['exministro', 'infraestrutura', 'logistico', 'ministrar']","[1, 1, 1, 1]","['capturar', 'circular', 'compartilhar', 'enganoso', 'gravacao', 'legendar', 'legendar', 'lixar', 'reverso', 'supostament', 'visualizar']","[1, 1, 1, 1, 1, 2, 2, 1, 1, 1, 1]",4,11,15,0
10345,"[]","[]","[]","[]",0,0,0,0
10346,"[]","[]","['abencoar', 'compartilhar', 'compartilhar', 'ganhar', 'sortir']","[1, 2, 2, 1, 1]",0,5,5,0
10349,"['cardiologista', 'sabado']","[1, 1]","['pelar', 'pelar']","[2, 2]",2,2,4,0
10351,"[]","[]","[]","[]",0,0,0,0
10352,"['assistenci', 'biliao', 'biliao', 'despesa', 'despesa', 'manutencao', 'manutencao', 'supremo', 'supremo']","[1, 2, 2, 2, 2, 2, 2, 2, 2]","['circular', 'compartilhar', 'imagem', 'incendio']","[1, 1, 1, 1]",9,4,13,0
10354,"['acordo', 'acordo', 'destacar', 'destinar', 'destinar', 'forcatarefa', 'forcatarefa', 'infraestrutura', 'realizacao', 'recurso', 'recurso']","[2, 2, 1, 2, 2, 2, 2, 1, 1, 2, 2]","['atribuir', 'circular', 'insinuar']","[1, 1, 1]",11,3,14,0
10357,"['comprometido', 'compromisso', 'compromisso', 'compromisso', 'condicao', 'condicao', 'conformar', 'economia', 'gued', 'gued', 'gued', 'ministrar', 'ministrar', 'ministrar', 'ministrar', 'proposto', 'reuniao', 'reuniao', 'situacao']","[1, 3, 3, 3, 2, 2, 1, 1, 3, 3, 3, 4, 4, 4, 4, 1, 2, 2, 1]","['compartilhar', 'enganir', 'espalhar', 'maldiz', 'parabem', 'parabem', 'parabem', 'parabem', 'wagner']","[1, 1, 1, 1, 4, 4, 4, 4, 1]",19,9,28,0
10359,"['biliao', 'totalizar']","[1, 1]","['inocentar']","[1]",2,1,3,0
10362,"['apurar', 'colunista', 'concedido', 'conjuntar', 'investigacao', 'sobretudo']","[1, 1, 1, 1, 1, 1]","['catedr', 'catedr', 'falsar', 'incendio', 'incendio', 'incendio', 'lupa', 'maldiz', 'parir', 'verificacao', 'verificar']","[2, 2, 1, 3, 3, 3, 1, 1, 1, 1, 1]",6,11,17,0
10364,"['associacao', 'associacao', 'importancia', 'oficialment', 'saudad', 'tornear']","[2, 2, 1, 1, 1, 1]","[]","[]",6,0,6,0
10365,"[]","[]","['lixar']","[1]",0,1,1,0
10366,"['comorbidad', 'dengu', 'economia', 'infectar', 'infectar', 'infectar', 'normalment', 'observar', 'observar', 'saudar', 'saudar', 'saudar', 'velocidad']","[1, 1, 1, 3, 3, 3, 1, 2, 2, 3, 3, 3, 1]","['compartilhar', 'compartilhar', 'crer', 'crer', 'cuspir', 'cuspir', 'cuspir', 'espalhar', 'espalhar', 'espalhar', 'espalhar', 'espalhar', 'espalhar', 'espalhar', 'imagem', 'puro', 'realment', 'realment']","[2, 2, 2, 2, 3, 3, 3, 7, 7, 7, 7, 7, 7, 7, 1, 1, 2, 2]",13,18,31,0
10368,"[]","[]","['imagem', 'imagem']","[2, 2]",0,2,2,0
10370,"['antecipar', 'boletim', 'conformar', 'justicar', 'sessao']","[1, 1, 1, 1, 1]","[]","[]",5,0,5,0
10371,"['amplo', 'conformar', 'congresso', 'elaborar', 'permanencia', 'sancao']","[1, 1, 1, 1, 1, 1]","['verdadeiro', 'verificacao', 'visualizacao']","[1, 1, 1]",6,3,9,0
10372,"['conjuntar']","[1]","['atirar', 'dubai', 'dubai', 'dubai', 'idioma', 'idioma']","[1, 3, 3, 3, 2, 2]",1,6,7,0
10373,"['infectar', 'precaucao', 'quarentenar', 'totalizar']","[1, 1, 1, 1]","['circular', 'compartilhar']","[1, 1]",4,2,6,0
10375,"[]","[]","['ganhar', 'quinzena', 'segundar', 'usuario']","[1, 1, 1, 1]",0,4,4,0
10376,"['margem', 'pastar']","[1, 1]","['estomago', 'imenso', 'indignar', 'parir', 'puro', 'realment', 'realment']","[1, 1, 1, 1, 1, 2, 2]",2,7,9,0
10377,"['epidemiar']","[1]","['garganta', 'garganta', 'garganta', 'limao', 'limao', 'limao', 'limao', 'limao', 'limao', 'limao']","[3, 3, 3, 7, 7, 7, 7, 7, 7, 7]",1,10,11,0
10379,"['crise', 'crise', 'depressao', 'rotina']","[2, 2, 1, 1]","['chorar', 'chorar']","[2, 2]",4,2,6,0
10380,"['biliao']","[1]","['circular', 'imagem']","[1, 1]",1,2,3,0
10382,"['autorizacao', 'individuar', 'reabertura', 'suspenso']","[1, 1, 1, 1]","['gravacao', 'gravacao', 'imagem']","[2, 2, 1]",4,3,7,0
10383,"[]","[]","[]","[]",0,0,0,0
10385,"['internar', 'justicar', 'lesao', 'lesao']","[1, 1, 2, 2]","['assaltar', 'assaltar', 'espancar', 'espancar', 'espancar', 'rosario']","[2, 2, 3, 3, 3, 1]",4,6,10,0
10390,"['funcionamento']","[1]","['circular', 'supostament']","[1, 1]",1,2,3,0
10392,"[]","[]","['ganhar', 'sortear', 'sortear']","[1, 2, 2]",0,3,3,0
10393,"['apurar', 'justicar', 'justicar']","[1, 2, 2]","['indignacao', 'inocentar', 'inocentar', 'menino', 'menino']","[1, 2, 2, 2, 2]",3,5,8,0
10394,"['alteracao', 'alteracao', 'conjuntar', 'desenvolvido', 'desenvolvimento', 'desenvolvimento', 'reforcar', 'silveiro']","[2, 2, 1, 1, 2, 2, 1, 1]","['compartilhar', 'enganoso']","[1, 1]",8,2,10,0
10395,"[]","[]","['realment']","[1]",0,1,1,0
10397,"[]","[]","['arquivar', 'usuario']","[1, 1]",0,2,2,0
10399,"['aprovacao', 'pagamento']","[1, 1]","['basto', 'cadastramento', 'ganhar']","[1, 1, 1]",2,3,5,0
10400,"['adicionar', 'cardiologista', 'economia', 'economia', 'emprestimo', 'necessario', 'pib']","[1, 1, 2, 2, 1, 1, 1]","[]","[]",7,0,7,0
10401,"['diretoria']","[1]","['checar', 'circular', 'circular', 'circular', 'supostament']","[1, 3, 3, 3, 1]",1,5,6,0
10403,"['mudanca', 'possibilidad']","[1, 1]","[]","[]",2,0,2,0
10406,"['antecipar']","[1]","[]","[]",1,0,1,0
10409,"['afp', 'alteracao', 'capitar']","[1, 1, 1]","['checar', 'compartilhar', 'compartilhar', 'legendar', 'replicar', 'usuario', 'verificar']","[1, 2, 2, 1, 1, 1, 1]",3,7,10,0
10413,"['comportamento', 'observar']","[1, 1]","['menino']","[1]",2,1,3,0
10415,"['aplicacao', 'aplicacao', 'desenvolvido', 'fase', 'instituto', 'letalidad', 'letalidad', 'parceria', 'saudar', 'taxar', 'taxar']","[2, 2, 1, 1, 1, 2, 2, 1, 1, 2, 2]","['postagen']","[1]",11,1,12,0
10418,"['supremo']","[1]","['enganir', 'pelar', 'sobrar']","[1, 1, 1]",1,3,4,0
10419,"['emprestimo', 'emprestimo', 'periodo', 'reuniao']","[2, 2, 1, 1]","['imagem', 'imagem', 'imagem']","[3, 3, 3]",4,3,7,0
10420,"[]","[]","[]","[]",0,0,0,0
10422,"['conflito', 'exercicio', 'queixar', 'saudar']","[1, 1, 1, 1]","['casamentar', 'perdao', 'perdao', 'perdao', 'perdao', 'perdao', 'perdao', 'perdao', 'perdao']","[1, 8, 8, 8, 8, 8, 8, 8, 8]",4,9,13,0
10423,"['rastreamento']","[1]","['minutar', 'missil', 'missil', 'missil', 'missil', 'missil', 'missil', 'missil', 'missil']","[1, 8, 8, 8, 8, 8, 8, 8, 8]",1,9,10,0
10424,"['justicar']","[1]","[]","[]",1,0,1,0
10425,"['lancamento', 'superar']","[1, 1]","['limao', 'limao', 'limao']","[3, 3, 3]",2,3,5,0
10428,"['respiratorio']","[1]","[]","[]",1,0,1,0
10430,"['conflito', 'desenvolvido', 'economia', 'economia', 'espanha', 'paralisar']","[1, 1, 2, 2, 1, 1]","['compartilhar', 'parir']","[1, 1]",6,2,8,0
10433,"[]","[]","['compartilhar', 'preencher']","[1, 1]",0,2,2,0
10435,"[]","[]","['abencoar', 'selecionar']","[1, 1]",0,2,2,0
10436,"[]","[]","['capturar', 'circular', 'compartilhar', 'imagem', 'imagem', 'verdadeiro', 'viralizada']","[1, 1, 1, 2, 2, 1, 1]",0,7,7,0
10437,"[]","[]","['checar', 'numericament']","[1, 1]",0,2,2,0
10438,"[]","[]","['checar', 'numericament']","[1, 1]",0,2,2,0
10439,"['demandar', 'prtb']","[1, 1]","['checar', 'numericament']","[1, 1]",2,2,4,0
10440,"[]","[]","[]","[]",0,0,0,0
10441,"['republico']","[1]","['circular', 'falsar', 'imagem']","[1, 1, 1]",1,3,4,0
10442,"['impactar', 'justicar', 'justicar', 'possibilidad']","[1, 2, 2, 1]","['fraudar', 'manipulacao']","[1, 1]",4,2,6,0
10446,"['jorg']","[1]","[]","[]",1,0,1,0
10448,"['esperancar', 'extraordinario', 'intenso']","[1, 1, 1]","['compartilhar', 'soldar']","[1, 1]",3,2,5,0
10450,"['toquio']","[1]","['misturar', 'pelar', 'postagen']","[1, 1, 1]",1,3,4,0
10452,"['anuncio', 'anuncio', 'destacar', 'epidemiar', 'estatistico', 'sobretudo']","[2, 2, 1, 1, 1, 1]","['circular', 'imagem', 'imagem', 'reverso']","[1, 2, 2, 1]",6,4,10,0
10454,"['desenvolvimento']","[1]","['crer']","[1]",1,1,2,0
10455,"['bandeirant', 'palacio']","[1, 1]","['circular', 'compartilhar', 'imagem', 'legendar', 'legendar', 'postagen', 'reverso', 'viralizada', 'viralizada']","[1, 1, 1, 2, 2, 1, 1, 2, 2]",2,9,11,0
10456,"[]","[]","['espalhar']","[1]",0,1,1,0
10457,"['determinacao', 'justicar', 'mexico', 'reclamacao', 'reportar', 'situacao']","[1, 1, 1, 1, 1, 1]","['circular', 'imagem', 'imagem', 'usuario', 'usuario']","[1, 2, 2, 2, 2]",6,5,11,0
10458,"['regrar', 'respostar']","[1, 1]","['enderecar', 'ganhar', 'ganhar', 'parabem', 'parabem', 'parir', 'questionario', 'selecionar', 'sobrar', 'sortir']","[1, 2, 2, 2, 2, 1, 1, 1, 1, 1]",2,10,12,0
10459,"[]","[]","[]","[]",0,0,0,0
10460,"[]","[]","['clicar', 'ganhar', 'ganhar', 'ganhar', 'ganhar']","[1, 4, 4, 4, 4]",0,5,5,0
10461,"['descumprimento']","[1]","[]","[]",1,0,1,0
10462,"['entregu', 'regrar', 'respostar']","[1, 1, 1]","['clicar', 'clicar', 'compartilhar', 'compartilhar', 'enderecar', 'galaxi', 'galaxi', 'galaxi', 'galaxi', 'ganhar', 'ganhar', 'ganhar', 'instrucao', 'minutar', 'parabem', 'parabem', 'selecionar', 'sortir', 'usuario', 'usuario']","[2, 2, 2, 2, 1, 4, 4, 4, 4, 3, 3, 3, 1, 1, 2, 2, 1, 1, 2, 2]",3,20,23,0
10464,"['toquio', 'toquio']","[2, 2]","['circular', 'imagem', 'mencao']","[1, 1, 1]",2,3,5,0
10468,"['suspeito']","[1]","['vazar']","[1]",1,1,2,0
10470,"[]","[]","['compartilhar', 'usuario']","[1, 1]",0,2,2,0
10474,"['informaco', 'ministrar', 'santiago']","[1, 1, 1]","['sobrar']","[1]",3,1,4,0
10479,"['exjuiz', 'expressar', 'imitacao', 'justicar', 'ministrar']","[1, 1, 1, 1, 1]","['circular']","[1]",5,1,6,0
10486,"['saudar']","[1]","['parir', 'parir', 'parir', 'realment']","[3, 3, 3, 1]",1,4,5,0
10487,"['disseminacao', 'habito', 'reforcar', 'umido']","[1, 1, 1, 1]","['circular', 'sapato']","[1, 1]",4,2,6,0
10488,"[]","[]","['ganhar', 'ganhar', 'ganhar', 'rouanet']","[3, 3, 3, 1]",0,4,4,0
10490,"[]","[]","['espalhar', 'filmar', 'imagem', 'quinzena']","[1, 1, 1, 1]",0,4,4,0
10491,"['intenso', 'previsao', 'previsao', 'previsao', 'silveiro']","[1, 3, 3, 3, 1]","['circular']","[1]",5,1,6,0
10492,"['estatistico']","[1]","['caixao', 'caixao', 'escutar', 'escutar', 'sortir', 'sortir', 'tumulo', 'tumulo']","[2, 2, 2, 2, 2, 2, 2, 2]",1,8,9,0
10494,"['colegio', 'domingo', 'tucano']","[1, 1, 1]","['bandeiro', 'circular', 'estampar', 'imagem']","[1, 1, 1, 1]",3,4,7,0
10495,"['cirurgico', 'enxergar', 'exercicio', 'reabertura', 'respiratorio', 'sentenca']","[1, 1, 1, 1, 1, 1]","['falsar', 'zincar', 'zincar', 'zincar']","[1, 3, 3, 3]",6,4,10,0
10497,"[]","[]","['capturar', 'capturar', 'circular', 'circular', 'circular', 'imagem', 'imagem', 'legendar', 'versao', 'versao']","[2, 2, 3, 3, 3, 2, 2, 1, 2, 2]",0,10,10,0
10499,"['avancar', 'humanitario', 'intenso', 'planar', 'previsao', 'regiao', 'regiao', 'regiao']","[1, 1, 1, 1, 1, 3, 3, 3]","['parir', 'pelar']","[1, 1]",8,2,10,0
10500,"[]","[]","['circular', 'humanar', 'legendar']","[1, 1, 1]",0,3,3,0
10501,"['carat', 'esperancar', 'intenso', 'margem', 'necessario', 'previsao', 'regiao', 'ribeiro', 'superar']","[1, 1, 1, 1, 1, 1, 1, 1, 1]","['barragem', 'barragem', 'barragem', 'barragem']","[4, 4, 4, 4]",9,4,13,0
10502,"[]","[]","[]","[]",0,0,0,0
10503,"['recordar']","[1]","['checar', 'numericament']","[1, 1]",1,2,3,0
10504,"[]","[]","['checar', 'numericament']","[1, 1]",0,2,2,0
10505,"['celso']","[1]","['checar', 'numericament']","[1, 1]",1,2,3,0
10506,"['biliao', 'biliao', 'celso']","[2, 2, 1]","['checar', 'numericament']","[1, 1]",3,2,5,0
10507,"['celso']","[1]","['checar', 'numericament']","[1, 1]",1,2,3,0
10508,"['guaruja', 'triplex']","[1, 1]","['checar', 'numericament', 'parir']","[1, 1, 1]",2,3,5,0
10509,"['biliao']","[1]","['checar', 'numericament', 'pelar']","[1, 1, 1]",1,3,4,0
10510,"['constituicao']","[1]","['checar', 'numericament', 'parir']","[1, 1, 1]",1,3,4,0
10511,"[]","[]","['checar', 'numericament']","[1, 1]",0,2,2,0
10513,"['aglomeracao', 'atuam']","[1, 1]","['arquivar', 'capturar', 'circular', 'circular', 'compartilhar', 'ilustrar', 'legendar', 'postagen']","[1, 1, 2, 2, 1, 1, 1, 1]",2,8,10,0
10515,"['aplicacao', 'atendido', 'dosar', 'fabricacao', 'hospitalizar', 'instituto', 'instituto', 'saudar', 'saudar', 'significativo']","[1, 1, 1, 1, 1, 2, 2, 2, 2, 1]","['cbn', 'circular']","[1, 1]",10,2,12,0
10516,"['decisao', 'prever']","[1, 1]","[]","[]",2,0,2,0
10523,"['constatar', 'levantamento']","[1, 1]","['compartilhar']","[1]",2,1,3,0
10525,"['ministrar', 'situacao', 'situacao']","[1, 2, 2]","['chorar']","[1]",3,1,4,0
10526,"['gabinet', 'saudar']","[1, 1]","['desfilar', 'manobrar', 'menino', 'parir', 'perdao']","[1, 1, 1, 1, 1]",2,5,7,0
10527,"[]","[]","['socialismo']","[1]",0,1,1,0
10529,"[]","[]","[]","[]",0,0,0,0
10530,"['flavio', 'flavio']","[2, 2]","['bandeiro', 'bandeiro', 'bandeiro', 'bandeiro']","[4, 4, 4, 4]",2,4,6,0
10531,"['roraima', 'sudest', 'suportar']","[1, 1, 1]","['compartilhar', 'ganhar', 'nordestino']","[1, 1, 1]",3,3,6,0
10532,"[]","[]","['circular', 'legendar', 'mafia']","[1, 1, 1]",0,3,3,0
10533,"[]","[]","['circular', 'compartilhar', 'fraudar', 'fraudar', 'fraudar', 'idioma', 'imagem', 'legendar']","[1, 1, 3, 3, 3, 1, 1, 1]",0,8,8,0
10536,"[]","[]","['estuprar', 'torturar', 'torturar']","[1, 2, 2]",0,3,3,0
10538,"[]","[]","[]","[]",0,0,0,0
10539,"['anuncio', 'especifico', 'instituto', 'metropolitano', 'regiao']","[1, 1, 1, 1, 1]","['circular', 'circular', 'imagem', 'imagem', 'mansao']","[2, 2, 2, 2, 1]",5,5,10,0
10541,"[]","[]","['arquivar', 'disseminar']","[1, 1]",0,2,2,0
10543,"['comportament', 'comportament', 'comportament', 'conduta', 'desafiar', 'destinar', 'diminuicao', 'feriar', 'importancia', 'mudanca', 'mudanca', 'mudanca', 'observacao', 'observacao', 'oliveira', 'periodo', 'planar', 'planar', 'planar', 'plano', 'pratico', 'pratico', 'presenciar', 'situacao', 'tripulacao']","[3, 3, 3, 1, 1, 1, 1, 1, 1, 3, 3, 3, 2, 2, 1, 1, 3, 3, 3, 1, 2, 2, 1, 1, 1]","['puro']","[1]",25,1,26,0
10545,"['domingo']","[1]","['atribuir', 'circular', 'lixar']","[1, 1, 1]",1,3,4,0
10550,"['colaboracao', 'regiao']","[1, 1]","['filmar', 'incendio']","[1, 1]",2,2,4,0
10551,"['epidemiar']","[1]","['postagen', 'verificacao']","[1, 1]",1,2,3,0
10552,"['condenacao', 'decisao', 'decisao', 'decisao', 'edson', 'edson', 'fachin', 'fachin', 'fachin', 'ministrar', 'ministrar', 'ministrar', 'supremo']","[1, 3, 3, 3, 2, 2, 3, 3, 3, 3, 3, 3, 1]","['gravacao', 'legendar', 'postagen', 'versao', 'visualizar']","[1, 1, 1, 1, 1]",13,5,18,0
10554,"[]","[]","['clicar', 'compartilhar', 'compartilhar', 'compartilhar', 'compartilhar', 'ganhar', 'parabem']","[1, 4, 4, 4, 4, 1, 1]",0,7,7,0
10557,"['alvorar', 'alvorar', 'palacio', 'palacio']","[2, 2, 2, 2]","['ganhar']","[1]",4,1,5,0
10565,"['instalacao', 'provisorio']","[1, 1]","[]","[]",2,0,2,0
10568,"[]","[]","['compartilhar', 'imagem']","[1, 1]",0,2,2,0
10570,"['instituto']","[1]","[]","[]",1,0,1,0
10571,"['curso']","[1]","['enderecar']","[1]",1,1,2,0
10572,"['bbc', 'reuter']","[1, 1]","['circular', 'imagem', 'imagem', 'legendar', 'tampouco']","[1, 2, 2, 1, 1]",2,5,7,0
10573,"['mexico']","[1]","[]","[]",1,0,1,0
10574,"['decisao', 'fundacao', 'henriqu', 'quedo', 'regiao', 'roraima', 'roraima', 'supremo']","[1, 1, 1, 1, 1, 2, 2, 1]","['imagem']","[1]",8,1,9,0
10576,"[]","[]","['cartaz', 'cartaz', 'circular', 'circular', 'circular', 'desmentir', 'falsar', 'logotipo']","[2, 2, 3, 3, 3, 1, 1, 1]",0,8,8,0
10578,"['associacao', 'associacao', 'associacao', 'bancada', 'integrant']","[3, 3, 3, 1, 1]","['compartilhar']","[1]",5,1,6,0
10582,"['metropolitano', 'regiao']","[1, 1]","['barragem', 'circular', 'rompimento', 'venezuelano', 'venezuelano']","[1, 1, 1, 2, 2]",2,5,7,0
10586,"[]","[]","['menino', 'menino', 'menino', 'parabem', 'parabem', 'parabem', 'versao']","[3, 3, 3, 3, 3, 3, 1]",0,7,7,0
10588,"[]","[]","['versao']","[1]",0,1,1,0
10590,"['ambientar']","[1]","['imagem', 'imagem', 'lixar', 'parir']","[2, 2, 1, 1]",1,4,5,0
10591,"['instituto', 'possibilidad', 'sabado', 'velocidad']","[1, 1, 1, 1]","['atribuir', 'circular']","[1, 1]",4,2,6,0
10592,"[]","[]","['circular', 'verdadeiro']","[1, 1]",0,2,2,0
10594,"['florido', 'quilometro']","[1, 1]","['segundar']","[1]",2,1,3,0
10598,"['ambito', 'condenacao', 'desembarcar', 'plenario', 'supremo', 'viagem']","[1, 1, 1, 1, 1, 1]","['circular', 'circular', 'compartilhar']","[2, 2, 1]",6,3,9,0
10601,"['reabertura', 'subir', 'subir', 'ventilador']","[1, 2, 2, 1]","['circular', 'circular', 'compartilhar', 'drone', 'gravacao', 'imagem', 'imagem', 'torrar', 'torrar']","[2, 2, 1, 1, 1, 2, 2, 2, 2]",4,9,13,0
10603,"[]","[]","['compartilhar', 'espalhar']","[1, 1]",0,2,2,0
10608,"[]","[]","['ganhar']","[1]",0,1,1,0
10612,"['congresso', 'decisao', 'vetar', 'vetar']","[1, 1, 2, 2]","['circular', 'compartilhar', 'postagen', 'sequer']","[1, 1, 1, 1]",4,4,8,0
10614,"['passageiro', 'passageiro']","[2, 2]","['dubai', 'dubai']","[2, 2]",2,2,4,0
10615,"['justicar', 'recurso', 'servidor']","[1, 1, 1]","['auditoria', 'invadir', 'invadir', 'usuario', 'vazar', 'vazar']","[1, 2, 2, 1, 2, 2]",3,6,9,0
10621,"['ambientar', 'necessario']","[1, 1]","['abusar', 'estuprar', 'parir', 'parir', 'parir']","[1, 1, 3, 3, 3]",2,5,7,0
10623,"['crise', 'desenvolvido', 'estrategia', 'imunizacao', 'instituto', 'saudar']","[1, 1, 1, 1, 1, 1]","[]","[]",6,0,6,0
10628,"[]","[]","['espalhar', 'quinzena']","[1, 1]",0,2,2,0
10639,"['apurar', 'aurelio', 'disseminacao', 'inquerito', 'inquerito', 'integrant', 'investigacao', 'julgamento', 'julgamento', 'ministrar', 'ministrar', 'ministrar', 'ministrar', 'ministrar', 'ministrar', 'plenario', 'supremo', 'supremo', 'supremo']","[1, 1, 1, 2, 2, 1, 1, 2, 2, 6, 6, 6, 6, 6, 6, 1, 3, 3, 3]","['atirar', 'circular', 'circular', 'falsar', 'imagem', 'legendar']","[1, 2, 2, 1, 1, 1]",19,6,25,0
10641,"['dificuldad', 'diminuicao', 'percepcao', 'transmissao']","[1, 1, 1, 1]","['crech']","[1]",4,1,5,0
10643,"['cepa', 'economia', 'infraestrutura', 'planar', 'regiao']","[1, 1, 1, 1, 1]","['disseminar', 'dorio', 'enganar', 'realment']","[1, 1, 1, 1]",5,4,9,0
10646,"['legislativo', 'proposto', 'reducao', 'servidor']","[1, 1, 1, 1]","[]","[]",4,0,4,0
10647,"[]","[]","['arquivar']","[1]",0,1,1,0
10649,"['decisao', 'implementacao', 'possibilidad', 'revogar', 'suspensao']","[1, 1, 1, 1, 1]","['compartilhar', 'compartilhar', 'usuario']","[2, 2, 1]",5,3,8,0
10650,"[]","[]","['disseminar', 'disseminar']","[2, 2]",0,2,2,0
10651,"[]","[]","['boatar', 'circular', 'circular', 'compartilhar', 'fraudar']","[1, 2, 2, 1, 1]",0,5,5,0
10652,"['adulto', 'adulto', 'compromisso']","[2, 2, 1]","['circular', 'disfarcar', 'ideologia', 'patrocinador']","[1, 1, 1, 1]",3,4,7,0
10653,"['magistrado', 'presidir', 'supremo', 'supremo', 'supremo']","[1, 1, 3, 3, 3]","['abusar', 'abusar', 'fraudar', 'legendar', 'viralizado']","[2, 2, 1, 1, 1]",5,5,10,0
10654,"['flavio', 'funcionamento', 'propagacao']","[1, 1, 1]","['agredir', 'amplament', 'camisa', 'compartilhar', 'gravacao', 'replicar', 'reverso', 'usuario', 'viralizado']","[1, 1, 1, 1, 1, 1, 1, 1, 1]",3,9,12,0
10655,"[]","[]","[]","[]",0,0,0,0
10656,"['especifico', 'provisorio']","[1, 1]","['segundar', 'sobrar']","[1, 1]",2,2,4,0
10657,"[]","[]","[]","[]",0,0,0,0
10658,"['vetar', 'vetar']","[2, 2]","['desfilar', 'desfilar', 'trafico']","[2, 2, 1]",2,3,5,0
10659,"['bancada', 'painel']","[1, 1]","['circular', 'imagem', 'quinzena']","[1, 1, 1]",2,3,5,0
10662,"['atendido', 'equivalent', 'prever', 'recurso']","[1, 1, 1, 1]","['circular', 'manipular', 'manipular', 'verdadeiro']","[1, 2, 2, 1]",4,4,8,0
10663,"[]","[]","['secreto']","[1]",0,1,1,0
10665,"[]","[]","['atirar', 'vazar', 'venezuelano']","[1, 1, 1]",0,3,3,0
10667,"[]","[]","[]","[]",0,0,0,0
10668,"[]","[]","[]","[]",0,0,0,0
10669,"['justicar', 'lesao']","[1, 1]","['pelar', 'rosario']","[1, 1]",2,2,4,0
10670,"['congresso', 'domicilio', 'domicilio', 'domicilio', 'privar']","[1, 3, 3, 3, 1]","['circular']","[1]",5,1,6,0
10671,"[]","[]","['indignar', 'parir', 'parir', 'sobrar']","[1, 2, 2, 1]",0,4,4,0
10673,"['assintomatico', 'dosar', 'dosar', 'observar', 'reducao', 'reducao', 'saudar', 'taxar']","[1, 2, 2, 1, 2, 2, 1, 1]","['circular']","[1]",8,1,9,0
10675,"['acumular', 'associacao', 'estatistico', 'semestr']","[1, 1, 1, 1]","['compartilhar', 'realment']","[1, 1]",4,2,6,0
10677,"['imunizacao', 'perspectivo']","[1, 1]","['cbn', 'compartilhar', 'compartilhar', 'imagem', 'imagem', 'inscricao', 'legendar']","[1, 2, 2, 2, 2, 1, 1]",2,7,9,0
10678,"['compromisso', 'flavio', 'infraestrutura', 'logistico']","[1, 1, 1, 1]","['bandeiro', 'bandeiro', 'circular', 'imagem']","[2, 2, 1, 1]",4,4,8,0
10681,"['adotada', 'alteracao', 'anvisa', 'anvisa', 'dosar', 'significativo', 'vigilancia']","[1, 1, 2, 2, 1, 1, 1]","['circular']","[1]",7,1,8,0
10683,"[]","[]","[]","[]",0,0,0,0
10685,"['milho', 'milho']","[2, 2]","['basto', 'basto', 'inscricao', 'inscricao', 'misturar']","[2, 2, 2, 2, 1]",2,5,7,0
10686,"['instalacao']","[1]","['parir', 'segundar']","[1, 1]",1,2,3,0
10688,"[]","[]","['abusar', 'copiar']","[1, 1]",0,2,2,0
10689,"['congresso', 'demrj', 'ministrar', 'reclamacao', 'republico', 'supremo']","[1, 1, 1, 1, 1, 1]","['circular', 'compartilhar', 'legendar']","[1, 1, 1]",6,3,9,0
10692,"['congresso', 'gabinet', 'gabinet', 'oliveira']","[1, 2, 2, 1]","['adelio', 'adelio', 'bispar', 'compartilhar', 'desmentir', 'facada', 'postagen', 'rosario', 'rosario', 'rosario', 'verificar']","[2, 2, 1, 1, 1, 1, 1, 3, 3, 3, 1]",4,11,15,0
10693,"['periodo', 'quarentenar', 'recuperacao', 'saudar']","[1, 1, 1, 1]","['circular', 'compartilhar', 'legendar', 'legendar', 'parir', 'parir', 'reverso', 'visualizar']","[1, 1, 2, 2, 2, 2, 1, 1]",4,8,12,0
10695,"[]","[]","['parabem', 'parabem', 'secreto', 'supostament']","[2, 2, 1, 1]",0,4,4,0
10698,"['condicao']","[1]","[]","[]",1,0,1,0
10699,"['antonio']","[1]","[]","[]",1,0,1,0
10703,"[]","[]","['imagem', 'nobel', 'nobel', 'nobel', 'zincar']","[1, 3, 3, 3, 1]",0,5,5,0
10704,"[]","[]","[]","[]",0,0,0,0
10706,"['consumidor', 'manutencao', 'regiao', 'sabado']","[1, 1, 1, 1]","['desligar']","[1]",4,1,5,0
10709,"[]","[]","[]","[]",0,0,0,0
10711,"['circulacao', 'suspenso', 'taxar']","[1, 1, 1]","['compartilhar']","[1]",3,1,4,0
10715,"['aglomeracao', 'autoridad', 'condicao', 'condicao', 'situacao', 'situacao', 'situacao']","[1, 1, 2, 2, 3, 3, 3]","['desmaiar', 'desmaiar', 'verdadeiro']","[2, 2, 1]",7,3,10,0
10720,"['desmatamento', 'desmatamento', 'instituto', 'periodo', 'periodo', 'preliminar', 'regiao', 'regiao', 'transicao']","[2, 2, 1, 2, 2, 1, 2, 2, 1]","['arvor', 'compartilhar']","[1, 1]",9,2,11,0
10721,"['administrativo', 'belgica', 'presenca', 'sabado', 'saudar', 'saudar']","[1, 1, 1, 1, 2, 2]","['circular', 'imagem', 'imagem', 'protestar', 'protestar', 'protestar']","[1, 2, 2, 3, 3, 3]",6,6,12,0
10723,"[]","[]","['caixao', 'caixao', 'supostament', 'supostament']","[2, 2, 2, 2]",0,4,4,0
10729,"[]","[]","['descricao', 'visualizacao']","[1, 1]",0,2,2,0
10732,"['espanha', 'itamarati', 'preparacao', 'previo', 'tripulacao', 'viagem', 'voo']","[1, 1, 1, 1, 1, 1, 1]","['cocaina']","[1]",7,1,8,0
10735,"['calheiro', 'esquema', 'esquema', 'provisorio']","[1, 2, 2, 1]","['enganoso', 'sobrar']","[1, 1]",4,2,6,0
10736,"['bruto', 'comparacao', 'comparacao', 'consultoria', 'crescimento', 'economia', 'elaborar', 'internar', 'pib', 'pib', 'pib', 'trimestr', 'trimestr', 'trimestr']","[1, 2, 2, 1, 1, 1, 1, 1, 3, 3, 3, 3, 3, 3]","['compartilhar', 'falsar', 'misturar', 'verdadeiro']","[1, 1, 1, 1]",14,4,18,0
10737,"['punicao', 'supremo']","[1, 1]","['enganar', 'parir', 'parir', 'parir', 'venezuelano', 'venezuelano']","[1, 3, 3, 3, 2, 2]",2,6,8,0
10740,"['barroso']","[1]","['lixar']","[1]",1,1,2,0
10741,"['agravamento', 'dedicar', 'depoimento', 'fase', 'fase', 'investigacao', 'ministrar', 'privar', 'risco', 'saudar', 'saudar', 'saudar']","[1, 1, 1, 2, 2, 1, 1, 1, 1, 3, 3, 3]","['humanar']","[1]",12,1,13,0
10742,"['comparacao']","[1]","['postagen']","[1]",1,1,2,0
10743,"['aprovacao', 'celebrar', 'decisao', 'infectar']","[1, 1, 1, 1]","[]","[]",4,0,4,0
10745,"['bastidor', 'expressar', 'prtb']","[1, 1, 1]","['compartilhar', 'usuario']","[1, 1]",3,2,5,0
10746,"['europeu', 'legislativo', 'plenario', 'presenca', 'presenca']","[1, 1, 1, 2, 2]","['circular', 'circular', 'circular', 'compartilhar', 'desmentir', 'legendar', 'legendar', 'usuario']","[3, 3, 3, 1, 1, 2, 2, 1]",5,8,13,0
10747,"['dialogo']","[1]","['versao', 'versao', 'versao']","[3, 3, 3]",1,3,4,0
10748,"['destinar']","[1]","['cocaina', 'cocaina', 'enderecar', 'parir', 'puro']","[2, 2, 1, 1, 1]",1,5,6,0
10749,"[]","[]","['agredir', 'compartilhar', 'espalhar', 'espancar', 'pelar']","[1, 1, 1, 1, 1]",0,5,5,0
10750,"[]","[]","[]","[]",0,0,0,0
10752,"[]","[]","['imagem', 'imagem', 'verificar']","[2, 2, 1]",0,3,3,0
10755,"['anvisa', 'aprovacao', 'calendario', 'estrategia', 'imunizacao', 'imunizacao', 'previsto', 'saudar', 'saudar']","[1, 1, 1, 1, 2, 2, 1, 2, 2]","['cartaz', 'circular']","[1, 1]",9,2,11,0
10758,"['monitoramento', 'regrar', 'vigilancia']","[1, 1, 1]","['terrorismo']","[1]",3,1,4,0
10759,"['impactar', 'instituto', 'instituto', 'previo', 'transmissao']","[1, 2, 2, 1, 1]","['atribuir', 'circular', 'espalhar']","[1, 1, 1]",5,3,8,0
10760,"['espirito', 'legislativo']","[1, 1]","[]","[]",2,0,2,0
10763,"['afp', 'andrea']","[1, 1]","['basto', 'checagem', 'circular', 'desmentir', 'enderecar', 'legendar', 'menino']","[1, 1, 1, 1, 1, 1, 1]",2,7,9,0
10766,"['ambientar', 'conformar', 'fundacao', 'varga']","[1, 1, 1, 1]","['huawei', 'secreto']","[1, 1]",4,2,6,0
10767,"[]","[]","['tampouco']","[1]",0,1,1,0
10768,"[]","[]","['clicar', 'compartilhar', 'compartilhar', 'ganhar', 'ganhar', 'instrucao', 'sortear']","[1, 2, 2, 2, 2, 1, 1]",0,7,7,0
10769,"[]","[]","['circular']","[1]",0,1,1,0
10770,"['machadar', 'wellington']","[1, 1]","['espalhar', 'parir', 'pelar']","[1, 1, 1]",2,3,5,0
10773,"['independentement', 'saudar']","[1, 1]","['circular']","[1]",2,1,3,0
10774,"[]","[]","['manipular']","[1]",0,1,1,0
10775,"[]","[]","['assassinar', 'assassinar', 'assassinar', 'assassinar', 'assassinar', 'verdadeiro']","[5, 5, 5, 5, 5, 1]",0,6,6,0
10776,"['desenvolvimento', 'fabricacao', 'impulsionar', 'instituto']","[1, 1, 1, 1]","['circular', 'compartilhar', 'insinuar']","[1, 1, 1]",4,3,7,0
10778,"['consorcio', 'infraestrutura']","[1, 1]","['circular', 'legendar']","[1, 1]",2,2,4,0
10779,"['investigacao', 'ministrar']","[1, 1]","[]","[]",2,0,2,0
10780,"['client', 'equipamento', 'equipamento']","[1, 2, 2]","['circular', 'dubai', 'legendar']","[1, 1, 1]",3,3,6,0
10781,"['destinar', 'recurso']","[1, 1]","['atribuir', 'circular', 'circular', 'compartilhar', 'imagem', 'incendio']","[1, 2, 2, 1, 1, 1]",2,6,8,0
10782,"['implementar', 'necessario', 'posicionamento']","[1, 1, 1]","[]","[]",3,0,3,0
10783,"['velocidad']","[1]","['acidentar', 'imagem', 'invadir', 'quinzena']","[1, 1, 1, 1]",1,4,5,0
10785,"[]","[]","['trafico', 'versao']","[1, 1]",0,2,2,0
10786,"['afp', 'constatar']","[1, 1]","['checagem', 'circular', 'compartilhar', 'descricao', 'fotografia', 'legendar', 'reverso', 'transposicao']","[1, 1, 1, 1, 1, 1, 1, 1]",2,8,10,0
10787,"['celebrar', 'contemplar', 'iniciativo', 'prever', 'republico', 'sancao', 'sancao', 'sancao', 'tramitacao', 'volumar']","[1, 1, 1, 1, 1, 3, 3, 3, 1, 1]","['biblia', 'boatar', 'circular', 'circular', 'desmentir']","[1, 1, 2, 2, 1]",10,5,15,0
10788,"['alternativo', 'quedo']","[1, 1]","['estranhar']","[1]",2,1,3,0
10789,"['avancar', 'expectativa', 'saudar', 'saudar']","[1, 1, 2, 2]","['circular', 'compartilhar', 'ganhar']","[1, 1, 1]",4,3,7,0
10791,"[]","[]","['checar']","[1]",0,1,1,0
10792,"['portavoz']","[1]","['cartaz', 'circular', 'intitular', 'legendar', 'logotipo']","[1, 1, 1, 1, 1]",1,5,6,0
10794,"['aspecto', 'assistencia', 'assistencia', 'economia', 'necessario', 'previsao']","[1, 2, 2, 1, 1, 1]","['lembres', 'realment', 'socialismo', 'socialismo', 'socialismo']","[1, 1, 3, 3, 3]",6,5,11,0
10795,"[]","[]","['adorar', 'circular', 'compartilhar', 'gravacao', 'legendar', 'parabem', 'parabem', 'revoltar', 'viralizado']","[1, 1, 1, 1, 1, 2, 2, 1, 1]",0,9,9,0
10799,"[]","[]","['catedr', 'incendio', 'incendio', 'parir', 'revoltar', 'revoltar', 'usuario']","[1, 2, 2, 1, 2, 2, 1]",0,7,7,0
10802,"['anvisa', 'equipamento']","[1, 1]","['cbn', 'circular']","[1, 1]",2,2,4,0
10803,"['anuncio', 'anuncio', 'parceiro', 'portavoz']","[2, 2, 1, 1]","['boatar', 'circular', 'circular', 'imagem', 'inscricao', 'legendar', 'mencao', 'versao', 'versao', 'viralizado', 'visualizacao']","[1, 2, 2, 1, 1, 1, 1, 2, 2, 1, 1]",4,11,15,0
10808,"[]","[]","['clicar', 'clicar', 'copiar', 'postagen', 'postagen', 'postagen']","[2, 2, 1, 3, 3, 3]",0,6,6,0
10809,"['assistencia', 'desenvolvimento', 'itamarati']","[1, 1, 1]","[]","[]",3,0,3,0
10814,"[]","[]","['soldar', 'soldar', 'torturar']","[2, 2, 1]",0,3,3,0
10815,"['academico', 'reducao', 'saudar']","[1, 1, 1]","['enfim', 'manipulacao']","[1, 1]",3,2,5,0
10819,"['atuam', 'instituto', 'instituto', 'psicologo', 'silveiro', 'silveiro']","[1, 2, 2, 1, 2, 2]","['compartilhar', 'compartilhar', 'filmar']","[2, 2, 1]",6,3,9,0
10821,"['barroso']","[1]","['compartilhar', 'gravacao', 'venezuelano']","[1, 1, 1]",1,3,4,0
10822,"['parceria']","[1]","['clicar', 'compartilhar', 'compartilhar', 'compartilhar', 'realment']","[1, 3, 3, 3, 1]",1,5,6,0
10824,"[]","[]","[]","[]",0,0,0,0
10830,"['comparacao']","[1]","['compartilhar', 'enganoso', 'sobrar', 'sobrar']","[1, 1, 2, 2]",1,4,5,0
10831,"['aprovacao', 'comissao', 'fase']","[1, 1, 1]","['cobaia', 'enganoso', 'humanar']","[1, 1, 1]",3,3,6,0
10832,"['lorenzoni', 'ministrar', 'parceiro', 'transmissao', 'transmissao']","[1, 1, 1, 2, 2]","['abencoar', 'abencoar', 'cristao']","[2, 2, 1]",5,3,8,0
10833,"['destinar', 'elaborar', 'instituto', 'respirador', 'respirador', 'saudar']","[1, 1, 1, 2, 2, 1]","['cartaz', 'cartaz', 'cartaz', 'circular', 'legendar', 'logotipo', 'sequer']","[3, 3, 3, 1, 1, 1, 1]",6,7,13,0
10834,"['contencao', 'quarentenar']","[1, 1]","['atribuir']","[1]",2,1,3,0
10835,"['dosar', 'reforcar', 'taxar']","[1, 1, 1]","[]","[]",3,0,3,0
10836,"[]","[]","['clicar', 'compartilhar', 'compartilhar', 'ganhar', 'ganhar', 'instrucao', 'parabem', 'reivindicar', 'reivindicar']","[1, 2, 2, 2, 2, 1, 1, 2, 2]",0,9,9,0
10837,"['alckmin', 'alckmin', 'chefiar', 'chefiar', 'chefiar', 'companhia', 'condicao', 'constituicao', 'decisao', 'desembarcar', 'economia', 'geraldo', 'gued', 'gued', 'importancia', 'investigacao', 'justicar', 'justicar', 'ministrar', 'ministrar', 'nomeacao', 'nomeacao', 'periodo', 'ramagem', 'republico', 'republico', 'substituto', 'supremo', 'supremo', 'supremo', 'tucano']","[2, 2, 3, 3, 3, 1, 1, 1, 1, 1, 1, 1, 2, 2, 1, 1, 2, 2, 2, 2, 2, 2, 1, 1, 2, 2, 1, 3, 3, 3, 1]","['camisa', 'imenso']","[1, 1]",31,2,33,0
10839,"[]","[]","['circular', 'deitar', 'fingir', 'imagem', 'sequer']","[1, 1, 1, 1, 1]",0,5,5,0
10841,"['iniciativo', 'instituto', 'vespera']","[1, 1, 1]","['circular']","[1]",3,1,4,0
10844,"[]","[]","['facada', 'inocentar']","[1, 1]",0,2,2,0
10845,"['excecao', 'ibg', 'ibg', 'ibg', 'ibg', 'instituto', 'saudar', 'saudar', 'saudar', 'saudar', 'saudar', 'saudar']","[1, 4, 4, 4, 4, 1, 6, 6, 6, 6, 6, 6]","['amigar', 'circular', 'circular', 'lixar', 'pego', 'pego', 'pego']","[1, 2, 2, 1, 3, 3, 3]",12,7,19,0
10846,"['diminuicao', 'ministrar', 'quedo', 'quedo', 'regiao', 'saudar', 'tendencia']","[1, 1, 2, 2, 1, 1, 1]","[]","[]",7,0,7,0
10847,"['alergia', 'autoridad', 'infeccioso', 'instituto', 'saudar']","[1, 1, 1, 1, 1]","['amigar', 'parir', 'segundar', 'segundar']","[1, 1, 2, 2]",5,4,9,0
10849,"['especialment', 'exercicio', 'instituto', 'instituto', 'instituto', 'necessario', 'periodo', 'prever', 'previsao']","[1, 1, 3, 3, 3, 1, 1, 1, 1]","['desmaiar', 'equador', 'sequer', 'telejorn', 'verificar']","[1, 1, 1, 1, 1]",9,5,14,0
10851,"['anuncio', 'anuncio', 'anuncio', 'flavio', 'investigacao', 'respostar', 'rocha']","[3, 3, 3, 1, 1, 1, 1]","['assassinar', 'boicotar', 'circular', 'versao', 'viralizado']","[1, 1, 1, 1, 1]",7,5,12,0
10856,"['epidemiar', 'kong', 'kong', 'mexico', 'respiratorio', 'surtir', 'surtir']","[1, 2, 2, 1, 1, 2, 2]","['circular', 'verificar']","[1, 1]",7,2,9,0
10857,"['destacar', 'domingo', 'justicar', 'ministrar']","[1, 1, 1, 1]","['bandeiro', 'camisa', 'cartaz', 'imagem']","[1, 1, 1, 1]",4,4,8,0
10858,"['antonio', 'gabinet', 'saudar', 'sindicato']","[1, 1, 1, 1]","['chorar', 'desfilar', 'manobrar', 'menino', 'parir', 'parir', 'parir', 'parir', 'parir', 'parir', 'parir', 'parir', 'parir', 'parir', 'pelar', 'perdao', 'quantum']","[1, 1, 1, 1, 10, 10, 10, 10, 10, 10, 10, 10, 10, 10, 1, 1, 1]",4,17,21,0
10859,"['consecutivo', 'observar', 'relativo']","[1, 1, 1]","['pelar', 'pelar', 'pelar', 'segundar']","[3, 3, 3, 1]",3,4,7,0
10863,"['recordar']","[1]","['compartilhar', 'incendio', 'postagen', 'replicar']","[1, 1, 1, 1]",1,4,5,0
10865,"['afetado', 'comparacao']","[1, 1]","[]","[]",2,0,2,0
10866,"[]","[]","['ganhar', 'secreto']","[1, 1]",0,2,2,0
10867,"[]","[]","['assinalar', 'atribuir', 'carrefour', 'carrefour', 'carrefour', 'checar', 'circular', 'compartilhar', 'espancar', 'postagen']","[1, 1, 3, 3, 3, 1, 1, 1, 1, 1]",0,10,10,0
10872,"[]","[]","[]","[]",0,0,0,0
10874,"[]","[]","['maldiz', 'maldiz', 'socialismo']","[2, 2, 1]",0,3,3,0
10875,"['bancada', 'oliveira', 'revogar']","[1, 1, 1]","['casamentar', 'cristao', 'maldiz']","[1, 1, 1]",3,3,6,0
10877,"['rocha']","[1]","['atribuir']","[1]",1,1,2,0
10881,"[]","[]","['parabem', 'versao', 'versao']","[1, 2, 2]",0,3,3,0
10884,"['alteracao', 'concedido', 'congresso', 'constituicao', 'constituicao', 'economia', 'economia', 'emendar', 'fase', 'gued', 'ministrar', 'necessario', 'periodo', 'prever', 'propagacao', 'proposto', 'provisorio', 'tramitacao']","[1, 1, 1, 2, 2, 2, 2, 1, 1, 1, 1, 1, 1, 1, 1, 1, 1, 1]","['boatar', 'circular']","[1, 1]",18,2,20,0
10885,"['antonio', 'monitoram', 'planar', 'temor', 'transmissao']","[1, 1, 1, 1, 1]","['barragem', 'circular', 'imagem', 'postagen']","[1, 1, 1, 1]",5,4,9,0
10886,"['apurar', 'apurar']","[2, 2]","['fraudar']","[1]",2,1,3,0
10888,"['situacao']","[1]","[]","[]",1,0,1,0
10889,"['alergia', 'crise', 'individuar', 'michael', 'saudar', 'saudar', 'saudar']","[1, 1, 1, 1, 3, 3, 3]","['checagem', 'checar', 'circular', 'legendar']","[1, 1, 1, 1]",7,4,11,0
10890,"['adicionar', 'instituto']","[1, 1]","['circular', 'verdadeiro']","[1, 1]",2,2,4,0
10891,"['espirito', 'ministrar', 'preservar']","[1, 1, 1]","['cocaina', 'cocaina', 'cocaina', 'protestar', 'quantum']","[3, 3, 3, 1, 1]",3,5,8,0
10892,"['justicar', 'justicar', 'justicar', 'justicar', 'mendonca', 'mendonca', 'mendonca', 'mendonca', 'ministrar', 'ministrar', 'ministrar', 'ministrar']","[4, 4, 4, 4, 4, 4, 4, 4, 4, 4, 4, 4]","['abencoar', 'cristao']","[1, 1]",12,2,14,0
10895,"[]","[]","[]","[]",0,0,0,0
10896,"['fronteiro', 'fronteiro', 'fronteiro']","[3, 3, 3]","[]","[]",3,0,3,0
10897,"['previsao']","[1]","['circular']","[1]",1,1,2,0
10898,"['afp', 'desembarcar']","[1, 1]","['checar', 'compartilhar', 'compartilhar', 'equador', 'equador', 'gravacao', 'imagem', 'imagem', 'verificacao']","[1, 2, 2, 2, 2, 1, 2, 2, 1]",2,9,11,0
10902,"['goncalo']","[1]","['chorar', 'pego']","[1, 1]",1,2,3,0
10903,"['academiar']","[1]","[]","[]",1,0,1,0
10904,"['anvisa', 'especifico', 'instituto', 'interrupcao', 'suspensao', 'temporario']","[1, 1, 1, 1, 1, 1]","[]","[]",6,0,6,0
10905,"['bastidor', 'esquema', 'estrategico', 'facilitar', 'fundamentar', 'liderar', 'orientacao', 'planar', 'prazo', 'reforcar', 'reuniao', 'reuniao', 'situacao', 'situacao', 'urbano', 'urbano']","[1, 1, 1, 1, 1, 1, 1, 1, 1, 1, 2, 2, 2, 2, 2, 2]","['atribuir', 'faccao', 'faccao', 'incendio', 'terrorismo', 'terrorismo', 'terrorismo']","[1, 2, 2, 1, 3, 3, 3]",16,7,23,0
10909,"['monitoramento']","[1]","['compartilhar', 'supostament']","[1, 1]",1,2,3,0
10910,"['autoridad', 'companhia']","[1, 1]","[]","[]",2,0,2,0
10913,"['importancia', 'julgamento', 'lorenzoni', 'ministrar', 'ministrar', 'ministrar', 'ministrar', 'onyx']","[1, 1, 1, 4, 4, 4, 4, 1]","['atribuir', 'atribuir', 'obama', 'obama', 'soldar', 'soldar', 'soldar', 'soldar', 'soldar', 'soldar', 'soldar', 'vc']","[2, 2, 2, 2, 7, 7, 7, 7, 7, 7, 7, 1]",8,12,20,0
10914,"['quarentenar']","[1]","['clicar', 'indignacao', 'mansao', 'viralizado']","[1, 1, 1, 1]",1,4,5,0
10915,"[]","[]","[]","[]",0,0,0,0
10916,"['cenario', 'distant', 'henriqu']","[1, 1, 1]","['circular', 'compartilhar', 'fingir']","[1, 1, 1]",3,3,6,0
10918,"['periodo', 'respostar', 'suspensao', 'treinar']","[1, 1, 1, 1]","['boatar']","[1]",4,1,5,0
10920,"['dificuldad', 'internar', 'positivar', 'saudar']","[1, 1, 1, 1]","[]","[]",4,0,4,0
10923,"['agravamento', 'autorizacao', 'internacao', 'situacao']","[1, 1, 1, 1]","['captar', 'circular', 'enganoso', 'estranhar', 'imagem', 'legendar']","[1, 1, 1, 1, 1, 1]",4,6,10,0
10924,"[]","[]","['assassinar']","[1]",0,1,1,0
10928,"['definitivo']","[1]","['compartilhar', 'quinzena']","[1, 1]",1,2,3,0
10930,"[]","[]","['desligar', 'desligar', 'grupar', 'parir', 'vc', 'versao', 'versao']","[2, 2, 1, 1, 1, 2, 2]",0,7,7,0
10931,"['anuncio']","[1]","['arvor', 'arvor', 'circular', 'compartilhar']","[2, 2, 1, 1]",1,4,5,0
10934,"['habitant', 'levantamento']","[1, 1]","['atribuir', 'circular']","[1, 1]",2,2,4,0
10939,"['ministrar', 'reducao', 'spaulo']","[1, 1, 1]","['checar', 'espalhar', 'fotografia', 'imagem', 'pelar', 'supostament']","[1, 1, 1, 1, 1, 1]",3,6,9,0
10940,"['associacao', 'dengu', 'dengu', 'dengu', 'justicar', 'republico']","[1, 3, 3, 3, 1, 1]","[]","[]",6,0,6,0
10941,"['plano']","[1]","['copiar']","[1]",1,1,2,0
10942,"['afp', 'infectar', 'infectar', 'ministrar', 'ministrar', 'ministrar', 'ministrar', 'ministrar', 'ministrar', 'portavoz', 'positivar', 'positivar', 'positivar', 'punicao', 'punicao', 'punicao', 'saudar', 'saudar', 'saudar']","[1, 2, 2, 6, 6, 6, 6, 6, 6, 1, 3, 3, 3, 3, 3, 3, 3, 3, 3]","['assinalar', 'checagem', 'compartilhar']","[1, 1, 1]",19,3,22,0
10943,"['fronteiro', 'provincia']","[1, 1]","['circular', 'compartilhar', 'idioma', 'legendar']","[1, 1, 1, 1]",2,4,6,0
10944,"['claudio', 'estimular']","[1, 1]","['crech', 'crech', 'crech', 'crech', 'vc']","[4, 4, 4, 4, 1]",2,5,7,0
10945,"['reuniao', 'reuniao', 'surtir']","[2, 2, 1]","['atribuir', 'atribuir', 'checar', 'circular', 'mencao', 'mencao', 'mentiroso', 'tampouco', 'verificar', 'versao']","[2, 2, 1, 1, 2, 2, 1, 1, 1, 1]",3,10,13,0
10946,"['previsto', 'regiao']","[1, 1]","['gravacao', 'incendio', 'incendio', 'incendio', 'insinuar']","[1, 3, 3, 3, 1]",2,5,7,0
10949,"['congresso']","[1]","['bonner', 'greve', 'greve', 'greve', 'greve', 'parir']","[1, 4, 4, 4, 4, 1]",1,6,7,0
10951,"['exministro', 'exministro']","[2, 2]","['circular', 'legendar', 'verificar']","[1, 1, 1]",2,3,5,0
10952,"[]","[]","[]","[]",0,0,0,0
10953,"['investigacao', 'justicar', 'supremo', 'sustentabilidad']","[1, 1, 1, 1]","['compartilhar', 'compartilhar']","[2, 2]",4,2,6,0
10954,"['adversario', 'logistico', 'necessario', 'possibilidad', 'prazo', 'prazo', 'presenciar', 'prever', 'privatizacao', 'rastreamento', 'remessar', 'remessar']","[1, 1, 1, 1, 2, 2, 1, 1, 1, 1, 2, 2]","['boicotar', 'boicotar', 'boicotar', 'circular', 'imenso', 'inscricao']","[3, 3, 3, 1, 1, 1]",12,6,18,0
10955,"['examinar', 'negativar']","[1, 1]","['desgracar', 'imagem', 'realment']","[1, 1, 1]",2,3,5,0
10956,"['curso', 'diagnosticar']","[1, 1]","[]","[]",2,0,2,0
10958,"['condicao', 'congresso', 'economia', 'equipamento', 'equipamento', 'necessario', 'parceria', 'privar', 'respostar']","[1, 1, 1, 2, 2, 1, 1, 1, 1]","['compartilhar', 'imagem', 'postagen']","[1, 1, 1]",9,3,12,0
10961,"['comparacao', 'equipamento', 'normalment', 'periodo', 'prever']","[1, 1, 1, 1, 1]","['compartilhar', 'imagem', 'usuario', 'usuario']","[1, 1, 2, 2]",5,4,9,0
10964,"['instituto', 'parceria', 'superar']","[1, 1, 1]","['circular', 'compartilhar', 'enganar', 'imagem', 'postagen', 'replicar']","[1, 1, 1, 1, 1, 1]",3,6,9,0
10965,"['mudanca']","[1]","[]","[]",1,0,1,0
10968,"['autoridad', 'autoridad', 'proporcao']","[2, 2, 1]","['compartilhar', 'espalhar', 'lixar']","[1, 1, 1]",3,3,6,0
10969,"['ernesto', 'gabinet', 'heleno', 'heleno', 'heleno', 'plano', 'plano', 'plano']","[1, 1, 3, 3, 3, 3, 3, 3]","['parir', 'sacar']","[1, 1]",8,2,10,0
10970,"['periodo']","[1]","['basto', 'chorar', 'ganhar']","[1, 1, 1]",1,3,4,0
10971,"['domingo', 'regrar', 'turista', 'turma']","[1, 1, 1, 1]","['amigar', 'desligar', 'misericordia']","[1, 1, 1]",4,3,7,0
10972,"[]","[]","['imagem']","[1]",0,1,1,0
10973,"['epidemiar', 'implementacao']","[1, 1]","[]","[]",2,0,2,0
10975,"[]","[]","['parir', 'postagen']","[1, 1]",0,2,2,0
10976,"['associacao']","[1]","['circular']","[1]",1,1,2,0
10977,"[]","[]","[]","[]",0,0,0,0
10978,"[]","[]","['compartilhar']","[1]",0,1,1,0
10979,"[]","[]","['biblia', 'biblia', 'catolico', 'catolico', 'cristao', 'cristao', 'desgracar']","[2, 2, 2, 2, 2, 2, 1]",0,7,7,0
10980,"['autoridad', 'pereira', 'publicitario', 'saudar']","[1, 1, 1, 1]","['circular', 'fotografo', 'legendar']","[1, 1, 1]",4,3,7,0
10983,"['tesourar']","[1]","['invadir', 'versao', 'versao']","[1, 2, 2]",1,3,4,0
10985,"['apostar', 'apostar', 'fluminens', 'justicar', 'patamar', 'permanencia']","[2, 2, 1, 1, 1, 1]","['chorar', 'libertador', 'reivindicar']","[1, 1, 1]",6,3,9,0
10988,"['previsao', 'saudar']","[1, 1]","['verificar']","[1]",2,1,3,0
10989,"[]","[]","['verdadeiro']","[1]",0,1,1,0
10993,"[]","[]","['vezar']","[1]",0,1,1,0
11003,"[]","[]","['compartilhar']","[1]",0,1,1,0
11004,"[]","[]","['compartilhar']","[1]",0,1,1,0
11008,"['boletim', 'justicar', 'ribeiro']","[1, 1, 1]","['basto', 'circular', 'fraudar', 'imagem']","[1, 1, 1, 1]",3,4,7,0
11009,"['juro', 'resolucao', 'resolucao', 'resolucao']","[1, 3, 3, 3]","['checar', 'checar', 'checar', 'checar', 'checar', 'checar', 'vc']","[6, 6, 6, 6, 6, 6, 1]",4,7,11,0
11010,"['equipamento', 'infectar', 'justicar', 'positivar']","[1, 1, 1, 1]","['cbn', 'circular', 'compartilhar', 'legendar', 'legendar']","[1, 1, 1, 2, 2]",4,5,9,0
11012,"[]","[]","[]","[]",0,0,0,0
11015,"[]","[]","['adelio', 'bispar']","[1, 1]",0,2,2,0
11017,"['alerj', 'alerj', 'aliquota', 'justificativo', 'justificativo', 'legislativo', 'mudanca', 'mudanca', 'proposto', 'servidor', 'wilson', 'witzel']","[2, 2, 1, 2, 2, 1, 2, 2, 1, 1, 1, 1]","['checar', 'lupa', 'lupa', 'verificar']","[1, 2, 2, 1]",12,4,16,0
11019,"['previsao', 'saudar']","[1, 1]","[]","[]",2,0,2,0
11020,"['claudio', 'crise', 'orientacao', 'orientacao']","[1, 1, 2, 2]","['circular', 'falsar', 'falsar', 'imagem', 'intitular']","[1, 2, 2, 1, 1]",4,5,9,0
11024,"['complicacao', 'complicacao', 'complicacao', 'internacao', 'internar', 'internar', 'internar', 'internar', 'suspeito']","[3, 3, 3, 1, 4, 4, 4, 4, 1]","[]","[]",9,0,9,0
11026,"['diariament', 'epidemiar']","[1, 1]","['botao', 'clicar', 'clicar', 'parabem']","[1, 2, 2, 1]",2,4,6,0
11029,"[]","[]","['assaltar', 'compartilhar']","[1, 1]",0,2,2,0
11032,"['equipamento']","[1]","['circular', 'logotipo']","[1, 1]",1,2,3,0
11033,"['condenacao', 'edson', 'fachin', 'ministrar']","[1, 1, 1, 1]","['circular', 'circular', 'compartilhar', 'imagem', 'imagem', 'imagem', 'legendar', 'wagner']","[2, 2, 1, 3, 3, 3, 1, 1]",4,8,12,0
11035,"['integrant', 'jurista', 'posicionamento', 'psicologo', 'resolucao', 'reuniao', 'reuniao']","[1, 1, 1, 1, 1, 2, 2]","['verificar', 'viralizado']","[1, 1]",7,2,9,0
11036,"[]","[]","[]","[]",0,0,0,0
11037,"['instituto', 'necessidad', 'orcamentaria', 'orcamentaria', 'pastar', 'previsao', 'primario', 'recebido', 'recurso', 'semestr']","[1, 1, 2, 2, 1, 1, 1, 1, 1, 1]","['circular', 'compartilhar']","[1, 1]",10,2,12,0
11039,"[]","[]","['curioso', 'espalhar', 'imagem']","[1, 1, 1]",0,3,3,0
11040,"['florido']","[1]","['verdadeiro']","[1]",1,1,2,0
11043,"['avancar']","[1]","[]","[]",1,0,1,0
11045,"['autoridad', 'avancar', 'curvo', 'defendido', 'infectar', 'saudar', 'saudar']","[1, 1, 1, 1, 1, 2, 2]","['atirar', 'circular', 'imagem', 'imagem', 'legendar']","[1, 1, 2, 2, 1]",7,5,12,0
11046,"['regrar', 'respostar']","[1, 1]","['clicar', 'clicar', 'compartilhar', 'compartilhar', 'enderecar', 'ganhar', 'ganhar', 'ganhar', 'huawei', 'huawei', 'instrucao', 'parabem', 'parabem', 'parir', 'parir', 'parir', 'questionario', 'reivindicar', 'selecionar', 'sobrar', 'sortir']","[2, 2, 2, 2, 1, 3, 3, 3, 2, 2, 1, 2, 2, 3, 3, 3, 1, 1, 1, 1, 1]",2,21,23,0
11050,"['ministrar', 'subir']","[1, 1]","[]","[]",2,0,2,0
11052,"['funcionamento', 'isolar', 'respostar', 'transmissao']","[1, 1, 1, 1]","['gravacao', 'invadir', 'invadir']","[1, 2, 2]",4,3,7,0
11054,"['emendar', 'fundacao', 'fundacao', 'fundacao', 'instituto', 'instituto']","[1, 3, 3, 3, 2, 2]","['capturar', 'invadir', 'realment', 'vazar', 'vazar', 'vazar']","[1, 1, 1, 3, 3, 3]",6,6,12,0
11056,"['administrativo']","[1]","[]","[]",1,0,1,0
11057,"[]","[]","['checar']","[1]",0,1,1,0
11058,"['capitar']","[1]","['checar']","[1]",1,1,2,0
11059,"['witzel']","[1]","['checar']","[1]",1,1,2,0
11060,"[]","[]","['abortar', 'checar']","[1, 1]",0,2,2,0
11061,"['congresso', 'discussao', 'independentement', 'orientacao']","[1, 1, 1, 1]","['checar', 'parir']","[1, 1]",4,2,6,0
11062,"['situacao']","[1]","['checar', 'quantum']","[1, 1]",1,2,3,0
11063,"[]","[]","['checar']","[1]",0,1,1,0
11064,"[]","[]","['checar']","[1]",0,1,1,0
11065,"[]","[]","['checar']","[1]",0,1,1,0
11066,"['privar']","[1]","['checar']","[1]",1,1,2,0
11067,"[]","[]","['checar']","[1]",0,1,1,0
11068,"['unanimidad']","[1]","['checar']","[1]",1,1,2,0
11069,"['privilegiar', 'respostar']","[1, 1]","['amplament', 'camisa', 'capturar', 'capturar', 'circular', 'idioma', 'postagen', 'usuario']","[1, 1, 2, 2, 1, 1, 1, 1]",2,8,10,0
11070,"['palacio', 'planalto', 'republico', 'viagem']","[1, 1, 1, 1]","['copiar']","[1]",4,1,5,0
11071,"['aplicacao', 'dosar', 'dosar', 'observar', 'oferecido']","[1, 2, 2, 1, 1]","['circular']","[1]",5,1,6,0
11074,"['infectar', 'internacao', 'possibilidad', 'quadro']","[1, 1, 1, 1]","['circular', 'desmentir', 'quantum']","[1, 1, 1]",4,3,7,0
11075,"[]","[]","['adelio', 'adelio', 'bispar', 'bispar', 'cbn', 'circular', 'wylli', 'wylli']","[2, 2, 2, 2, 1, 1, 2, 2]",0,8,8,0
11076,"[]","[]","['arquivar', 'usuario']","[1, 1]",0,2,2,0
11078,"['jornada']","[1]","['imagem']","[1]",1,1,2,0
11079,"['turma', 'turma']","[2, 2]","['versao', 'versao', 'versao', 'wagner', 'wagner']","[3, 3, 3, 2, 2]",2,5,7,0
11083,"['agravar', 'alteracao', 'comportament', 'estagio', 'prazo']","[1, 1, 1, 1, 1]","[]","[]",5,0,5,0
11084,"[]","[]","['compartilhar']","[1]",0,1,1,0
11086,"['associacao', 'dosar']","[1, 1]","[]","[]",2,0,2,0
11088,"['depressao', 'saudar']","[1, 1]","['greve', 'invadir', 'melancia', 'melancia', 'melancia', 'melancia', 'melancia', 'melancia', 'melancia', 'melancia', 'melancia', 'vazar']","[1, 1, 9, 9, 9, 9, 9, 9, 9, 9, 9, 1]",2,12,14,0
11089,"['decorrencia', 'preocupacao']","[1, 1]","['disseminar', 'espalhar']","[1, 1]",2,2,4,0
11092,"[]","[]","['cedula', 'fraudar', 'fraudar', 'fraudar']","[1, 3, 3, 3]",0,4,4,0
11094,"['complicacao', 'possibilidad']","[1, 1]","['atribuir', 'circular']","[1, 1]",2,2,4,0
11097,"['quedo', 'ritmar', 'treinar', 'treinar']","[1, 1, 2, 2]","['desfilar', 'desfilar', 'desfilar', 'desfilar', 'dubai', 'dubai']","[4, 4, 4, 4, 2, 2]",4,6,10,0
11098,"[]","[]","['humanar']","[1]",0,1,1,0
11099,"[]","[]","['telejorn']","[1]",0,1,1,0
11100,"['infraestrutura', 'realizacao', 'regiao']","[1, 1, 1]","['postagen', 'postagen', 'tampouco']","[2, 2, 1]",3,3,6,0
11102,"['emprestimo', 'parceria', 'ricardo']","[1, 1, 1]","['circular', 'enganoso', 'humanar', 'imagem', 'parir', 'pelar', 'sobrar']","[1, 1, 1, 1, 1, 1, 1]",3,7,10,0
11105,"['anvisa', 'aprovacao', 'opcao', 'opcao', 'supremo']","[1, 1, 2, 2, 1]","['compartilhar', 'postagen', 'supostament']","[1, 1, 1]",5,3,8,0
11106,"['diretoria', 'folhar', 'justificativo', 'mudanca', 'pagamento', 'reportar', 'situacao']","[1, 1, 1, 1, 1, 1, 1]","['espalhar', 'espalhar', 'ganhar', 'gasolina', 'gasolina', 'gasolina', 'gasolina', 'gasolina', 'manipular', 'sapato']","[2, 2, 1, 5, 5, 5, 5, 5, 1, 1]",7,10,17,0
11109,"['desenvolvimento', 'fase', 'instituto']","[1, 1, 1]","[]","[]",3,0,3,0
11111,"['parceria']","[1]","['cnh', 'cnh', 'cnh', 'cnh', 'cnh', 'compartilhar', 'compartilhar', 'compartilhar', 'compartilhar', 'ganhar', 'inscricao', 'inscricao', 'motorista']","[5, 5, 5, 5, 5, 4, 4, 4, 4, 1, 2, 2, 1]",1,13,14,0
11114,"['fluxo', 'trafego']","[1, 1]","['circular', 'imagem', 'imagem', 'imagem', 'replicar', 'reverso']","[1, 3, 3, 3, 1, 1]",2,6,8,0
11116,"['absoluto', 'biliao', 'conjuntar', 'coordenar', 'diariament', 'espanha', 'europeu', 'europeu', 'gabinet', 'gued', 'henriqu', 'henriqu', 'inglaterra', 'marinhar', 'planar', 'primeiroministro', 'prioridad', 'privar', 'reforcar']","[1, 1, 1, 1, 1, 1, 2, 2, 1, 1, 2, 2, 1, 1, 1, 1, 1, 1, 1]","['amigar', 'amigar', 'basto', 'cbn', 'cbn', 'cbn', 'cbn', 'desgracar', 'dorio', 'dorio', 'dorio', 'expulsar', 'expulsar', 'obama', 'socialismo', 'socialismo', 'socialismo', 'socialismo', 'socialismo', 'socialismo']","[2, 2, 1, 4, 4, 4, 4, 1, 3, 3, 3, 2, 2, 1, 6, 6, 6, 6, 6, 6]",19,20,39,0
11118,"['disseminacao', 'saudar', 'saudar', 'saudar']","[1, 3, 3, 3]","['carbono', 'cbn', 'circular', 'compartilhar', 'desmentir', 'dioxido']","[1, 1, 1, 1, 1, 1]",4,6,10,0
11120,"['domingo', 'provisorio']","[1, 1]","['torturar', 'trafico']","[1, 1]",2,2,4,0
11122,"['decorrencia', 'negativar', 'revisar']","[1, 1, 1]","['compartilhar', 'fraudar']","[1, 1]",3,2,5,0
11123,"['condicao', 'dificuldad', 'exigencia', 'piorar', 'regiao', 'situacao']","[1, 1, 1, 1, 1, 1]","[]","[]",6,0,6,0
11125,"[]","[]","['lixar']","[1]",0,1,1,0
11126,"[]","[]","[]","[]",0,0,0,0
11128,"['equipamento', 'globonew']","[1, 1]","[]","[]",2,0,2,0
11130,"[]","[]","['barragem', 'compartilhar', 'imagem', 'rompimento']","[1, 1, 1, 1]",0,4,4,0
11131,"['estabilidad', 'necessario']","[1, 1]","['ganhar', 'ideologia', 'ideologia']","[1, 2, 2]",2,3,5,0
11132,"['client', 'client', 'client']","[3, 3, 3]","['enderecar', 'usuario']","[1, 1]",3,2,5,0
11133,"[]","[]","['drone', 'imagem', 'quinzena', 'segundar', 'vezar']","[1, 1, 1, 1, 1]",0,5,5,0
11135,"['absoluto']","[1]","['assaltar', 'imagem']","[1, 1]",1,2,3,0
11136,"[]","[]","['minutar', 'parir', 'sobrar', 'visualizacao']","[1, 1, 1, 1]",0,4,4,0
11137,"[]","[]","['visualizacao']","[1]",0,1,1,0
11140,"[]","[]","['insinuar']","[1]",0,1,1,0
11141,"['adicionar', 'autoridad', 'desempenhar', 'privar']","[1, 1, 1, 1]","[]","[]",4,0,4,0
11144,"['associacao', 'preventivo', 'sorocaba']","[1, 1, 1]","[]","[]",3,0,3,0
11145,"[]","[]","['desfilar']","[1]",0,1,1,0
11146,"['alergia', 'contabilizar', 'periodo']","[1, 1, 1]","['gravacao', 'viralizada']","[1, 1]",3,2,5,0
11149,"['atuacao', 'comissao', 'comissao', 'provincia', 'republico', 'saudar']","[1, 2, 2, 1, 1, 1]","['atribuir', 'circular', 'nobel', 'nobel', 'nobel']","[1, 1, 3, 3, 3]",6,5,11,0
11151,"['movimentacao']","[1]","['parabem', 'revoltar', 'sobrar']","[1, 1, 1]",1,3,4,0
11152,"['alvorar', 'discussao', 'oficialment', 'palacio', 'saudar', 'servidor', 'tcu']","[1, 1, 1, 1, 1, 1, 1]","['compartilhar', 'parir', 'segundar']","[1, 1, 1]",7,3,10,0
11154,"['comissao', 'comissao', 'henriqu', 'justicar', 'pagamento', 'pagamento', 'subordinar']","[2, 2, 1, 1, 2, 2, 1]","['compartilhar', 'disseminar', 'postagen', 'usuario']","[1, 1, 1, 1]",7,4,11,0
11156,"[]","[]","[]","[]",0,0,0,0
11159,"['afp', 'comissao', 'periodo']","[1, 1, 1]","['compartilhar', 'imagem', 'inscricao', 'parir', 'pelar', 'pelar']","[1, 1, 1, 1, 2, 2]",3,6,9,0
11160,"['condenacao', 'decisao', 'justicar', 'supremo']","[1, 1, 1, 1]","['circular', 'circular', 'circular', 'imagem', 'legendar', 'reverso']","[3, 3, 3, 1, 1, 1]",4,6,10,0
11161,"['destinar', 'pastar']","[1, 1]","['compartilhar', 'postagen']","[1, 1]",2,2,4,0
11163,"['assintomatico', 'parcelar']","[1, 1]","[]","[]",2,0,2,0
11164,"['goncalo', 'goncalo', 'metropolitano', 'regiao', 'subir']","[2, 2, 1, 1, 1]","['circular', 'inscricao', 'inscricao', 'inscricao', 'sortear', 'vazio']","[1, 3, 3, 3, 1, 1]",5,6,11,0
11165,"['entregu', 'regrar', 'respostar']","[1, 1, 1]","['clicar', 'clicar', 'compartilhar', 'compartilhar', 'enderecar', 'ganhar', 'ganhar', 'instrucao', 'minutar', 'parabem', 'parabem', 'parabem', 'parabem', 'reivindicar', 'selecionar', 'sortir', 'sortir']","[2, 2, 2, 2, 1, 2, 2, 1, 1, 4, 4, 4, 4, 1, 1, 2, 2]",3,17,20,0
11166,"[]","[]","[]","[]",0,0,0,0
11168,"['painel', 'regiao']","[1, 1]","['bandeiro', 'boatar', 'cbn', 'incendio', 'viralizado']","[1, 1, 1, 1, 1]",2,5,7,0
11169,"[]","[]","['disseminar', 'enganoso', 'enganoso', 'narrativo', 'narrativo', 'usuario']","[1, 2, 2, 2, 2, 1]",0,6,6,0
11170,"['viajant']","[1]","['parir', 'sobrar']","[1, 1]",1,2,3,0
11171,"['saudar']","[1]","[]","[]",1,0,1,0
11172,"['calendario', 'fase', 'imunizacao', 'previsao']","[1, 1, 1, 1]","[]","[]",4,0,4,0
11175,"['decisao', 'espirito', 'folhar', 'preservar', 'rotina']","[1, 1, 1, 1, 1]","['circular', 'falsar', 'filmar', 'gravacao', 'ilustrar', 'ilustrar', 'imagem', 'imagem', 'imagem', 'imagem', 'imagem']","[1, 1, 1, 1, 2, 2, 5, 5, 5, 5, 5]",5,11,16,0
11177,"['observar']","[1]","['circular', 'fotografo', 'imagem', 'imagem', 'imagem', 'legendar', 'legendar', 'reverso']","[1, 1, 3, 3, 3, 2, 2, 1]",1,8,9,0
11178,"['ambientar', 'internar', 'internar', 'saudar']","[1, 2, 2, 1]","['compartilhar', 'imagem', 'legendar']","[1, 1, 1]",4,3,7,0
11181,"['biliao', 'decisao', 'decisao', 'implementacao', 'interferencia', 'limitacao', 'supremo']","[1, 2, 2, 1, 1, 1, 1]","['circular', 'falsar', 'usuario']","[1, 1, 1]",7,3,10,0
11182,"['espirito']","[1]","[]","[]",1,0,1,0
11183,"['republico']","[1]","['circular', 'quinzena', 'supostament']","[1, 1, 1]",1,3,4,0
11184,"['aurelio', 'destacar', 'lewandowski']","[1, 1, 1]","['amigar', 'amigar', 'atribuir', 'circular', 'imagem', 'imagem']","[2, 2, 1, 1, 2, 2]",3,6,9,0
11185,"['processo']","[1]","['estuprar', 'trafico', 'trafico', 'vagabundar']","[1, 2, 2, 1]",1,4,5,0
11188,"[]","[]","['circular', 'imagem']","[1, 1]",0,2,2,0
11191,"[]","[]","['capturar', 'compartilhar', 'descricao', 'imagem', 'legendar', 'reverso']","[1, 1, 1, 1, 1, 1]",0,6,6,0
11193,"['anuncio', 'avancar', 'avancar', 'client', 'decisao', 'esforco', 'saudar', 'temporario', 'temporario']","[1, 2, 2, 1, 1, 1, 1, 2, 2]","['circular']","[1]",9,1,10,0
11197,"['afetado', 'afetado']","[2, 2]","['dorio']","[1]",2,1,3,0
11198,"[]","[]","['circular', 'circular', 'imagem', 'legendar', 'legendar', 'visualizacao']","[2, 2, 1, 2, 2, 1]",0,6,6,0
11199,"['carat', 'ideologico', 'justicar']","[1, 1, 1]","[]","[]",3,0,3,0
11201,"['autoridad', 'comparacao', 'dengu', 'diagnosticar', 'impacto', 'indicador', 'letalidad', 'minimizar', 'possibilidad', 'previsto']","[1, 1, 1, 1, 1, 1, 1, 1, 1, 1]","['enganoso']","[1]",10,1,11,0
11202,"['epidemiar', 'quarentenar']","[1, 1]","['espalhar', 'imagem', 'quinzena', 'sapato']","[1, 1, 1, 1]",2,4,6,0
11205,"['bolsonarista', 'domingo', 'domingo', 'iniciativo', 'surtir', 'turistico']","[1, 2, 2, 1, 1, 1]","['atirar', 'checagem', 'circular', 'compartilhar', 'compartilhar', 'compartilhar', 'gravacao', 'imagem', 'imagem', 'legendar', 'protestar', 'reverso', 'soldar', 'telegram']","[1, 1, 1, 3, 3, 3, 1, 2, 2, 1, 1, 1, 1, 1]",6,14,20,0
11208,"['diariament', 'enfrentamento', 'pratico']","[1, 1, 1]","[]","[]",3,0,3,0
11209,"['relativo', 'saudar']","[1, 1]","['atribuir', 'circular', 'imagem']","[1, 1, 1]",2,3,5,0
11210,"['barroso', 'compromisso']","[1, 1]","['parir', 'parir', 'parir', 'parir', 'parir', 'parir', 'parir', 'pelar', 'pelar', 'pelar', 'pelar']","[7, 7, 7, 7, 7, 7, 7, 4, 4, 4, 4]",2,11,13,0
11214,"['normalment', 'opcao']","[1, 1]","['amigar', 'amplament', 'capturar', 'circular', 'compartilhar', 'usuario', 'vc']","[1, 1, 1, 1, 1, 1, 1]",2,7,9,0
11218,"[]","[]","['amigar']","[1]",0,1,1,0
11222,"['ansiedad', 'comprometido', 'condicao', 'cronica', 'depressao', 'fluxo', 'infectar', 'insuficient', 'mantido', 'prazo', 'saudar']","[1, 1, 1, 1, 1, 1, 1, 1, 1, 1, 1]","['acidentar']","[1]",11,1,12,0
11223,"['anvisa', 'anvisa', 'dosar', 'imunizacao', 'vigilancia']","[2, 2, 1, 1, 1]","['verificar']","[1]",5,1,6,0
11226,"['infectar']","[1]","[]","[]",1,0,1,0
11228,"[]","[]","['amplament', 'atribuir', 'compartilhar', 'compartilhar', 'manipular', 'postagen']","[1, 1, 2, 2, 1, 1]",0,6,6,0
11229,"['infeccioso']","[1]","['circular', 'tampouco']","[1, 1]",1,2,3,0
11231,"['ideologico']","[1]","['expulsar', 'expulsar', 'expulsar', 'expulsar', 'expulsar', 'soltar', 'soltura']","[5, 5, 5, 5, 5, 1, 1]",1,7,8,0
11234,"['europeu']","[1]","['perdao', 'quantum']","[1, 1]",1,2,3,0
11236,"[]","[]","['capturar']","[1]",0,1,1,0
11237,"['metropolitano', 'portavoz', 'presenciar', 'regiao', 'respostar']","[1, 1, 1, 1, 1]","['chorar', 'descricao', 'gravacao', 'incendio', 'incendio', 'incendio', 'incendio', 'verificacao']","[1, 1, 1, 4, 4, 4, 4, 1]",5,8,13,0
11238,"['acumular', 'alergia', 'ambientar', 'necessidad', 'periodo', 'pratico', 'respiratorio', 'saudar']","[1, 1, 1, 1, 1, 1, 1, 1]","['compartilhar', 'espalhar', 'parir', 'parir', 'parir', 'parir', 'parir', 'parir', 'pelar', 'sapato', 'suco', 'vezar']","[1, 1, 6, 6, 6, 6, 6, 6, 1, 1, 1, 1]",8,12,20,0
11240,"['apreensao', 'domingo', 'domingo']","[1, 2, 2]","['circular', 'ganhar', 'imagem', 'imagem', 'imagem', 'imagem', 'legendar']","[1, 1, 4, 4, 4, 4, 1]",3,7,10,0
11241,"['reuniao']","[1]","['chorar', 'humanar', 'menino', 'menino']","[1, 1, 2, 2]",1,4,5,0
11242,"['ribeiro', 'ribeiro']","[2, 2]","['suco', 'vitaminar', 'vitaminar']","[1, 2, 2]",2,3,5,0
11244,"['justicar', 'prazo', 'prazo', 'supremo']","[1, 2, 2, 1]","['circular', 'circular', 'imagem']","[2, 2, 1]",4,3,7,0
11246,"['punicao', 'suspensao']","[1, 1]","['circular', 'instrucao', 'usuario', 'usuario', 'usuario', 'verdadeiro']","[1, 1, 3, 3, 3, 1]",2,6,8,0
11249,"['amplo', 'congresso', 'congresso', 'congresso', 'presenca']","[1, 3, 3, 3, 1]","['circular', 'invadir', 'invadir', 'legendar', 'legendar', 'protestar', 'protestar', 'secreto']","[1, 2, 2, 2, 2, 2, 2, 1]",5,8,13,0
11256,"[]","[]","['pego', 'verificar']","[1, 1]",0,2,2,0
11258,"['ministrar', 'reforcar']","[1, 1]","['atribuir', 'atribuir', 'basto', 'circular', 'circular', 'vazar', 'visualizacao']","[2, 2, 1, 2, 2, 1, 1]",2,7,9,0
11259,"['carat', 'journal']","[1, 1]","['ganhar', 'misericordia']","[1, 1]",2,2,4,0
11261,"['painel']","[1]","['sobrar']","[1]",1,1,2,0
11263,"['comissao', 'congresso', 'exjuiz', 'forcatarefa', 'inquerito', 'instalacao', 'integrant', 'justicar', 'ministrar', 'varar']","[1, 1, 1, 1, 1, 1, 1, 1, 1, 1]","[]","[]",10,0,10,0
11265,"['privar', 'recurso']","[1, 1]","['captar', 'legendar', 'rouanet', 'usuario']","[1, 1, 1, 1]",2,4,6,0
11266,"['carla', 'colaborar', 'desempenhar', 'desempenhar', 'federar', 'pslsp', 'saudar', 'zambelli']","[1, 1, 2, 2, 1, 1, 1, 1]","['atribuir', 'compartilhar']","[1, 1]",8,2,10,0
11267,"['converso']","[1]","['imagem', 'vazar']","[1, 1]",1,2,3,0
11268,"['consequencia', 'crise', 'decorrent', 'epidemiar', 'necessario', 'quarentenar', 'reducao', 'saneamento', 'surtir', 'tambem']","[1, 1, 1, 1, 1, 1, 1, 1, 1, 1]","['expulsar', 'ganhar']","[1, 1]",10,2,12,0
11275,"['conjuntar', 'folhar', 'sabatino', 'spaulo']","[1, 1, 1, 1]","['checar', 'lupa', 'rompimento']","[1, 1, 1]",4,3,7,0
11279,"['humanitario']","[1]","['parabem']","[1]",1,1,2,0
11280,"['afastamento', 'determinacao', 'disseminacao', 'urbano']","[1, 1, 1, 1]","['circular', 'compartilhar']","[1, 1]",4,2,6,0
11282,"['alvorar', 'palacio', 'proferir']","[1, 1, 1]","[]","[]",3,0,3,0
11287,"['aprovacao', 'aprovacao', 'concreto', 'economia', 'gued', 'ministrar', 'planar']","[2, 2, 1, 1, 1, 1, 1]","['cedula', 'cedula']","[2, 2]",7,2,9,0
11289,"['claudio']","[1]","['chorar', 'circular', 'fotografo', 'imagem', 'imagem', 'imagem', 'legendar', 'misericordia', 'reverso']","[1, 1, 1, 3, 3, 3, 1, 1, 1]",1,9,10,0
11294,"['conformar', 'desenvolvimento', 'desenvolvimento', 'portavoz']","[1, 2, 2, 1]","['fotografo', 'imagem', 'padrar']","[1, 1, 1]",4,3,7,0
11295,"[]","[]","[]","[]",0,0,0,0
11297,"['especializar', 'fase', 'fase', 'journal', 'respiratorio']","[1, 2, 2, 1, 1]","['circular', 'ganhar']","[1, 1]",5,2,7,0
11301,"[]","[]","[]","[]",0,0,0,0
11303,"['calheiro', 'calheiro', 'circulacao', 'mdbal']","[2, 2, 1, 1]","['circular', 'legendar']","[1, 1]",4,2,6,0
11304,"['companhia', 'delacao', 'surto']","[1, 1, 1]","[]","[]",3,0,3,0
11307,"['barroso', 'liderar']","[1, 1]","['carrefour', 'parabem']","[1, 1]",2,2,4,0
11309,"[]","[]","[]","[]",0,0,0,0
11313,"[]","[]","[]","[]",0,0,0,0
11317,"['carat']","[1]","['usuario']","[1]",1,1,2,0
11319,"['destacar', 'economia', 'levantamento', 'painel']","[1, 1, 1, 1]","['replicar']","[1]",4,1,5,0
11320,"['periodo']","[1]","[]","[]",1,0,1,0
11322,"['rocha']","[1]","['canadens', 'canadens', 'capturar', 'capturar', 'capturar', 'capturar', 'capturar', 'capturar']","[2, 2, 6, 6, 6, 6, 6, 6]",1,8,9,0
11324,"['contabilizar']","[1]","['cedula', 'cedula', 'cedula', 'circular', 'despejar', 'despejar', 'imagem', 'imagem', 'legendar', 'versao']","[3, 3, 3, 1, 2, 2, 2, 2, 1, 1]",1,10,11,0
11329,"['especifico', 'ministrar', 'ministrar']","[1, 2, 2]","['circular', 'compartilhar', 'greve', 'greve', 'greve', 'postagen']","[1, 1, 3, 3, 3, 1]",3,6,9,0
11331,"[]","[]","['circular', 'desmentir']","[1, 1]",0,2,2,0
11334,"['acumular', 'anvisa', 'autoridad', 'bolsonarista', 'claudio', 'descumprimento', 'destacar', 'destacar', 'destinar', 'diariament', 'diariament', 'diretoria', 'discussao', 'enfatizar', 'estatistico', 'implementar', 'intubacao', 'ministrar', 'ministrar', 'republico', 'republico', 'saudar', 'saudar', 'saudar', 'servidor']","[1, 1, 1, 1, 1, 1, 2, 2, 1, 2, 2, 1, 1, 1, 1, 1, 1, 2, 2, 2, 2, 3, 3, 3, 1]","['estampar']","[1]",25,1,26,0
11335,"[]","[]","['curioso', 'imagem']","[1, 1]",0,2,2,0
11336,"['anvisa', 'anvisa', 'conformar', 'destacar', 'fronteiro', 'fronteiro', 'preparacao', 'situacao', 'temporario', 'vigilancia']","[2, 2, 1, 1, 2, 2, 1, 1, 1, 1]","['deitar', 'manipulacao']","[1, 1]",10,2,12,0
11338,"[]","[]","[]","[]",0,0,0,0
11339,"[]","[]","['espalhar']","[1]",0,1,1,0
11340,"['interpretar']","[1]","['biblia', 'biblia']","[2, 2]",1,2,3,0
11344,"[]","[]","['humanar', 'humanar', 'renunciar']","[2, 2, 1]",0,3,3,0
11346,"['reabertura']","[1]","['motorista']","[1]",1,1,2,0
11348,"['academiar', 'fundacao', 'infectar', 'instituto', 'privar']","[1, 1, 1, 1, 1]","['imenso']","[1]",5,1,6,0
11350,"['internar', 'internar']","[2, 2]","[]","[]",2,0,2,0
11352,"['implementacao']","[1]","['copiar', 'copiar', 'enganar', 'fraudar', 'imagem', 'imagem', 'imagem', 'parir']","[2, 2, 1, 1, 3, 3, 3, 1]",1,8,9,0
11353,"['viajant']","[1]","['amplament', 'compartilhar', 'espalhar', 'gretar', 'imagem', 'postagen', 'quinzena']","[1, 1, 1, 1, 1, 1, 1]",1,7,8,0
11354,"['pagamento', 'parcelar', 'parcelar']","[1, 2, 2]","['basto', 'cadastramento', 'enderecar', 'inscricao', 'inscricao', 'inscricao']","[1, 1, 1, 3, 3, 3]",3,6,9,0
11355,"['esperancar']","[1]","['ganhar', 'soltar']","[1, 1]",1,2,3,0
11356,"['especializar', 'provincia']","[1, 1]","['circular', 'imagem', 'imagem', 'imagem', 'legendar', 'reverso']","[1, 3, 3, 3, 1, 1]",2,6,8,0
11358,"['manutencao']","[1]","['invadir']","[1]",1,1,2,0
11360,"['ambientar', 'ambientar', 'europeu', 'merkel', 'ministrar', 'ricardo', 'sall', 'suspensao']","[2, 2, 1, 1, 1, 1, 1, 1]","['pego']","[1]",8,1,9,0
11364,"['infectar', 'infectar', 'surtir', 'surtir']","[2, 2, 2, 2]","['espalhar', 'filmar']","[1, 1]",4,2,6,0
11365,"['administrativo', 'autorizacao', 'inglaterra', 'sigla', 'sigla', 'sigla', 'taxar', 'temporario']","[1, 1, 1, 3, 3, 3, 1, 1]","['amplament', 'circular', 'postagen']","[1, 1, 1]",8,3,11,0
11366,"['gripezinha', 'gripezinha', 'habito', 'mudanca']","[2, 2, 1, 1]","['assinalar', 'circular', 'indignacao', 'mesario', 'mesario', 'postagen', 'postagen', 'usuario']","[1, 1, 1, 2, 2, 2, 2, 1]",4,8,12,0
11369,"['afp', 'companhia', 'destinar', 'plano', 'recuperacao', 'reportar']","[1, 1, 1, 1, 1, 1]","['circular', 'circular', 'postagen', 'postagen']","[2, 2, 2, 2]",6,4,10,0
11370,"['aplicacao', 'conjunto', 'distant', 'estabilidad', 'integro', 'ministrar', 'ministrar', 'ministrar', 'negativar', 'palacio', 'punicao']","[1, 1, 1, 1, 1, 3, 3, 3, 1, 1, 1]","['disseminar', 'verdadeiro']","[1, 1]",11,2,13,0
11372,"['inicialment', 'obtido', 'republico']","[1, 1, 1]","['circular', 'compartilhar', 'intitular', 'manchet']","[1, 1, 1, 1]",3,4,7,0
11373,"[]","[]","[]","[]",0,0,0,0
11375,"['situacao']","[1]","['arvor']","[1]",1,1,2,0
11379,"['regiao']","[1]","['compartilhar']","[1]",1,1,2,0
11387,"['esquema', 'saudar']","[1, 1]","['bonner', 'bonner', 'mansao']","[2, 2, 1]",2,3,5,0
11388,"['quadro']","[1]","['cbn', 'circular', 'compartilhar', 'limao', 'limao', 'suco']","[1, 1, 1, 2, 2, 1]",1,6,7,0
11389,"['provincia']","[1]","['cristao', 'cristao', 'cristao', 'misericordia', 'parir', 'parir', 'pelar', 'pelar']","[3, 3, 3, 1, 2, 2, 2, 2]",1,8,9,0
11393,"['florido']","[1]","['fotografo']","[1]",1,1,2,0
11394,"[]","[]","['enganir', 'enganoso']","[1, 1]",0,2,2,0
11400,"['apurar', 'inquerito']","[1, 1]","['fraudar', 'fraudar', 'fraudar']","[3, 3, 3]",2,3,5,0
11401,"['desenvolvido', 'disseminacao', 'machadar', 'reforcar', 'significativo', 'situacao']","[1, 1, 1, 1, 1, 1]","['escutar']","[1]",6,1,7,0
11403,"['economia', 'estrategia', 'estrategia']","[1, 2, 2]","['compartilhar', 'compartilhar', 'enfim', 'enfim']","[2, 2, 2, 2]",3,4,7,0
11405,"['afp', 'transmissao']","[1, 1]","['checar', 'circular', 'incendio', 'legendar', 'postagen', 'verificacao', 'visualizar']","[1, 1, 1, 1, 1, 1, 1]",2,7,9,0
11407,"[]","[]","['espalhar', 'supostament']","[1, 1]",0,2,2,0
11411,"['obtido']","[1]","['circular', 'compartilhar', 'imagem']","[1, 1, 1]",1,3,4,0
11412,"['desenvolvimento', 'saudar']","[1, 1]","['espalhar']","[1]",2,1,3,0
11413,"['ambientar', 'arthur', 'epidemiologico', 'epidemiologico', 'estatistico', 'estrategico', 'exministro', 'painel', 'painel', 'saudar', 'saudar', 'saudar', 'vigilancia']","[1, 1, 2, 2, 1, 1, 1, 2, 2, 3, 3, 3, 1]","['acidentar', 'fraudar', 'insinuar']","[1, 1, 1]",13,3,16,0
11416,"[]","[]","['efarsa']","[1]",0,1,1,0
11419,"['autoridad', 'quarentenar']","[1, 1]","['abusar', 'atirar', 'atirar', 'atirar']","[1, 3, 3, 3]",2,4,6,0
11421,"['prever', 'saudar', 'saudar', 'surtir']","[1, 2, 2, 1]","[]","[]",4,0,4,0
11422,"['turista', 'turista', 'turista']","[3, 3, 3]","[]","[]",3,0,3,0
11423,"[]","[]","['cobaia', 'dorio']","[1, 1]",0,2,2,0
11425,"['autoridad', 'circulacao', 'conjuntar', 'disseminacao', 'propagacao', 'saudar']","[1, 1, 1, 1, 1, 1]","['circular', 'imagem', 'imagem', 'legendar', 'protestar']","[1, 2, 2, 1, 1]",6,5,11,0
11426,"['aprovacao', 'congresso', 'economia', 'processo', 'proposto', 'recurso', 'transferencia']","[1, 1, 1, 1, 1, 1, 1]","['cadastramento', 'cadastramento', 'cadastramento', 'circular']","[3, 3, 3, 1]",7,4,11,0
11427,"['infancia', 'varar']","[1, 1]","['imagem', 'menino']","[1, 1]",2,2,4,0
11431,"['condenacao', 'inconsistencia', 'investigacao', 'recurso', 'sentenca']","[1, 1, 1, 1, 1]","['ganhar']","[1]",5,1,6,0
11432,"['lavagem']","[1]","['circular', 'imagem']","[1, 1]",1,2,3,0
11436,"[]","[]","['estranhar', 'trafico', 'versao']","[1, 1, 1]",0,3,3,0
11437,"[]","[]","['lembres', 'parir', 'parir', 'versao']","[1, 2, 2, 1]",0,4,4,0
11442,"['carat', 'situacao', 'situacao']","[1, 2, 2]","[]","[]",3,0,3,0
11447,"[]","[]","['efarsa']","[1]",0,1,1,0
11457,"[]","[]","['ganhar']","[1]",0,1,1,0
11458,"[]","[]","['amigar', 'estranhar', 'humanar', 'supostament', 'verdadeiro']","[1, 1, 1, 1, 1]",0,5,5,0
11459,"['araujo', 'chefiar', 'ernesto', 'estrategia', 'itamarati', 'planar', 'saudar']","[1, 1, 1, 1, 1, 1, 1]","['ganhar', 'ganhar']","[2, 2]",7,2,9,0
11461,"[]","[]","['assaltar', 'disfarcar', 'imagem', 'vagabundar', 'vagabundar']","[1, 1, 1, 2, 2]",0,5,5,0
11463,"[]","[]","[]","[]",0,0,0,0
11464,"['adulto']","[1]","['circular', 'compartilhar', 'imagem', 'usuario', 'versao', 'versao']","[1, 1, 1, 1, 2, 2]",1,6,7,0
11466,"['domingo']","[1]","['clicar', 'clicar', 'compartilhar', 'ganhar', 'ganhar', 'huawei', 'huawei', 'huawei', 'instrucao', 'macho', 'minutar', 'parabem', 'reivindicar', 'usuario', 'usuario']","[2, 2, 1, 2, 2, 3, 3, 3, 1, 1, 1, 1, 1, 2, 2]",1,15,16,0
11469,"['amplo', 'assistencia', 'autoridad', 'orientacao', 'orientacao', 'saudar']","[1, 1, 1, 2, 2, 1]","[]","[]",6,0,6,0
11474,"[]","[]","['circular', 'compartilhar', 'gravacao', 'ilustrar', 'postagen', 'tumulo', 'tumulo', 'visualizacao']","[1, 1, 1, 1, 1, 2, 2, 1]",0,8,8,0
11478,"['concorrent', 'presenca']","[1, 1]","['estranhar']","[1]",2,1,3,0
11479,"['sugestao']","[1]","['arquivar', 'grupar', 'telegram']","[1, 1, 1]",1,3,4,0
11481,"['equipamento', 'regiao']","[1, 1]","['falsar', 'incendio', 'incendio', 'supostament', 'tampouco']","[1, 2, 2, 1, 1]",2,5,7,0
11483,"['ambientar', 'internar', 'ministrar', 'preventivo', 'quadro', 'respiratorio']","[1, 1, 1, 1, 1, 1]","['cbn', 'circular']","[1, 1]",6,2,8,0
11484,"['dedicar', 'exministro', 'exministro', 'ideologico', 'jurista', 'justicar', 'rejeicao', 'supremo']","[1, 2, 2, 1, 1, 1, 1, 1]","['atribuir', 'atribuir', 'circular', 'circular', 'compartilhar', 'disseminar']","[2, 2, 2, 2, 1, 1]",8,6,14,0
11485,"['aprovacao', 'aprovacao', 'possibilidad', 'recurso']","[2, 2, 1, 1]","['enganoso', 'enganoso', 'filmar', 'filmar', 'filmar', 'filmar', 'imagem', 'postagen']","[2, 2, 4, 4, 4, 4, 1, 1]",4,8,12,0
11486,"[]","[]","['circular', 'faccao']","[1, 1]",0,2,2,0
11488,"[]","[]","['carrefour', 'clicar', 'compartilhar', 'compartilhar', 'ganhar', 'ganhar', 'instrucao', 'parabem', 'reivindicar', 'sortir']","[1, 1, 2, 2, 2, 2, 1, 1, 1, 1]",0,10,10,0
11490,"['respostar']","[1]","['bandeiro', 'bandeiro', 'bandeiro', 'boicotar']","[3, 3, 3, 1]",1,4,5,0
11491,"['pagamento']","[1]","[]","[]",1,0,1,0
11492,"['autorizacao', 'autorizacao', 'congresso', 'decisao', 'desgastar', 'federativo', 'recordar', 'republico', 'republico', 'respostar']","[2, 2, 1, 1, 1, 1, 1, 2, 2, 1]","['cristao', 'escutar', 'parir', 'parir', 'parir', 'parir', 'parir', 'parir', 'parir', 'parir', 'parir', 'parir', 'soldar', 'vc', 'vc', 'vc']","[1, 1, 10, 10, 10, 10, 10, 10, 10, 10, 10, 10, 1, 3, 3, 3]",10,16,26,0
11493,"['bolsonarista']","[1]","['capturar', 'circular', 'compartilhar', 'escravo', 'gravacao', 'imagem', 'intitular', 'reverso', 'visualizar']","[1, 1, 1, 1, 1, 1, 1, 1, 1]",1,9,10,0
11494,"[]","[]","[]","[]",0,0,0,0
11496,"['lorenzoni']","[1]","['espalhar', 'imagem']","[1, 1]",1,2,3,0
11498,"['benjamin', 'primeiroministro']","[1, 1]","['arquivar', 'circular', 'verificar']","[1, 1, 1]",2,3,5,0
11500,"['necessario']","[1]","['fotografo']","[1]",1,1,2,0
11508,"['anvisa', 'anvisa', 'periodo', 'vigilancia']","[2, 2, 1, 1]","['circular', 'legendar']","[1, 1]",4,2,6,0
11509,"[]","[]","['espalhar', 'espalhar', 'imagem', 'inscricao', 'quinzena', 'replicar']","[2, 2, 1, 1, 1, 1]",0,6,6,0
11510,"['iniciativo']","[1]","[]","[]",1,0,1,0
11514,"['periodo', 'recurso']","[1, 1]","[]","[]",2,0,2,0
11516,"[]","[]","['fotografo', 'menino']","[1, 1]",0,2,2,0
11517,"['boletim', 'decorrencia', 'diariament', 'epidemiologico', 'saudar']","[1, 1, 1, 1, 1]","['circular', 'clicar', 'sequer']","[1, 1, 1]",5,3,8,0
11518,"['adhanom', 'saudar', 'tedro']","[1, 1, 1]","[]","[]",3,0,3,0
11526,"['justicar', 'justicar', 'justicar', 'ministrar', 'ministrar', 'ministrar', 'ministrar', 'ministrar', 'saudar', 'saudar', 'saudar']","[3, 3, 3, 5, 5, 5, 5, 5, 3, 3, 3]","['renunciar', 'renunciar']","[2, 2]",11,2,13,0
11527,"['associacao', 'desafiar']","[1, 1]","['pelar']","[1]",2,1,3,0
11528,"[]","[]","['compartilhar', 'imagem']","[1, 1]",0,2,2,0
11529,"['concedido', 'crise', 'paralelo', 'supremo', 'supremo', 'suspeito', 'suspensao']","[1, 1, 1, 2, 2, 1, 1]","['fraudar', 'venezuelano']","[1, 1]",7,2,9,0
11531,"[]","[]","['filmar', 'parir', 'parir']","[1, 2, 2]",0,3,3,0
11532,"['pratico']","[1]","['expulsar', 'puro']","[1, 1]",1,2,3,0
11533,"['pagamento']","[1]","[]","[]",1,0,1,0
11534,"['oficialment', 'republico', 'sabado']","[1, 1, 1]","[]","[]",3,0,3,0
11535,"[]","[]","['compartilhar', 'parir', 'parir', 'parir', 'pelar', 'visualizacao', 'visualizacao']","[1, 3, 3, 3, 1, 2, 2]",0,7,7,0
11538,"[]","[]","['biblia', 'camisa', 'compartilhar', 'imagem']","[1, 1, 1, 1]",0,4,4,0
11544,"['autoridad', 'desenvolvimento', 'fase', 'pslsp']","[1, 1, 1, 1]","['pelar']","[1]",4,1,5,0
11545,"['saudar']","[1]","['circular', 'compartilhar', 'enganir', 'postagen', 'usuario']","[1, 1, 1, 1, 1]",1,5,6,0
11546,"[]","[]","['assinalar', 'circular', 'compartilhar', 'idioma']","[1, 1, 1, 1]",0,4,4,0
11547,"['avancar', 'fundacao']","[1, 1]","['basto', 'enderecar', 'enderecar', 'inscricao', 'preencher', 'questionario']","[1, 2, 2, 1, 1, 1]",2,6,8,0
11548,"[]","[]","['humanar']","[1]",0,1,1,0
11550,"['gabinet', 'gabinet', 'heleno', 'heleno', 'ministrar', 'reforcar', 'republico']","[2, 2, 2, 2, 1, 1, 1]","['atribuir', 'circular', 'enderecar', 'enderecar', 'enganar', 'facada', 'falsar', 'falsar', 'imagem', 'menino', 'usuario', 'verificar']","[1, 1, 2, 2, 1, 1, 2, 2, 1, 1, 1, 1]",7,12,19,0
11552,"['aglomeracao', 'congresso', 'pagamento', 'suspensao']","[1, 1, 1, 1]","['boatar', 'circular', 'desmentir', 'imagem', 'imagem']","[1, 1, 1, 2, 2]",4,5,9,0
11553,"['autoridad', 'palacio', 'planalto', 'presenca']","[1, 1, 1, 1]","['enganoso']","[1]",4,1,5,0
11554,"['atuam', 'disseminacao', 'justicar']","[1, 1, 1]","['cbn', 'circular', 'compartilhar', 'sequer']","[1, 1, 1, 1]",3,4,7,0
11555,"['biliao', 'desenvolvimento', 'economia', 'expectativa', 'justicar', 'ministrar', 'processo', 'revisar', 'revisar']","[1, 1, 1, 1, 1, 1, 1, 2, 2]","['chorar', 'sacar', 'sacar', 'verificar']","[1, 2, 2, 1]",9,4,13,0
11556,"[]","[]","['invadir']","[1]",0,1,1,0
11557,"[]","[]","['sobrar', 'transposicao']","[1, 1]",0,2,2,0
11559,"[]","[]","[]","[]",0,0,0,0
11561,"['iniciativo']","[1]","['compartilhar', 'parir', 'quinzena']","[1, 1, 1]",1,3,4,0
11563,"['apostar', 'apostar']","[2, 2]","['desgracar']","[1]",2,1,3,0
11564,"['apurar', 'justicar', 'justicar']","[1, 2, 2]","['catolico', 'inocentar', 'inocentar', 'inocentar', 'padrar', 'padrar', 'padrar', 'padrar', 'padrar', 'perdao', 'perdao']","[1, 3, 3, 3, 5, 5, 5, 5, 5, 2, 2]",3,11,14,0
11565,"[]","[]","['parir', 'pelar', 'supostament']","[1, 1, 1]",0,3,3,0
11567,"[]","[]","['espalhar', 'quinzena']","[1, 1]",0,2,2,0
11573,"[]","[]","['cristao', 'cristao']","[2, 2]",0,2,2,0
11577,"['capitar']","[1]","[]","[]",1,0,1,0
11581,"['ministrar', 'punicao', 'saudar']","[1, 1, 1]","['compartilhar']","[1]",3,1,4,0
11582,"[]","[]","['parir']","[1]",0,1,1,0
11583,"['calamidad', 'necessario', 'observar', 'privar', 'privar', 'privar', 'temporario']","[1, 1, 1, 3, 3, 3, 1]","['circular']","[1]",7,1,8,0
11585,"['fluminens', 'mexico', 'possibilidad', 'regiao', 'revogar', 'revogar', 'turistico']","[1, 1, 1, 1, 2, 2, 1]","[]","[]",7,0,7,0
11587,"[]","[]","['clicar', 'compartilhar', 'compartilhar', 'compartilhar', 'compartilhar', 'ganhar', 'ganhar']","[1, 4, 4, 4, 4, 2, 2]",0,7,7,0
11590,"['alteracao', 'conjuntar', 'desenvolvido', 'desenvolvimento']","[1, 1, 1, 1]","['circular']","[1]",4,1,5,0
11593,"['autoridad', 'propagacao', 'saudar']","[1, 1, 1]","[]","[]",3,0,3,0
11599,"['contribuicao', 'variacao']","[1, 1]","['circular', 'padrar']","[1, 1]",2,2,4,0
11601,"['biliao', 'converso', 'exonerar', 'importacao', 'importacao', 'irregularidad', 'ministrar', 'ministrar', 'saudar', 'suspeito', 'suspeito']","[1, 1, 1, 2, 2, 1, 2, 2, 1, 2, 2]","['checagem', 'parir', 'parir', 'parir', 'pelar']","[1, 3, 3, 3, 1]",11,5,16,0
11604,"['biliao', 'disseminacao', 'estrategia', 'liderar', 'panamericana', 'prever', 'saudar', 'saudar', 'saudar', 'saudar', 'saudar']","[1, 1, 1, 1, 1, 1, 5, 5, 5, 5, 5]","[]","[]",11,0,11,0
11608,"['dificuldad']","[1]","['ganhar']","[1]",1,1,2,0
11610,"['ministrar', 'ministrar', 'ministrar', 'privar', 'ricardo', 'ricardo', 'situacao', 'turma', 'turma']","[3, 3, 3, 1, 2, 2, 1, 2, 2]","['compartilhar']","[1]",9,1,10,0
11611,"['apurar']","[1]","['bandeiro', 'invadir', 'invadir', 'invadir', 'sacar']","[1, 3, 3, 3, 1]",1,5,6,0
11612,"['celebrar', 'celebrar', 'celebrar']","[3, 3, 3]","['camiseta', 'camiseta', 'camiseta']","[3, 3, 3]",3,3,6,0
11613,"['acumular', 'proporcao', 'restritivo']","[1, 1, 1]","['amplament', 'circular', 'compartilhar', 'estomago', 'postagen', 'suco', 'suco']","[1, 1, 1, 1, 1, 2, 2]",3,7,10,0
11615,"['despesa', 'despesa', 'domingo', 'gabinet', 'montant', 'recordar', 'recordar', 'republico']","[2, 2, 1, 1, 1, 2, 2, 1]","['postagen']","[1]",8,1,9,0
11617,"['henriqu', 'henriqu']","[2, 2]","[]","[]",2,0,2,0
11619,"['comissao', 'integrant', 'pagamento', 'reuniao']","[1, 1, 1, 1]","['compartilhar', 'libertador', 'libertador', 'libertador']","[1, 3, 3, 3]",4,4,8,0
11620,"[]","[]","['escutar']","[1]",0,1,1,0
11621,"['avancar', 'comportamento', 'proposto']","[1, 1, 1]","['circular', 'privacidad']","[1, 1]",3,2,5,0
11625,"['competicao', 'realizacao', 'realizacao']","[1, 2, 2]","['libertador', 'parir', 'pelar', 'protestar']","[1, 1, 1, 1]",3,4,7,0
11626,"['integrant', 'liderar', 'proferir']","[1, 1, 1]","['amplament', 'circular', 'compartilhar', 'imagem']","[1, 1, 1, 1]",3,4,7,0
11630,"['orientacao']","[1]","['circular']","[1]",1,1,2,0
11631,"['adicionar', 'concorrent', 'infancia', 'observacao', 'suportar']","[1, 1, 1, 1, 1]","['abusar', 'abusar', 'abusar', 'abusar', 'cocaina', 'pelar', 'vazar', 'verdadeiro']","[4, 4, 4, 4, 1, 1, 1, 1]",5,8,13,0
11632,"[]","[]","['caixao', 'caixao', 'sacar', 'vazio', 'vazio']","[2, 2, 1, 2, 2]",0,5,5,0
11638,"['boletim', 'complicacao', 'internar', 'recuperacao']","[1, 1, 1, 1]","['usuario']","[1]",4,1,5,0
11639,"['folhar', 'spaulo']","[1, 1]","['bispar', 'circular', 'compartilhar', 'fotografia', 'greve', 'imagem', 'intitular', 'reverso', 'transposicao']","[1, 1, 1, 1, 1, 1, 1, 1, 1]",2,9,11,0
11640,"[]","[]","['compartilhar', 'quinzena']","[1, 1]",0,2,2,0
11643,"['adicionar', 'biliao', 'colaboracao', 'consequencia', 'servidor', 'servidor']","[1, 1, 1, 1, 2, 2]","['logotipo', 'logotipo', 'usuario', 'usuario', 'usuario', 'usuario', 'usuario', 'usuario', 'usuario', 'usuario']","[2, 2, 8, 8, 8, 8, 8, 8, 8, 8]",6,10,16,0
11645,"['escalar', 'instituto', 'molecular', 'pereira']","[1, 1, 1, 1]","[]","[]",4,0,4,0
11646,"[]","[]","['compartilhar', 'preencher', 'preencher']","[1, 2, 2]",0,3,3,0
11647,"['ambito', 'estatistico', 'henriqu', 'periodo', 'periodo']","[1, 1, 1, 2, 2]","['compartilhar', 'gasolina', 'gasolina', 'gasolina', 'imagem', 'legendar', 'viralizada']","[1, 3, 3, 3, 1, 1, 1]",5,7,12,0
11650,"[]","[]","[]","[]",0,0,0,0
11651,"['divergencia', 'internar', 'justicar']","[1, 1, 1]","['boicotar', 'protestar', 'verdadeiro']","[1, 1, 1]",3,3,6,0
11652,"['saudar']","[1]","['zincar']","[1]",1,1,2,0
11654,"['justicar']","[1]","[]","[]",1,0,1,0
11656,"['decorrencia', 'transmissao']","[1, 1]","[]","[]",2,0,2,0
11657,"['afiar', 'emergenciai', 'equipamento', 'funcao', 'possibilidad', 'regulamentar', 'situacao']","[1, 1, 1, 1, 1, 1, 1]","['compartilhar', 'incendio', 'mencao', 'viralizada']","[1, 1, 1, 1]",7,4,11,0
11661,"[]","[]","['atribuir', 'imagem', 'pelar']","[1, 1, 1]",0,3,3,0
11662,"['conformar']","[1]","[]","[]",1,0,1,0
11663,"[]","[]","['atribuir', 'boatar', 'checagem', 'circular', 'desmentir', 'enderecar', 'mansao', 'verificar']","[1, 1, 1, 1, 1, 1, 1, 1]",0,8,8,0
11664,"['ministrar']","[1]","[]","[]",1,0,1,0
11665,"['barroso', 'decisao', 'ministrar', 'ministrar', 'regrar']","[1, 1, 2, 2, 1]","['visualizacao']","[1]",5,1,6,0
11666,"['infectar', 'propagacao', 'quarentenar']","[1, 1, 1]","['circular', 'soltar', 'soltar']","[1, 2, 2]",3,3,6,0
11667,"['prever', 'prever']","[2, 2]","[]","[]",2,0,2,0
11670,"[]","[]","[]","[]",0,0,0,0
11671,"['comissao', 'consequencia', 'dinamarca', 'espanha', 'inglaterra', 'inglaterra', 'moderno']","[1, 1, 1, 1, 2, 2, 1]","['ganhar', 'manchet', 'manchet', 'manchet', 'manchet', 'sequer', 'verdadeiro']","[1, 4, 4, 4, 4, 1, 1]",7,7,14,0
11672,"['internar', 'transferir']","[1, 1]","['espalhar']","[1]",2,1,3,0
11673,"[]","[]","['circular', 'idioma', 'minutar', 'postagen', 'verificar', 'visualizar']","[1, 1, 1, 1, 1, 1]",0,6,6,0
11676,"[]","[]","['wylli']","[1]",0,1,1,0
11677,"['academico', 'saudar']","[1, 1]","['compartilhar', 'implantar']","[1, 1]",2,2,4,0
11678,"[]","[]","['vc']","[1]",0,1,1,0
11681,"['implementar']","[1]","['compartilhar', 'compartilhar', 'imagem', 'protestar', 'usuario']","[2, 2, 1, 1, 1]",1,5,6,0
11682,"['economia']","[1]","[]","[]",1,0,1,0
11685,"['elaborar', 'projeco']","[1, 1]","['fraudar', 'supostament']","[1, 1]",2,2,4,0
11686,"['autoridad', 'domingo', 'fabricio', 'flavio', 'investigacao', 'movimentacao', 'mprj', 'queiroz', 'realizacao']","[1, 1, 1, 1, 1, 1, 1, 1, 1]","['checar']","[1]",9,1,10,0
11687,"['autorizacao', 'autorizacao', 'domingo', 'fabricio', 'flavio', 'investigacao', 'movimentacao', 'mprj', 'queiroz', 'realizacao']","[2, 2, 1, 1, 1, 1, 1, 1, 1, 1]","['checar', 'parir']","[1, 1]",10,2,12,0
11691,"[]","[]","[]","[]",0,0,0,0
11692,"['equipamento', 'infectar']","[1, 1]","[]","[]",2,0,2,0
11693,"[]","[]","['rompimento']","[1]",0,1,1,0
11694,"[]","[]","['espalhar', 'espalhar', 'imagem']","[2, 2, 1]",0,3,3,0
11702,"[]","[]","['bandeiro', 'circular', 'imagem']","[1, 1, 1]",0,3,3,0
11703,"['assistencia', 'autoridad', 'autoridad', 'autoridad', 'autoridad', 'autoridad', 'autoridad', 'autoridad', 'autoridad', 'autoridad', 'autoridad', 'autoridad', 'autoridad', 'autoridad', 'autoridad', 'biliao', 'condicao', 'desigualdad', 'diariament', 'investigacao', 'necessidad', 'punicao', 'viagem']","[1, 14, 14, 14, 14, 14, 14, 14, 14, 14, 14, 14, 14, 14, 14, 1, 1, 1, 1, 1, 1, 1, 1]","['abusar', 'abusar', 'abusar', 'abusar', 'abusar', 'abusar', 'abusar', 'abusar', 'abusar', 'abusar', 'abusar', 'abusar', 'abusar', 'abusar', 'basto', 'compartilhar', 'motorista', 'torrar']","[14, 14, 14, 14, 14, 14, 14, 14, 14, 14, 14, 14, 14, 14, 1, 1, 1, 1]",23,18,41,0
11704,"['boletim', 'dosar', 'epidemiologico', 'instituto', 'previsao', 'publicoalvo', 'publicoalvo']","[1, 1, 1, 1, 1, 2, 2]","['circular']","[1]",7,1,8,0
11705,"[]","[]","['camiseta', 'estampar', 'quinzena']","[1, 1, 1]",0,3,3,0
11708,"[]","[]","['cristao', 'enganar', 'espancar', 'estuprar', 'indignar', 'misericordia', 'torturar', 'versao', 'versao', 'versao', 'versao', 'versao']","[1, 1, 1, 1, 1, 1, 1, 5, 5, 5, 5, 5]",0,12,12,0
11709,"['congresso', 'respostar', 'sancao', 'supremo']","[1, 1, 1, 1]","[]","[]",4,0,4,0
11711,"[]","[]","['amigar', 'compartilhar', 'versao']","[1, 1, 1]",0,3,3,0
11714,"['situacao']","[1]","['compartilhar']","[1]",1,1,2,0
11715,"[]","[]","[]","[]",0,0,0,0
11716,"[]","[]","[]","[]",0,0,0,0
11718,"['autoridad', 'autoridad', 'comissao', 'comprometido', 'constituicao', 'investigacao', 'justicar']","[2, 2, 1, 1, 1, 1, 1]","['abusar', 'abusar', 'abusar']","[3, 3, 3]",7,3,10,0
11719,"['aglomeracao', 'biliao', 'recordar', 'recordar', 'recordar']","[1, 1, 3, 3, 3]","['boatar', 'circular', 'mencao']","[1, 1, 1]",5,3,8,0
11720,"['academiar', 'almeida', 'aspecto', 'economia', 'economia', 'economia', 'federar', 'henriqu', 'proposto', 'regrar', 'servidor', 'sindicato']","[1, 1, 1, 3, 3, 3, 1, 1, 1, 1, 1, 1]","['checagem']","[1]",12,1,13,0
11725,"[]","[]","['manipular']","[1]",0,1,1,0
11726,"['isolar', 'planar']","[1, 1]","['ganhar', 'parir', 'parir']","[1, 2, 2]",2,3,5,0
11730,"[]","[]","['cedula', 'circular']","[1, 1]",0,2,2,0
11732,"[]","[]","[]","[]",0,0,0,0
11733,"['pastar', 'pastar']","[2, 2]","[]","[]",2,0,2,0
11734,"['sabado', 'vespera']","[1, 1]","[]","[]",2,0,2,0
11743,"[]","[]","[]","[]",0,0,0,0
11744,"['republico']","[1]","['amplament', 'circular', 'compartilhar']","[1, 1, 1]",1,3,4,0
11746,"[]","[]","['circular', 'verdadeiro']","[1, 1]",0,2,2,0
11747,"['ambientar', 'anticorpo', 'cenario', 'circulacao', 'conformar', 'conformar', 'coordenar', 'dengu', 'destacar', 'infectar', 'infectar', 'mutacao', 'piorar', 'reabertura', 'respiratorio', 'transmissao', 'variacao']","[1, 1, 1, 1, 2, 2, 1, 1, 1, 2, 2, 1, 1, 1, 1, 1, 1]","['circular', 'compartilhar']","[1, 1]",17,2,19,0
11750,"[]","[]","['imagem', 'instrucao', 'parir']","[1, 1, 1]",0,3,3,0
11751,"['apostar', 'apostar']","[2, 2]","[]","[]",2,0,2,0
11752,"['despesa']","[1]","[]","[]",1,0,1,0
11753,"[]","[]","['agredir', 'espalhar']","[1, 1]",0,2,2,0
11755,"['apurar', 'circulacao', 'concedido', 'logistico', 'logistico', 'privar', 'privar', 'viagem']","[1, 1, 1, 2, 2, 2, 2, 1]","['compartilhar', 'enganoso', 'imagem']","[1, 1, 1]",8,3,11,0
11756,"['autorizacao', 'boletim']","[1, 1]","['circular']","[1]",2,1,3,0
11757,"['variacao']","[1]","[]","[]",1,0,1,0
11765,"[]","[]","['circular', 'circular', 'idioma', 'imagem', 'invadir', 'supostament']","[2, 2, 1, 1, 1, 1]",0,6,6,0
11768,"['biliao']","[1]","['ilustrar', 'rouanet', 'rouanet']","[1, 2, 2]",1,3,4,0
11770,"[]","[]","[]","[]",0,0,0,0
11771,"['higienizacao', 'integro']","[1, 1]","['pelar', 'suco', 'viralizado']","[1, 1, 1]",2,3,5,0
11774,"['desafiar', 'desafiar']","[2, 2]","[]","[]",2,0,2,0
11776,"['estimular', 'periodo', 'silveiro', 'suprem', 'supremo', 'supremo']","[1, 1, 1, 1, 2, 2]","['circular', 'tampouco', 'viralizada']","[1, 1, 1]",6,3,9,0
11779,"[]","[]","['boatar', 'cedula', 'cedula', 'cedula', 'cedula', 'circular', 'circular', 'compartilhar', 'desmentir', 'imagem', 'legendar', 'lixar', 'lixar']","[1, 4, 4, 4, 4, 2, 2, 1, 1, 1, 1, 2, 2]",0,13,13,0
11780,"['agravamento', 'aumento', 'capitar', 'congresso', 'despesa', 'despesa', 'extraordinario', 'federar', 'fundacao', 'gabinet', 'gabinet', 'instituto', 'justicar', 'levantamento', 'movimentacao', 'necessario', 'reducao', 'reducao', 'reducao', 'republico']","[1, 1, 1, 1, 2, 2, 1, 1, 1, 2, 2, 1, 1, 1, 1, 1, 3, 3, 3, 1]","['circular', 'motorista', 'motorista', 'realment']","[1, 2, 2, 1]",20,4,24,0
11783,"['consequencia', 'domingo']","[1, 1]","[]","[]",2,0,2,0
11785,"['comissao', 'comissao', 'competicao', 'confederacao', 'posicionamento', 'presidir']","[2, 2, 1, 1, 1, 1]","['maldiz', 'patrocinador']","[1, 1]",6,2,8,0
11787,"[]","[]","[]","[]",0,0,0,0
11788,"['fluxo', 'fluxo', 'intensivo', 'investigacao', 'necessario', 'porqu', 'saudar', 'saudar', 'saudar', 'saudar', 'saudar', 'ventilador']","[2, 2, 1, 1, 1, 1, 5, 5, 5, 5, 5, 1]","['autopsia', 'autopsia', 'autopsia', 'autopsia', 'autopsia', 'compartilhar']","[5, 5, 5, 5, 5, 1]",12,6,18,0
11793,"['amplo']","[1]","['compartilhar', 'enganar', 'enganar', 'enganir', 'interaco', 'legendar', 'postagen']","[1, 2, 2, 1, 1, 1, 1]",1,7,8,0
11795,"[]","[]","[]","[]",0,0,0,0
11797,"['oswaldo']","[1]","['circular']","[1]",1,1,2,0
11800,"['etapa']","[1]","['botao', 'clicar', 'compartilhar', 'compartilhar', 'compartilhar', 'compartilhar', 'sacar', 'sacar', 'sacar', 'sacar', 'sacar', 'sacar', 'sacar', 'sacar']","[1, 1, 4, 4, 4, 4, 8, 8, 8, 8, 8, 8, 8, 8]",1,14,15,0
11804,"['complicacao', 'fluxo', 'lesao', 'pulmonar']","[1, 1, 1, 1]","['compartilhar', 'ilustrar', 'imagem', 'postagen', 'versao']","[1, 1, 1, 1, 1]",4,5,9,0
11805,"['acompanhamento']","[1]","['compartilhar', 'imagem', 'imagem', 'viralizado']","[1, 2, 2, 1]",1,4,5,0
11806,"[]","[]","['espalhar', 'grupar', 'minutar', 'motorista', 'quinzena']","[1, 1, 1, 1, 1]",0,5,5,0
11808,"['acordo', 'antonio', 'celebrar', 'colaboracao', 'companhia', 'consolidar', 'delacao', 'elaborar', 'equivalent', 'justicar', 'justicar', 'justicar', 'justicar', 'justicar', 'machadar', 'nelson', 'orientacao', 'relativo', 'republico']","[1, 1, 1, 1, 1, 1, 1, 1, 1, 5, 5, 5, 5, 5, 1, 1, 1, 1, 1]","[]","[]",19,0,19,0
11809,"['ampliacao']","[1]","['compartilhar', 'espalhar', 'nordestino']","[1, 1, 1]",1,3,4,0
11811,"['concedido', 'crescimento']","[1, 1]","['abencoar', 'abencoar', 'catedr', 'catedr', 'cristao']","[2, 2, 2, 2, 1]",2,5,7,0
11812,"[]","[]","[]","[]",0,0,0,0
11813,"['destacar', 'exministro', 'igualitario', 'instituto']","[1, 1, 1, 1]","['circular']","[1]",4,1,5,0
11821,"['desembarcar', 'emprestimo', 'esquema', 'exministro', 'ministrar', 'ministrar', 'ministrar', 'pastar', 'prazo', 'reuniao']","[1, 1, 1, 1, 3, 3, 3, 1, 1, 1]","['vc', 'vc']","[2, 2]",10,2,12,0
11827,"['ampliacao', 'enfermagem', 'plano', 'saudar']","[1, 1, 1, 1]","['amigar', 'motorista']","[1, 1]",4,2,6,0
11830,"[]","[]","[]","[]",0,0,0,0
11831,"['possibilidad', 'prever', 'realizacao', 'secom']","[1, 1, 1, 1]","[]","[]",4,0,4,0
11832,"['reclamacao']","[1]","['parir', 'parir', 'parir', 'pelar', 'versao', 'versao']","[3, 3, 3, 1, 2, 2]",1,6,7,0
11833,"[]","[]","[]","[]",0,0,0,0
11835,"['espanha']","[1]","['circular', 'circular', 'legendar']","[2, 2, 1]",1,3,4,0
11836,"['opcao', 'transferir']","[1, 1]","['grupar', 'parir', 'parir', 'parir']","[1, 3, 3, 3]",2,4,6,0
11837,"['epidemiar']","[1]","[]","[]",1,0,1,0
11840,"['diariament', 'reducao']","[1, 1]","['circular', 'compartilhar', 'secreto']","[1, 1, 1]",2,3,5,0
11842,"['esperancar', 'pereira']","[1, 1]","[]","[]",2,0,2,0
11845,"['ministrar', 'prever', 'rotina', 'saudar', 'saudar']","[1, 1, 1, 2, 2]","['atirar', 'atirar', 'atirar', 'atirar', 'atirar', 'atirar', 'atirar', 'chorar', 'pego']","[7, 7, 7, 7, 7, 7, 7, 1, 1]",5,9,14,0
11849,"['recordar', 'recurso']","[1, 1]","['checar', 'numericament']","[1, 1]",2,2,4,0
11850,"[]","[]","['checar', 'numericament']","[1, 1]",0,2,2,0
11851,"['celso']","[1]","['caixao', 'caixao', 'checar', 'imenso', 'numericament']","[2, 2, 1, 1, 1]",1,5,6,0
11852,"['celso']","[1]","['checar', 'numericament']","[1, 1]",1,2,3,0
11853,"['celso']","[1]","['checar', 'numericament']","[1, 1]",1,2,3,0
11854,"['celso']","[1]","['checar', 'numericament']","[1, 1]",1,2,3,0
11855,"['celso', 'habitant']","[1, 1]","['checar', 'numericament']","[1, 1]",2,2,4,0
11856,"['celso', 'etapa', 'instituto', 'parceria']","[1, 1, 1, 1]","['checar', 'numericament']","[1, 1]",4,2,6,0
11857,"['bancada']","[1]","['checar', 'numericament']","[1, 1]",1,2,3,0
11858,"['biliao']","[1]","['checar', 'numericament', 'parir']","[1, 1, 1]",1,3,4,0
11859,"[]","[]","['checar', 'numericament']","[1, 1]",0,2,2,0
11860,"[]","[]","['checar', 'numericament', 'parir']","[1, 1, 1]",0,3,3,0
11861,"[]","[]","['caixao']","[1]",0,1,1,0
11864,"['anuncio', 'client', 'crescimento', 'domingo', 'sabado']","[1, 1, 1, 1, 1]","['boicotar', 'cristao', 'filmar', 'filmar']","[1, 1, 2, 2]",5,4,9,0
11865,"['decorrencia', 'desenvolvimento']","[1, 1]","[]","[]",2,0,2,0
11868,"[]","[]","[]","[]",0,0,0,0
11869,"['depoimento']","[1]","['rosario']","[1]",1,1,2,0
11870,"['regiao', 'rigoroso']","[1, 1]","[]","[]",2,0,2,0
11873,"['comissao', 'exministro', 'inquerito', 'saudar']","[1, 1, 1, 1]","[]","[]",4,0,4,0
11875,"['determinacao']","[1]","['compartilhar', 'postagen']","[1, 1]",1,2,3,0
11876,"['client', 'taxar']","[1, 1]","[]","[]",2,0,2,0
11877,"['dosar', 'dosar', 'dosar', 'dosar']","[4, 4, 4, 4]","['realment', 'vazio']","[1, 1]",4,2,6,0
11881,"['ambientar', 'chefiar', 'companhia', 'fundacao', 'necessidad']","[1, 1, 1, 1, 1]","['amigar', 'estranhar', 'pelar', 'verificar']","[1, 1, 1, 1]",5,4,9,0
11882,"['desenvolvimento', 'etapa']","[1, 1]","['arquivar', 'humanar', 'segundar']","[1, 1, 1]",2,3,5,0
11885,"['autoridad', 'comparacao', 'comparacao', 'contabilizar', 'estatistico', 'infectar', 'infectar', 'manutencao', 'orientacao', 'periodo', 'saudar', 'situacao', 'surtir', 'surtir']","[1, 2, 2, 1, 1, 2, 2, 1, 1, 1, 1, 1, 2, 2]","['circular', 'compartilhar', 'manipular', 'viralizado']","[1, 1, 1, 1]",14,4,18,0
11891,"[]","[]","['enganir']","[1]",0,1,1,0
11893,"['recurso']","[1]","['atribuir']","[1]",1,1,2,0
11894,"[]","[]","['espalhar', 'filmar', 'gravacao', 'pelar']","[1, 1, 1, 1]",0,4,4,0
11895,"['ambientar', 'ministrar', 'preservar']","[1, 1, 1]","['humanar']","[1]",3,1,4,0
11896,"[]","[]","['arquivar', 'compartilhar', 'parir', 'usuario']","[1, 1, 1, 1]",0,4,4,0
11897,"[]","[]","[]","[]",0,0,0,0
11898,"['tendencia']","[1]","[]","[]",1,0,1,0
11900,"[]","[]","['arquivar', 'descricao', 'visualizacao']","[1, 1, 1]",0,3,3,0
11902,"['equipamento']","[1]","['circular', 'fraudar', 'venezuelano']","[1, 1, 1]",1,3,4,0
